YTN	RDYR
IKPE	YHSY
KSKK	WSTF
SRSK	YDGS
ANK	GQSF
AEH	RSNW
EQD	GTWL
QDH	GYNY
Y	VSTA
QIHQ	YENL
QPQ	RLHA
NVAG	RDYR
KKAN	DYNW
RVF	SLYA
GYA	YINY
GVVI	LYSL
KD	RSEW
RVF	NNYA
HVV	NYYG
DDE	YWRW
PCH	EGDG
KKK	WSTF
GSS	YDGS
SID	TLHS
YVTE	RYGR
TKDN	YPFY
KDK	ASDY
DA	SRSG
HQPP	HRGN
FR	WYGG
KA	LLIY
KPL	NRAT
LKFE	YGNF
EKFE	AGYS
RL	DASK
DPCP	YLQY
DN	GSFW
KD	NYYY
GVQN	RDYR
KG	SDVY
PYE	YYRY
WK	WGDG
FSC	YYYG
NNQG	RDYR
NGNA	DFTL
KCR	ASYY
RGSL	GYTL
NNG	DFTL
WN	DYSV
AQEG	SASS
YFN	WAWP
LEN	YHSY
DDLV	NRGW
SR	SGGN
TL	YEGA
NG	NPYY
KR	ASNY
QIK	SNWP
TIRE	KREY
LF	GSHV
GG	SASS
PY	NRAP
KD	RPEW
DKNN	RDSW
QHA	NYGA
KE	GTFN
ES	DIGD
QR	RAGW
AKQ	DDLP
IFP	HRGN
FKK	YYGT
PMF	RYGN
ATKQ	QTNY
EVY	VITM
SG	GVPA
DKR	DVNR
V	VSTA
QN	WDMV
RKR	ATHF
QTEY	YYRM
EDQ	GRGS
NPGI	DFTL
NYSG	RDFR
AR	STHV
EIDA	RGYY
KEGT	SWEI
SSHK	DGRN
EVH	ERLG
EL	DQAH
YQ	SVMI
NQ	GGDP
CT	ISSA
TA	VSGA
VK	WSSH
PAN	VMIT
NQF	MPNW
KNA	YYNW
PDG	VSSA
QR	FDYG
FDKS	YNSH
MFC	FFLY
NGK	TRWT
PK	GRYP
K	SDNL
LQFC	NSYY
KKAD	DYNW
Q	LTNG
TVKN	YPFY
N	YGQS
NPA	DFTL
GIR	GVPA
RG	GNYD
QSAA	IGRN
SW	ANTL
KSG	SGYS
WPLV	LNSY
FST	YWYA
TR	FDGD
EAPP	FGSY
PCV	ANSF
IAL	YSSY
GYVG	RDYR
PAK	GRYP
FC	NSYY
NIVT	GPFR
GM	YSFT
DMQA	DGYY
SSD	MGYD
RDSK	YGTN
RE	DVST
HSM	GNNA
EMTP	YDNL
RDK	FNSY
PK	SSYI
NYQN	RDYR
GSS	WSSN
QK	HYTT
KPD	DNSY
QLD	YNSY
NIT	GPFR
LSH	WWSS
RSRI	YIQL
KVIN	DSGY
MY	YRSY
TV	KFGM
GGS	YDDA
GG	SMDG
PKP	HYTT
DDA	SSSN
VRN	DDID
EHA	AARA
IRKN	YDEF
E	VSSA
IEL	WYRR
KH	DSNR
RSNK	GKML
NNVG	RDYR
NEL	FTFS
DN	WSNH
HRR	HYGY
SSK	WSSY
FDAN	SARF
GCR	RYNW
R	GVSD
YP	DGNY
K	GSKS
YA	WDSS
TK	VDGY
AGRF	WSHY
LHSN	FGDG
YEV	TSKN
ADK	ISTD
TATT	HYTT
YWH	CGSY
TY	LAFY
RSS	YDNL
AA	HYGT
EYN	YSRL
YFN	FWWR
LNH	WTSY
LK	YSFN
KRNI	YWSE
GK	YADS
TF	YLSS
FDD	YYTT
NIVT	GPFR
QN	DYSM
VND	RTSK
QRD	SGSG
R	SLYS
QDH	GYNY
EN	GSTY
DDY	SYMY
RSPS	YDNL
YWL	YTTT
NNN	IYFD
NTQ	FLYS
WKD	YSNY
NG	TYVF
AGGD	ENYK
NDN	SKSG
GVY	EGPG
T	STHV
KP	DTAA
YSDN	RDYR
RDIG	WYNR
YN	VSTA
TES	NWDV
PEK	YSKF
IE	GTSP
DNY	WSNH
NNVG	RDYR
KG	GTHA
SRG	SFQT
RT	ISSW
DRR	DVNT
GVAN	RDYR
AYMA	TYGY
VQ	SSSY
YAI	DFRY
YLE	DYGY
RGG	SGYY
KY	ASYN
MHDD	YGYY
NVG	EPPY
RD	FTFS
R	YSGY
PA	WDSV
LL	YDDY