RDYR	YTN
YHSY	IKPE
WSTF	KSKK
YDGS	SRSK
GQSF	ANK
RSNW	AEH
GTWL	EQD
GYNY	QDH
VSTA	Y
YENL	QIHQ
RLHA	QPQ
RDYR	NVAG
DYNW	KKAN
SLYA	RVF
YINY	GYA
LYSL	GVVI
RSEW	KD
NNYA	RVF
NYYG	HVV
YWRW	DDE
EGDG	PCH
WSTF	KKK
YDGS	GSS
TLHS	SID
RYGR	YVTE
YPFY	TKDN
ASDY	KDK
SRSG	DA
HRGN	HQPP
WYGG	FR
LLIY	KA
NRAT	KPL
YGNF	LKFE
AGYS	EKFE
DASK	RL
YLQY	DPCP
GSFW	DN
NYYY	KD
RDYR	GVQN
SDVY	KG
YYRY	PYE
WGDG	WK
YYYG	FSC
RDYR	NNQG
DFTL	NGNA
ASYY	KCR
GYTL	RGSL
DFTL	NNG
DYSV	WN
SASS	AQEG
WAWP	YFN
YHSY	LEN
NRGW	DDLV
SGGN	SR
YEGA	TL
NPYY	NG
ASNY	KR
SNWP	QIK
KREY	TIRE
GSHV	LF
SASS	GG
NRAP	PY
RPEW	KD
RDSW	DKNN
NYGA	QHA
GTFN	KE
DIGD	ES
RAGW	QR
DDLP	AKQ
HRGN	IFP
YYGT	FKK
RYGN	PMF
QTNY	ATKQ
VITM	EVY
GVPA	SG
DVNR	DKR
VSTA	V
WDMV	QN
ATHF	RKR
YYRM	QTEY
GRGS	EDQ
DFTL	NPGI
RDFR	NYSG
STHV	AR
RGYY	EIDA
SWEI	KEGT
DGRN	SSHK
ERLG	EVH
DQAH	EL
SVMI	YQ
GGDP	NQ
ISSA	CT
VSGA	TA
WSSH	VK
VMIT	PAN
MPNW	NQF
YYNW	KNA
VSSA	PDG
FDYG	QR
YNSH	FDKS
FFLY	MFC
TRWT	NGK
GRYP	PK
SDNL	K
NSYY	LQFC
DYNW	KKAD
LTNG	Q
YPFY	TVKN
YGQS	N
DFTL	NPA
GVPA	GIR
GNYD	RG
IGRN	QSAA
ANTL	SW
SGYS	KSG
LNSY	WPLV
YWYA	FST
FDGD	TR
FGSY	EAPP
ANSF	PCV
YSSY	IAL
RDYR	GYVG
GRYP	PAK
NSYY	FC
GPFR	NIVT
YSFT	GM
DGYY	DMQA
MGYD	SSD
YGTN	RDSK
DVST	RE
GNNA	HSM
YDNL	EMTP
FNSY	RDK
SSYI	PK
RDYR	NYQN
WSSN	GSS
HYTT	QK
DNSY	KPD
YNSY	QLD
GPFR	NIT
WWSS	LSH
YIQL	RSRI
DSGY	KVIN
YRSY	MY
KFGM	TV
YDDA	GGS
SMDG	GG
HYTT	PKP
SSSN	DDA
DDID	VRN
AARA	EHA
YDEF	IRKN
VSSA	E
WYRR	IEL
DSNR	KH
GKML	RSNK
RDYR	NNVG
FTFS	NEL
WSNH	DN
HYGY	HRR
WSSY	SSK
SARF	FDAN
RYNW	GCR
GVSD	R
DGNY	YP
GSKS	K
WDSS	YA
VDGY	TK
WSHY	AGRF
FGDG	LHSN
TSKN	YEV
ISTD	ADK
HYTT	TATT
CGSY	YWH
LAFY	TY
YDNL	RSS
HYGT	AA
YSRL	EYN
FWWR	YFN
WTSY	LNH
YSFN	LK
YWSE	KRNI
YADS	GK
YLSS	TF
YYTT	FDD
GPFR	NIVT
DYSM	QN
RTSK	VND
SGSG	QRD
SLYS	R
GYNY	QDH
GSTY	EN
SYMY	DDY
YDNL	RSPS
YTTT	YWL
IYFD	NNN
FLYS	NTQ
YSNY	WKD
TYVF	NG
ENYK	AGGD
SKSG	NDN
EGPG	GVY
STHV	T
DTAA	KP
RDYR	YSDN
WYNR	RDIG
VSTA	YN
NWDV	TES
YSKF	PEK
GTSP	IE
WSNH	DNY
RDYR	NNVG
GTHA	KG
SFQT	SRG
ISSW	RT
DVNT	DRR
RDYR	GVAN
TYGY	AYMA
SSSY	VQ
DFRY	YAI
DYGY	YLE
SGYY	RGG
ASYN	KY
YGYY	MHDD
EPPY	NVG
FTFS	RD
YSGY	R
WDSV	PA
YDDY	LL