TETE	GHGFR
KID	HYSPW
YNRS	SNSWY
NTN	YNNWW
PW	YDKLP
WS	SKEVL
YGRS	SNSWY
PPG	FSKLY
INS	YGSTL
EVI	YGSSR
VPE	GGTNW
GPSS	YYSYR
MARSL	TSSYY
RSQD	SWGIR
NLQA	HNSAY
GR	NNEDP
HTS	YYSIR
IGPV	SRELW
ESD	VHSNY
HEAF	GSHVL
EDK	YDEFL
HNG	RSNWY
NEF	YANYW
EH	VHSNY
FA	ASLVL
IP	HWNYL
THNI	GNEVF
KD	DYTYL
SLTR	LPGSS
LYFC	YRYSR
ERDH	VHSNY
FE	SSHVL
SW	GNTLR
YQI	SVMIM
KG	HLEYY
RGPF	PLQSY
FPA	SYSSL
NW	TTHVP
QR	VHNNY
S	NTLVW
EE	NKQTL
HF	GSHVL
NNTG	YNNWW
RG	SFSYP
SGY	YNSYY
RGS	SNSWY
NF	SWEIY
AFL	YRYSR
GD	SNEDL
WLY	NVELR
Y	HYSTF
WSG	NNVDW
LGFQ	LSRGY
NWKNV	YADYW
KNGLD	FWSTR
ATLQ	MLEHL
ENPK	SSSLF
N	GSGYF
GST	YNSYY
VVA	DYSYL
IPI	YYNPW
AP	SYSYL
PRH	FDGAF
GRG	SHEDL
WR	GNTLF
QF	VGDTF
WSGNN	NNVDW
KED	DYSYY
YDNRS	SNSWY
RT	GTHFL
KQYR	DYTYL
NVEVG	TYNHY
YRNS	ANSWY
AAR	YWNTF
VYGGV	AYIPL
WS	RSNWI
EFH	VHSNY
HFE	GSHVL
ATL	GASWF
AKD	HYSPW
TAK	HYGNF
TVG	NNEDY
TPA	RLRGN
LTP	GNTLY
WGNS	NNVDW
PV	SRELW
NS	GSGYF
KDCE	NYYRD
HTT	FYIYY
YGR	SNSWY
EA	NKQTL
FM	FNSYI
RR	WRSNY
RPI	HYSIL
TVS	YNNWL
LRFF	TYGHF
SGTF	NNEDW
SA	STHFP
NNT	YNNWW
YWW	QFDPF
KN	GSTFW
RYL	AKAFP
GLRQV	LYGFF
DS	YDNLR
PT	YYTYL
RNY	SNSWY
KFH	VHSNY
HKAF	GSHVL
LEL	SYSTF
ASNR	HYAIL
FNW	YGSSS
GGALA	FWSTR
YDR	SNSWY
FAT	TYSYP
EH	IHSNY
FHA	GSHVL
VL	DYSYL
WGSN	SKEAY
RG	SKEVW
SR	SRDLL
DIN	HWNYL
RD	SNSWY
IA	GLLSL
SPA	HISRR
WP	STHVP
RDNS	SNSWY
QKD	YNIYY
RNY	SNSWY
YGR	SNAWY
L	SQISP
TDSL	SGYYN
YNRS	SDSWY
PTD	YYTYY
DDLA	LHFYH
R	YDGDY
PFEVE	TSGYY
SR	SRDLL
PENDR	SNVWF
PPYW	WYSNW
KW	GTHFW
GETD	RRNWN
HNSIT	GNEVF
RSG	SDYAN
GTR	SGSWR
TS	IIEDW
TYLQM	STHVW
RGNY	SNSWY
G	NNVDW
IIER	FDHLL
NL	QAVSA
FSL	SYSTW
NGNW	NNVDW
SP	NLELY
RNS	SNSWY
YR	SNSWY
RPG	HNSNL
SAFP	SYNLY
NVPK	YASYY
WIT	IGVYY
YNRS	SNSWY
RY	SNSWY
HGAE	HNDYL
GPPR	GNTLW
HEQ	HWTYY
LW	SYNLY
NF	YGSSS
GTRR	SNSWR
PST	SYNLY
YAS	DYSHL
VSG	YAQLY
YDR	SNSWY
YAS	DYSNL
LFY	LSRGY
QRM	SNTSL
RRS	YATSY
QHR	VGDTF
YN	SFNVL
NF	YGSSS
RQV	FWDTW
YNKK	GATSE
LNSR	YYAYW
YR	SNSWY
AQE	YKQFL
FA	GSHVL
HRD	RAHND
NDKG	TSRYY
RY	SNSWY
PDEV	AYKTY
NTN	HNSYR
WG	TTHAP
YGNRS	SNSWY
DEL	LHFYH
DLAR	YDGSY
PTVT	YYSYY
EGL	RSTYL
YGR	SNSWY
SAFG	SNEDF
NN	STHVR
WHEH	DNPTL
NPG	SYSYY
KAT	HLEYF
RY	SNSWY
SPT	SYNLR
RNY	SNSWY
LQQQV	TSIYY
ALT	SREFF
NDK	HNSYR
KAT	HGESW
PQ	GHSFF
HYK	NNEDW
GNH	NSGNY
EKNP	SSSLF
KGRLH	SGYSH
KW	GTHFW
Q	YSTVW
AQT	HDSSY
YKN	SFNVL
NKP	YDGDY
DASL	TWYYF
WITN	IRELR
KG	GNTLW
STRAD	FWGNW
YR	SNSWY
NKE	YWSTW
ALL	TWYYF
RN	SHSWF
PYPE	YYGSD
KED	YDTYW
FLDD	RSNWL
YGRS	SNSWY
DATLL	TWYYF
VF	SNRWF
ICIWT	TSGYY
TN	IRELR
RGG	NIQLW
AVI	MSSYL
DNWE	SNTWY
NDTI	HNSYR
DDNEE	NYGIF
RD	SKEVL
SMRD	HNSYR
R	SNSWY