KEMS	EKMS
KGEMS	EKMS
VPG	GID
QRS	RSRQ
KKYWR	DGVYRE
DLTT	APSI
DLTT	PSI
DLE	MPSVK
SLLIE	VIAMPR
LSLIE	IAMPR
SLLIE	VIAMPRR
LEAILS	MPS
LSILE	IAMRKR
ILSL	PS
LSILE	IAPRR
SLLIE	VIAMPRK
LSILE	IAMPRR
LSILE	IAMPRKR
LSLIE	IAMPRKR
SAV	NNS
LQALDKNWLDRYEVLYLI	QLALNWLDREYVLLKI
LQALNDKWLRYDEVLYLI	QLALKNWLDREYVKLLI
QVYRQKW	QQVYKGLAKE
EK	NQLDE
LQALNDKWLDRYEVLYLI	QLALKNWLDREYVLLI
LQALNDKWLDRYEVLYLIK	QLALKNWLDREYVLLI
LQALNDKWLRYDEVLYLI	QLALKNWLDREYVLLI
QVYRQWK	QVYKGLAKE
LIQALNKWLDRYEVLYLI	QLALKNWLDREYVLLI
LQALNWLDRYEVLYLI	QLALKNWLDREYVLLI
LQALNDKWLDRYEVYLLI	QLALKNWLDREYVLLI
LQALNKWLDRYEVLYLI	QLALKNWLDREYVLLI
VQQ	YQRV
QRVY	QQV
LQALNDKWLDYREVLYLI	QLALKNWLREYVLLI
LQALNKWLDRYEVYLLI	QLALKNWLDREYVLLI
NKRTLL	LAHAGD
VVALMLAPV	PAVALMLAVV
VVALMLAPVA	PAVALMLAVV
VQDTK	TEE
VDKQ	TSEE
NDPE	ENE
GEEND	PVQRD
ADIR	RLE
ELR	RDIA
ENQ	NPQD
QN	YQNVS
LGHLD	DHLGL
AAQQN	AAAQ
AEK	KAE
RDGG	EK
TQE	TEQ
QKA	SAE
TAIA	VTAI
VTIAA	TAIEA
TEAVLQ	TEALVLQ
TDQQP	HRATT
SHR	RKQ
HRT	TQDQ
ERE	EAN
YDSASQ	DYSAQ
YDSAQ	DYSASQ
YDSAQ	DYSAQ
PATIGGLLLSH	DATIGK
DLRRR	PDLEY
PAYNH	RNKL
GVEA	LA
KWKE	SNEEFKV
RNDGN	SRNDG
ESL	NL
LVL	FVI
LML	FVV
LML	YVAL
RDS	AKG
RKD	QRKDR
QKEQ	DRSGVIS
KEQ	RSGVIS
EMGDT	RT
RARF	RAG
E	RTEAE
LGHNVA	ESLDK
HLEA	SLDKDG
EKK	YLK
KER	DDRDG
HNV	SLAKD
EKL	TKLE
LILS	LLI
LIL	LLIS
IDREDGEQ	TKTREALQ
KLGE	DFPEL
KSFAAD	ADAEEE
EAEDN	DGDN
GGNY	DDGNE
NGRG	RGNG
DGD	TEAED
QT	GQN
NLKH	SLDKD
KHNL	ESLDKD
NLKH	SLDK
KNLH	ESLDK
VAEE	SLGQ
RLDV	DLV
LGEHNV	ESLDK
AMEEEVTEL	SLQNPTEEL
NSRFD	RTDRNS
NDSGRNT	NRTDNS
DNSRNT	RTDNSG
DNSRT	RTDNSG
NSRDR	FRTDRNS
KSAS	SAR
SSAR	KSS
NDN	NND
TEERE	TEER
IDG	ID
ETE	LGQN
RES	KRS
ERSL	RYSTD
KRGEFE	SNKQ
KRFKND	NNLKQ
SCA	NPT
SCA	NT
SCA	NTE
QARW	ARHTGEKL
WRQ	KLTDE
HWR	ARTGKD
WRH	KLTDE
AHEWR	RHTNGKD
QKHVQ	QNGNG
QHVQ	QNGNG
QFEK	HN
QFE	HN
QEHFTH	NNLK
LLSS	GQPT
HWKM	EEEAV
HWPKM	EEEAV
ANE	GVD
DGT	GDTR
TAVMSDR	NNVTTDG
DGIT	GIDT
LMV	VML
MLV	ML
EDG	RNPQ
LRGQNP	KRGQNP
DGTD	GDTR
KGSE	ESGK
SI	KVE
EGD	PSK
IN	PGY
NEDYK	FY
NDYK	FY
KQN	YGP
QEEY	ETIN
NK	SSKE
GKS	GSY
LS	QKD
FQCEDECDI	DIQDPDTNLEGY
IDTN	YLDG
YLDG	IDTN
RKR	RKR
RATRD	DRATR
ATRD	RATR
LTL	TLL
KLTLD	DLLK
LSTLD	LLSK
LAPLL	IPGLL
LGIPL	LAPLL
LGLIP	LAPLL
EYFEP	HPFYE
EKVEGK	EQK
KEVEG	EEEQ
ASQAM	ASRD
RKS	RKS
HVSRLYSL	YFWLLYFNLL
HVSRLYNSL	YFWLLYFENLL
FQSGM	FQFS
NIYWVWK	INGYY
INYWVWK	INGYY
GFGQRK	DQG
GFGQR	DQG
QRN	KEFGL
NYAS	YASN
IFLDW	EFLW
RMG	WYH
EGVR	WEED
AGEVR	WEED
EAGVRY	WEDK
EAGVR	WED
REG	KAALK
RKEG	KAALK
RKEHEKAR	ENYEAE
LADG	NKN
ASLG	ADFIS
TGIPD	TGI
TGIPD	TI
NFYYAIRFTT	NYFAYRFT
EYLTIRDKK	KRQSQEVDY
EYLTIRDKK	KRQSQEVY
KTETLIDKERK	ESKKRFQVIYRI
KTETLIDKERK	ESKKRFSQVIYRI
TILR	FYD
YLTEIRRDKK	RQSGQSIDTH
TIRD	FYDR
EYLTIRRDKK	KRQSGQSIDTH
YLTEIRRDKKE	RQSGQSIDTH
TEA	RRDRY
YLTEIRRDTEK	RQSGQSDDTHRI
TIDRRK	FYINDE
ILTERD	YDIHN
LEY	RDRYR
KTETLIDKREK	ESKKRFSQIYRI
EYLTIRDEKK	KRQSQEVIY
LSAMK	FTSIN
VLASM	RKTLL
LKA	KLMLSN
LKIAE	LSINN
STQ	NFTQ
KEQ	ESTN
TMEFLFRLLIDSEYLRYMHYTID	KILYISLLWVVKTKMNETNFTQILVEALVRVLIRL
IDLVVSVVIVEFAKINNAE	IQLYISLKLWVVKTKMNFILVEALVRVLI
YYMR	QQYE
RDQATL	TNFTQ
DRQATL	NFTQ
LR	LQEGD
TSIINLLLLIIVETQATNNSID	KIQLYISLKLWVVKTKMFILVEALVRVLIRL
INLLLLIIEVTTQATNNSDI	YISLKLWVVKTKMTNFLVEALVRVLIRFL
DQAT	NFT
DQATL	NFTQ
ILLLLIIVETAQTNNSI	YISLKLWVVKTKMFILEALVRVLIRL
RLQ	KH
RLQ	AKHG
RLQK	KH
ND	PQSK
MND	QPQSK
RYQL	PN
DSLVHP	HLPVDS
DSLVPH	HLPVDS
DELL	RKKF
KGI	IY
QLPV	VDS
VDS	HQLPV
KN	STE
KVQ	KQEKVS
KVQ	QKVS
SET	HKN
EST	HKNQ
STE	KN
SET	HKNQ
SG	SSG
SSG	SG
LTPINK	VTMAYQ
EDGW	RIED
GEWE	EGEDW
YRE	SNEE
AKTAT	AKTA
AKA	AK
AD	RRK
IFQ	EVN
YVQ	LAN
EEDE	RRK
RKR	EDEE
EHI	NAS
IQ	LAHG
EKY	KER
NGDR	MQQ
NDGR	MQQ
QSFHD	DHSFQ
LQG	NLW
KYSPT	ELMG
KSPYT	EPLMG
YST	LMG
YST	LMGW
NPKITYT	EDLIG
PSS	WNK
GRG	NRP
KYDRRKG	ERRYD
NMFET	GKR
TNSTNNNT	NTNTNTNS
QE	KPSR
TQ	RGVK
Q	QAHKS
IDLI	LIM
TIFFLVIMF	VIMLLFA
LANLA	IVPL
RRGV	SDLGE
SIR	ETF
ENKL	NAEQ
KAD	FQNS
GGIKCD	QIK
LDL	IRTIL
LL	IRTIL
LL	KIRTIL
LDL	IRTL
LDL	IRIL
LD	IRTL
LL	IRTTL
YKIS	KK
TAR	ELY
PKVRS	RWRRK
PKVRSE	RWRRK
PNLRSL	SETREH
PNLRSLK	SETREH
MLYEE	IGGLIYRRILY
YKL	MEL
YP	NLL
KLF	KANHF
KLI	KANH
KLFI	KANH
TEQR	RETQ
LDGAN	NAL
KGHE	EKGH
KGDQ	QDGKV
GFH	HFTG
GQTFH	HFTGQ
ASEEFEDAA	AESEFEDAA
QARN	NQEA
KKTQ	EQQH
WNG	QIL
IEATR	PES
PRRV	RPRV
RTK	MEG
KGE	QTD
REQD	PRHRT
GKRR	DRLE
LAEQPH	HPQAL
LAEQEPH	HPQAEL
LAEQEPH	HPQAEEL
RS	HRDDE
TR	PLQNH
ELVQDR	PIKPE
IKVPE	LQDRV
SELQMEY	NRRSD
EEPR	NDKS
YKIRQLQDQ	DQLQQIRYK
YIIRQLQDQ	DQLQQIIRY
R	LGLSD
LGYV	YLGV
RGEVD	DEVRGT
KAGES	SEAKG
EPRCH	HRCEP
HRCVL	HRC
EDK	SQL
GGS	KGG
PLDAL	ALAP
WAQ	VFDV
QT	ACDS
ISTQ	ARR
EAR	EIDA
KNVKS	NC
KNCQA	DTCACK
ELRRT	TRREL
LED	EDL
QSFLDDD	GTKHE
EYDLPST	DLPYST
HQGLHS	VVGDCGSS
HLLQGS	VVGDCGSS
HQGSLH	VVGDCGSS
KASS	DSKTK
EATVM	NDRCI
ETMV	NDRCI
RIYLL	TFML
RIYLL	TFMML
CDRPG	KES
DGGR	KES
GRGPD	VGR
FLTVELLVVIVG	EFLRVLVLVQIV
VEFLVLRVLVQIV	VSGFLTVLELVVIVG
VFLTVELLVVIVG	VEFLRVLVLVQIV
LESVE	RLQT
QVGVTESE	ETVEGVSQ
RQLT	LEVS
VSFLTVELLVVIDV	VEFLRVLVLVQIV
VEFLRVLVLVQV	VSFLTVLELVVIDVG
VSGFLTVELLVVI	VEFLRVLVLVQI
CDGR	KET
CDGRP	KET
CDRPG	KET
VFQD	MAAAGTV
KGTE	KGTE
ELVQ	KKK
HLLEL	YRK
KAGK	SGSRY
KNKQD	QREQK
NATD	SYR
KGDTRN	DRDDVAL
DRDDAVL	KGDTNR
DRDDAV	KDTNR
KGDTRN	DRDDVA
KDTRN	DRDDVAL
KDTRN	DRDDVA
TLK	DWGL
DWGL	TLK
TLKV	DWGL
DWGL	TL
TL	DWGL
TLK	FWGL
FWGL	TLK
TLKV	FWGL
FWGL	TLKV
DWGL	TLKV
FTLK	NWGL
NWGL	FTLK
KDTNR	DRDDVA
DRDADV	KDTNR
DTLK	NWGL
NWGL	DTL
DTL	NWGL
TLK	NWGL
NWGL	DTLK
NWGL	TL
SAK	DE
DE	SAK
SAKK	DE
SDL	DKL
APH	HKF
DKL	SLD
TLK	WGL
WGL	TLK
TL	WGL
TLV	DWGL
WGL	TLKV
DRDADV	KGDTN
KGDTN	DRDDVALK
DRDA	KGD
DRDDAKVL	KGDTNK
KGDTN	DRDDVAL
DRDDAVL	KGDTNK
KDTN	DRDDVAL
KGDTKN	DRDDVALK
DRKDDAVL	KEGDTNK
KGDTKN	DRDDVAL
KDTKN	DRDDVAL
KDTKN	DRDDVALK
KGDTKNE	DRDDVALK
WSAQLM	WKGMFHH
WFHKGM	WMSQLA
DRDAKDVL	KGDTNK
KGDTNK	DRDDVALK
KDTNK	DRDDVALK
DRDALKDV	KDTNK
KDTNK	DRDDVAL
DRDAKDVL	KDTNK
DRDDAKVL	KDTNK
DRDADVL	KGDTNK
DRDADVL	KDTNK
KGDTNK	DRDDVAL
KDTNK	DRDDVA
DRDAKDV	KDTNK
DRDADV	KDTNK
DRDADV	KGDTNK
SDYL	DKEL
KDELK	SYSLD
DLK	YSLD
KDTKN	DRDDVA
KDTN	DRDDVA
DRDADV	KDTN
DTL	HKGW
AGDY	GADY
YSI	FKLP
DEKRDR	RRKDED
HNN	NHLPVK
PLSQVAPQ	RRD
VQKKK	KSAANE
SNLSL	NSSLL
TSNLSL	RNSSLL
RSNLSL	TNSSLL
SGR	SGPR
GIS	ISG
DSG	SGD
LGIS	ISG
SGPR	GRS
EVRK	NATD
LLNL	LLNLT
VMRN	YSVSE
LRVAQM	AQVLR
LRVA	VAREL
NLLVVTQVILESHVKFNMDIKVEMFF	QFLLVTKQSVIKIELSGSVELKTN
NLLVVTQVILESHVFMDIKVEMFF	QFLLVTKQSVIKIELSGSVELKTN
NLLVVTQVILESHVFMDIKVEMFF	QFLLVTKSVIKIELSGSVELKTN
NLLVVTQVILESHVFMDIKVMFFP	QFLLVTKSVIKIELSGSVEKLTN
GINQNR	MGE
RQDN	VQ
RQDN	VQS
ES	TESG
LDVNLIVLRLLTVK	LEVNLVLQLDELV
LEVLNVLQLDLEVK	LDVLIVLRLLTVK
LDVLIVLRLLTV	LEVNLVLQLDELV
PEERN	EPREN
PEERN	ERPNE
PEERN	EPRNEY
GREIIDYR	MREQA
GREIIPYR	MREQA
GREIIDY	MREQ
GRIIPDYR	MEQA
GRIIYR	MEQA
GREIIDY	MAREQ
GRIIPYR	MEQA
GEIIPYR	MREQA
REE	REE
VIANESL	IRYN
VIANESL	RYIN
IANESL	RYIN
AVIANESL	YIRNS
VIANESL	IRYNS
ALAFALFLT	LAAAFLFL
LF	LLSF
NSYEE	EENS
NKRYG	SE
SE	KRYG
SED	KRYG
SE	NKRYGE
NKRYG	ES
RVRDD	LEDVS
RRDDKK	LEDVSA
RVRDDK	LEDVSA
KGVE	EQYGLD
EYSDN	DNSYE
PKEEGEK	GEKPTT
PKEESGEK	GEKPTT
AARG	KAL
LIRR	QGDG
LIR	QGDG
RS	SGG
RS	SGAG
ERNG	RENG
ERNG	RENGD
YKVEDLL	VLEYKLD
SEN	NESS
RLED	RLWR
LNTIDP	NQQ
SRIGE	RISGE
SRIGE	RISGYE
QLRMG	QRLG
LGLG	GLLG
QLEG	QELG
GELG	EGLG
NVGGL	NKM
IQ	IDQGT
KIIGL	IGKIL
IQ	IDQLTG
FLL	FLL
FL	FLL
QDGGR	QDRGG
QDRG	QGR
QDRG	QG
KEGN	NNEE
IT	EGI
CGILEELQKKISELALMTSI	CIGLELKEYQISLEALMTSI
VLLKNLEEVLKLLAERAESEKLEELVTNLLEAYKEYEILSKLAERAEAESVLESILEELQKKYIL	VLLNKLEVKELLLAAREESECLLKEVTLNLEAYEYILSLKAERAEEAVSLISLLKEQYKIL
IEHAM	AMHEI
YISLDLMT	MTLLDYS
YSLDALMT	MTLLDYIS
KIELHADMT	MTADHLEIK
MLEVLLNLEEVLKLLAERASEKSLEELVTNLLEAYSKEYILSKLAERAAESVLEILELQKKYISMLEVL	LMEVKLLNKLEVKELLLAEAREESGSEKLLEVTLNLEYASEEYILSLKAERAEEAVSLILELKEQYKISEMLEVLL
MLEKVLLNLEEVLKLLAERAESEKSLEELVTNLLEAYSKEYEILSKLAERAAESVLEILELQKKYISEMLEVLL	MLEVKLLNKLEVKELLLAERAEESGSEKLLEVTLNLEYASEEKYILSLKAERAEEAVSLEILELKEQYKISMLEVL
MLEVLLNLEEVLKLLAERAESEKSLEELVTNLLEAYSKEYILSKLAERAAESVLILEELQKKYISEMLEVLL	LVLLKNLEVKELLLAEARESGSELLKEVTLNLEYASEKYILLKAEAERAVSLILLKEQYKISMELEVKLL
MLEVLLNLEEVLKLLAERAESEKSLEELVTNLLEAYSKEYEILSKLAERAAESVLILELQKKYISMLEVLL	LVKLLKNLEVKELLLAEARESGSELLKEVTLNLEYASEKYEILLKAEAERAVSLISLLKEQYKISMLEVLL
DMTSI	VTKLE
VLESILELQKLKYKAISELALNDMI	VLISLELKYQLKKAISLEALMNDI
VLSILELQKLKYKAISELALNDMI	VLEISLELKYQLKKAISLEALMNDI
NLEEVLKLVLEELQKKYISELALM	KNLEVKELVLLLQEYKISLEALM
LSKYHN	LDNSEL
DEDYK	KYEDD
KDHND	DYLK
KNLEEVLKLVLEELQKKYISELALMI	NKLEVKELVLLLKQEYKISLEALDM
DYLK	HDND
KNLEEVLKLVLEELQKKYISELALM	EKNLVKELVLLELEQYKISLEALHDM
KNLEEVLKLVLEELQKKYISELALM	NKLEVKELVLLLKEQYKISLEALM
KNLEEVLKLVLEELQKKYISELALM	NEKLVKELVLLLEQYKISLEALDM
DDEYAQLK	KIQAALEDY
KNLEEVLKLVLEELQKKYISELALDM	EKNLVKELVLLELEQKYKISLEALM
ELAQRLALKLAEAASEGMIEADKMQEQLAKIAAKYVAKLIEDLAERASEKCLEELVNLLEAYKEYEEILKL	LEALRALKAEAASEMIEAMEQLKQAAIAYKVALKIELDAEARESCELLVTLNLEAYSEEKYILSLK
ELAQRLALKLAEAASEGMIEADKMQEQLAKIAAKYVAKLIEDLAERASEKCLEELVNLLEAYKEYEEILKL	LEALRALKAEAASEMIEAMEEQLKQAAIAYKVALKIELDAEARESCELLVTLNLEAYSEEKYILSLK
ELAQRLALKLAEAASEGMIEADKMQEQLAKIAAKYVAKLIEDLAERASEKCLEELVNLLEAYKEYEEILKL	LEALRALKAEAASEMIEAMEQLKQAAIAYKVALKIELDAEAERSCELLVTLNLEAYSEKYEILSLK
ELYAQKLKY	LYSSY
LQKY	LSY
LKYKAIEEHND	ELVREFRDQ
KMLDKALRAEAEDKAERSLEELLQKLTEELYSSLAKLAA	MKLKKDALAREEAKAESERLLELQLEKTLEYSLSALKAK
DAT	NLQM
MLKDKALRAEAEDKAERSLEELLQKLTEELYSSLAKLAA	LMKKDALRAEEAKDAEERSLLQELLEKTLEYSLSALKAK
KMLKDKALRAAEDKAERSLEDILEQLTESRVLELSESLA	MKLKKDALAERAKDAESRLEIDLLEQTRSVLLESELSA
EKKEKD	KEQRDD
QMLDNRD	KANFDK
MLDKALRAAEDKAERSLEDILQLVTESRVLELSESLA	KMLKKDALARAEKAESRLEILELQRTESVLLESELSA
MLKDKAIRAEAEDKAERCQLEEQLQKLTEEVYSVAKLAEKAAEEVLI	KMLKKDAIRAEEAKDAEQRECLQELLETVYSVSALKAKAEAVELI
QMLN	LNMQ
LPGSMLQSKHDDEYD	RELHLKPRLRKV
SMQSKHDDYD	EHLRKRK
KVLRRKPLHELR	EYDDDHSKQSMLLPG
TVMIV	TVMIV
SVTRVQMQIEVRVISLSLQIHLLSLTTL	LTTLLLLSQLISSILRVVQEMIRQTVV
VTRVQMQIEVRVISLSLQIHLLSLTTL	TTLLLLSQLISSILRVVEQMIRQTVV
REEPQF	LRNKEM
REEQF	LRNKEM
LDVPK	FDARM
RGTGGR	RDSDDGGLQY
EGRLTGY	RYRA
QQPL	RR
EGRLTGY	RRA
VHQYHR	VHYQQRH
SLI	ISKL
IHYQ	IHYQ
TNSD	KERN
QLRD	QELRD
WGST	TSGSW
RN	SGYR
KPFNN	FPNKN
FSQ	NG
RETW	TTSVA
RETWT	TTSVA
KTRII	RKTI
RE	NRY
NRY	RE
YEGK	RKDT
NLT	GQP
KS	SCAS
LNS	LSNS
WGSST	TSGSW
HGFNS	GR
ERLH	REH
KY	PGHPR
PGHPR	KY
LQRQIIQGPL	LQIIQGPQR
PSGAI	T
YCF	AHA
PGLV	LVPG
TFEGRQL	KLRTLGAVKE
KLTRLGAEVK	TFGRELQ
TFEGRQL	KLRLGAVKE
ALLSKR	LQMDA
TGQ	QSGK
TGQ	QGSGA
PTAV	NKIN
PSAV	NKIPN
PSAV	KIPNN
SAV	KINN
PSAV	KINN
PSAV	NKIN
PSTSV	NQIPN
SDT	KFV
DT	GFKV
PSTAV	NKIPN
PSAV	NKN
PSTAV	NKI
SDT	KGFV
PSAV	KIN
PSTAV	KTINN
PQVSV	KIPNN
NKDKD	DI
PSV	NKIPN
PTAV	NKIPN
PTAV	KINN
PSTV	NKIPN
STV	KINN
VSTV	KINN
STV	KIPNN
PSTV	NKIN
PTAV	KIPNN
PQSTAV	NKIPN
TAV	KTVN
PSTAV	KINN
PQVSTV	NKIPN
PSTAV	NKIN
PQSTV	NKIN
PSTAV	KIPNN
SV	KIPNN
PQVSV	NKIPN
PVSTAV	NKIPN
PSTAVE	NKIPN
PSTAV	NKTIPN
PSTAVE	NVIN
PVSTV	NKIPN
VSTV	KIPNN
PVSV	NKIPN
QVSV	KIPNN
PSTAV	NKTIN
PQSTV	NKIPN
APQVSTAV	NKVTIN
PSTAVE	KINN
PSAVE	KINN
PQSTAV	NKIN
DTV	TKV
PTV	NKIN
PQVSTAE	NPI
PSTAVE	NKIN
STAV	KINN
SDTV	TK
GGK	NVIQI
KPGGGQ	QGGGKP
KPGGGQ	QGGKG
GQK	DGFD
IRFVSAYRNQYDMLMIRV	VRMILYDNRQYANSFVI
RFIQ	SRYR
EGLP	QV
AYVR	AYRRV
QVA	QVA
LGVGQ	PQLES
LGVQ	PQLES
LQEPS	VGQ
LGVGQ	PQES
GVGQ	QLEPS
LGVQ	PQES
TWEL	KKN
KKQH	ESDG
KK	NGE
FHAKEP	DN
VNKE	KVNE
FLLF	KVKY
LLF	VKY
KYVLF	LLTAY
KYDLF	LLTADY
KTEL	SDNQ
GKT	GKTT
AQDD	RQD
KERD	DQKAN
SDNQ	SDYNIQ
FTT	FTTR
QKS	QKE
TGK	KRDYE
RDY	TG
TTGK	QSN
EPSD	EPSD
RDY	TTG
ERDY	KTG
TSDN	NRK
QDG	DQGI
QDGI	DGQIK
AQP	QAD
TLTG	KGTI
GKTI	LTTG
RTSD	SDR
LTG	TGL
TENK	SEPD
EPSD	NKTE
GKQ	GKTT
GKQE	GTTKT
ARSD	RQEK
KGKT	QDG
KEGI	KG
TGKT	KKTG
KTLTGKT	TLKTGT
QEGIP	GKK
TG	RDY
KTLTG	SNY
RRVQ	DDQ
QDKEG	KT
DRCN	NRD
EN	SSPG
FGNTC	VTTS
VNFGNTC	TVTTSS
WAD	AYK
PTLWAVVGWLVYINGK	RTLTSAVVALEFRAQD
NPTALWAVVGS	RSTTALVVL
NTALWAVVGS	RSTTALVVL
PTLWAVVGV	RSTLTAVVL
PTLWAVVGS	RSTLTAVVL
PTLWAVVGWLYING	RSTLTAVVLAEFRA
PTTWAVVGWLYING	RSTLTAIVMVERAQF
TTWAVVGWLYIN	RTLTSAIVMVRAQF
PTLWAVVGVWLVYING	RSTTALVVLAEFRA
PTLWAVVGWLYIN	RSTTALVVLAEFRA
TLWAVVGWLVYING	RSTTALVVLAEFRA
PTLWAVVGVWLYING	RTTSALVVLAEFRA
TLWAVVGWLYIG	RSTLTAVVLAERF
PTLWAVVGWLYING	RSTLTAVVLAERF
TLWAVVGWLVYIGK	RSTLTAVVALERQFDD
TLWAVVGWLYING	RTLTSAVVLAERQF
PTLWAVVGWLVYIN	RLTSAVVALEFRAQ
PTLWAVVGWLVYING	RSTLTAVVALEFRAQ
LWAVVS	STALVL
TLWAVVGS	STLTAVVL
HEDCEE	RKSA
REEQEED	YEKR
REEQEED	YKR
EDEE	KSA
EDEED	KNPAR
ELD	RKNP
EHEDEE	RKSA
EDEED	KR
RRQTEDEED	EYKAR
EED	NPRK
REEDED	EYRKP
REDEED	PAKRN
REDTEE	PAKR
KEDEE	RKSA
EDCEED	KR
RREEED	AEYRKP
TEEDED	YRK
ED	RKNP
EDCEED	KRN
REDEED	AKR
TEED	ANPRK
REED	APRK
REEQTEED	YKR
HEDEE	RKSA
RREEQEED	YKR
RREEQEED	YEKR
REEQTEED	YEKR
TYRTFDDVLKGRY	TYAVKQAY
VTVFSAYRRVQRKY	IYSLRNQEPF
TYRTFDDVLKNGRY	TYAVKQAYP
TYRTFDVLKNGRAY	YAVKQQAPY
TYRTFDVLKNGRAY	TYAVKQQAY
TYRTPFDDVLKNGRY	TYAVKQAYP
TYRTFDVLKKGRYY	TYAVKQAYQP
KTYRTFDDVLKGRY	YTAVKQAYP
QTEDKGYLTACVAAYKN	RYSFFVGAFEFD
TEDKGYLTACVAAYKN	RYSFFVGAFEFD
DDKRSYFGGLLSAKSE	SSKRYNAVIGAFFQ
DDKRSYFGGLLSAKSE	SKRYNAVIGAFFQ
EAKGYLTATVAYK	AYSRFFIGAFEFD
EAKGYLTATVGAYK	AYSRFFIGAFEFD
DSYFGGLLSAKS	SLYKFFIGAFQ
DDKSYYFGGLLSAK	SLSFFIGAFQ
DRSYFGGLLSAKS	SYFFIGAFQ
DRSYFVGGLLSAGKS	SYFFIGAFQ
PSKGYLTATLGAYK	AYFFIGAFEFD
DDKRSYFGGLLSAGKSE	SSKRYNAVIGAFFQ
VGYKN	FEFD
PSKGYLTATLGAYKN	YAFFIGAFEFD
PSKGYLTATLGAYK	AYSFFITGAFEFD
TEDKGYLTACVAYKN	RYSFFVGAFEFD
DDKRSYFGGLLSAGKSE	SKRYNAVIGAFFQ
TEDKGYLTACVAAYKN	RYFFVGAFEFD
TEDKGYLTACVAYKN	RYFFTVGAFEFD
TEDKGYLTACVAAYKN	RQYSFFVGAFEFD
TEDKGYLTACVAYKN	RYRFFVGAFEFD
TEDKGYLTACVAYKN	RYFFVGAFEFD
TEDKGYLTACVAYKN	RYSRFFVGAFEFD
TEDKGYLTACVAAYKN	RYSRFFTVGAFEFD
TEDKGYLTACVAAYKN	RYSRFFVGAFEFD
TEDKGYLTACVAAYKN	RYRFFVGAFEFD
QTSEDKGYLTACVAAYKN	RYSFFVGAFEFD
QTEDKGYLTACVAAYKN	RYFFVGAFEFD
EAKGYLTATVAYKN	ARYSFFIGAFEFD
NR	KPPS
EHQWI	WQHI
EALN	NEAL
TYN	YNT
ELIVATIQ	QAIVTIE
ELIVATIQ	QAIVTIEL
IVEKK	KYTDN
VT	DRQ
RNEER	ESDP
QNAQEA	QALTLSA
DSEKYN	HTEPLA
GGRQ	RGGQ
ETRAW	ETRA
WNP	NWW
ERTK	KRTE
QNAQTAW	QALTLSA
QNAQTAW	QALRTLSA
DRQFG	RDQFG
DRQG	RDQFGL
HDHV	NDG
VTNES	QENAK
EPCP	PCEP
QGPR	NGE
QGPYR	NGE
QPFG	PFGQ
QPFG	PQFG
RLRG	RIFL
DAVAVR	RAVVAD
STVGGGGYNQAKGSTVAGGYNNEATGSTIAGGRKNQATGKGSFAAGIDNKNADNAVALGNKN	STVAGGYNNEATGSTIAGGRKNQATGKGSFAAGIDNKNADNAAVALGNKNTEGENSVAIGSNN
STVGGGGYNQAKGSTVAGGYNNEATGSTIAGGRKNQATGKGSFAAGIDNKNADNAVALGNKN	STVAGGYNNEATGSTIAGGRKNQATGKGSFAAGIDNKNADNAAVALGNKNTIEGENSVAIGSNN
STVGGGGYNQAKGSTVAGGYNNEATGSTIAGGRKNQATGKGSFAAGIDNKNADNAVALGNKN	STVAGGYNNEATGSTIAGGRKNQATGKGSFAAGIDNKNADANAVALGNKNTIEGENSVAIGSNN
STVGGGGYNQAKGSTVAGGYNNEATGSTIAGGRKNQATGKGSFAAGIDNKNADNAVALGNKN	STVAGGYNNEATGSTIAGGRKNQATGKGSFAAGIDNKNADANAVALGNKNTEGENSVAIGSNN
RRD	DRR
KDGFIAAKV	DYDYME
KDEGFAAV	YEYL
KDGFAAV	DYEYL
ADRGQ	RGSRH
LEGP	GPPRT
KKR	FPWRGT
QNSQ	SRH
DKDLDTQ	QLA
DTS	LQD
RR	DEE
RR	DEEQ
AAIVARKLA	RIAAQAYK
ILLE	DVR
ILLE	DVK
SQKGILLE	RFDLV
SQKGILLE	RFDLVKRAR
SQKGILLE	RFDLVRAR
LRLAEAVAEALLAEKALEYREETLLYRRAEAVRALDAVVLVL	LSVEILLAEKAVKAEAKLLRELEYALAEAGSEVLARARQEVVRVALL
LLKELLK	AQALTALRAQ
GLISL	TLR
GLIL	LRA
ELDEADS	KKLLK
LA	PSG
LKLTLEIVTFIEANDLLE	LRLLKIVKFINRVLL
LKLLEIVTFE	FEVTITLLELK
KGYQ	RI
IR	YQKG
ADN	PD
ADNQ	PD
TEIILTFWLLILV	TEILITFWLLILV
EILEAVM	LITEAAMW
ILETAAMW	IELEAVM
HVHDE	EVELE
RHEEAE	EAELERLK
TARKD	LLKDS
PVER	YYENR
QLLKMNLAKILECKEEILNLLH	LQLKNRMLAIEKLKCEINLLELH
HFSEQERLLQH	HFEQAKVQNKQL
LNLR	QQLR
ILKINLAKILECKEEILNLLL	QILKNILAIEKLKCEIELLLLL
QILKINLAKILEKEEIRLLLL	IKLNILAIELCEIKNELLLLL
ILKINLAKILECKEEILLLL	QILKNILAIEKLKEILLLLL
QILKNLAKILECKEEIRLLLL	IKLNILAIELKCEINELLLLL
ILKINLAKILECKEEILNLLL	QILKNILAIEKLCKEIELLLL
QILKNLAKILECKEEILLLL	IKLINLAIELCKEINELLLLL
ILKINLAKILESKEILLLL	ILKNQILAIELKSKEIELLLLL
QILKINLAKILESKEEILLLL	KILNILAIELSKEINELLLLL
IIIIIIEIIIINIGLL	IIIIIIKIIIIERLINL
IIKIIIIEIIIINILL	IIQIIIIKIIIIERLNL
LRQQHFS	FSHQKQLR
QHFSEQE	QNLRR
LKQNATQ	RQNQNTKHQ
RLRQNNQKH	QNATESFEQE
IIKIIIIEIIIINILLG	IIQIIIIKIIIIERLINLQ
LKQNATQ	RQNQNTKH
QHFSEQE	QNLRRQ
RLRQNNQTKH	NTQAESFQEE
IIIIKIIIIEIRIL	IIIIAIEIIIINII
IIKIIAIIEIIIINI	IIQIIIIKIIIIERLI
SEQE	RQR
IIIIKIIIIEIRILI	IIIIIEIIIINII
RQR	EQSE
IIKIIIIEIIIINIKQ	IIQNIIIIKIIIIERLIK
IINIIKIIIIEIRI	IIIIIEIIIINI
IIIIAIIEIIIINI	IIIIIIKIIIIERL
WHE	WHK
LWQ	KGMT
KEKG	FK
DVARA	KVY
STPL	PQYVL
PLQYV	STPL
KRDLPISLFF	SILPDLRFF
AS	SYG
NFYMY	ISVGGNS
GNSGSIV	YYMFN
SKE	SQSKE
QTD	TYAAN
QTDVS	TYAAND
WVELILQLLH	LLHLQVLIWE
LKDS	RK
LNY	LAL
KK	AIEQS
LKK	IEMDAS
KLKK	IMADS
LKK	IMAES
ERK	ERKF
AWAE	EAWAEPES
LNYE	NIS
DAARPAGDS	SDVQLKVRD
RSAT	STR
KKLSN	KKLSN
KKLS	KKLS
GYRT	YRTG
REE	ERE
YKTEDSDKWKHVK	KHVKWKDSDKTEY
YKTEDDKWKHVK	KHVKWDDKTEY
YKTEDDKWKHVK	KHVKWKDDKTEY
VPRCQLD	DGVI
VPRCQLD	IVDG
ILIRCA	LIIIC
ILIRCA	LIIIPC
DR	QAHN
QELV	QEL
HTF	QLD
HTFF	QWLD
VTGSIS	VAEA
RES	ESR
PTGSISD	VAEATK
VH	ELPKW
RTTTYI	TTYTRR
ATARE	VQGATR
RDSV	AGAS
GVWKGA	KSQFL
DK	SNASG
TGAY	FRGF
QKE	KASD
KRDKN	RENGS
QQQIGDR	DRGIQQQ
RGIQQAQYI	AIGQQAQYI
AGIQQAQYI	RIGQQYAQI
QQID	DIQQ
QQQIGDR	DRGIQQKQ
GAAKGEQQQ	REENGESR
TKRDKNTN	RQNEGSK
ASSCNPA	NPASCAS
KYEY	EYYK
LQGLNQ	QELGL
EKNY	GPTWA
RRQG	RS
RAE	EKA
ENER	ENER
YDEAKHE	NRDWLQ
QESKD	KRVD
YAW	ENRA
KYAW	EENRA
KR	EVLLE
ENQ	QKEN
ENTQ	QKE
KLFVLEIGLYLKIGIQ	GIEIKLYGILEGVLFLKM
RLIGEAAE	EAAGEILR
AKNSVAIGHSS	GYSIAIGDRS
KVNGKQSIAIGSGA	ALNGSQISIGTGN
GNVTVI	QAQLA
EERR	ERQG
YELTRRLDADFVAI	VAFDDRLATRLRYE
LAFVA	LFVA
LFVA	LAFVA
YELTRRLDADFVAIAGF	VAGFDDLTRLRYE
KPYRN	YRNEY
NPVR	NP
AVA	AVA
MLDPA	DPLAN
FEAKLH	TG
TEDEVDS	DEEVDS
EDEVDS	EDEVDSD
RPLD	PLDR
RPLDD	PLDRD
KHNS	ETWQDKR
AELQKFSGPLGSQGLFC	LDALKYQLLAATIKFS
DRFFDLVN	VNLDLFADFE
VQSNLY	VYSNQL
DRFFLDLVN	VNLDLFRFD
SRMKL	ASHTLF
SFHTLA	RLMKS
WGHKW	TVD
VNDHD	VNDHD
VNDHDA	VNDHDA
QQKDGM	QDYTIQN
QQKSDGM	QDYTQIN
DGVP	PIRVEGSD
IWCE	IWCED
FR	YGP
YGPK	FRN
YRSEDRKP	RYSERKPD
KK	YSKK
KKG	SKKG
SKKG	KSKG
YSKKG	KYSKG
TRVLLRVAL	ALRVLLVT
RVRLDVDL	VDLVLRRST
STRVRLLVDAL	LDLVVRDR
ETRVLV	VLTRV
EEERNHKENEQ	QHERENENNKQ
DHCARHG	ARCHGHD
RK	CLCD
RK	PLCD
CGRG	GRVREC
VRECGR	GRGFC
HPC	KMR
HCPHC	RK
WQAS	SHT
YRNE	QSV
MVHR	RS
SRH	HTGT
RRY	VEK
RRY	VE
SRD	RSGR
RRY	EVK
CPHCDKL	KGML
TKCDI	WKNQ
TIELS	LRKT
TIEL	LKET
TKL	LTET
TKLR	LTET
TIEL	LRKET
TIEL	LRKT
CKK	FKT
LCARDCIIRN	INRCIRDAGLC
LCAGRDCIIRNC	INRCIRDAGLC
CSNKE	KNESC
CRNGGE	PSCHFL
GTHCTK	KTGTHC
NIY	YIN
FNCG	WKG
WNCG	WQ
KCEL	GGFKK
LIN	LRIN
ADLKAE	DCTLI
YKCECKFQ	LQHHD
YKCPECKFQ	LQHHDQ
PYA	PYKCP
KCE	CSES
MFV	VGPQ
TRNDACQ	ESVN
ESND	TRNDACQ
EKCLTSN	NESD
ESND	KCELTN
WELLRLEA	FRLLDRV
TEKQ	GRTE
QVR	KEGQD
EHW	KQVFP
GKGLR	CNG
KGR	GCN
KGLR	GCN
KIFIR	AQILL
KIFIR	QIALL
IFVR	IALL
KIFVR	QIALL
KIFR	QIALLR
IFIR	IALL
RQLRN	GRVN
QST	VPGQG
KIFVR	QIALLK
IFR	IALL
IFIR	ILL
KIFR	QIALL
IFIR	IALLK
KIFVR	AILL
KIFIR	AILL
RLPR	DALA
RLPR	DAL
KRR	DEEEE
KRPR	DEEE
AKRVTMK	GSMED
AKRVTMK	GED
NRK	DERSD
KQVHD	REDG
SRSR	TEDE
SRSR	DTEE
NGKVTI	EKEL
PMAH	RS
QRLS	AART
TPDITR	RIPTKTD
TPDITR	RIPTTD
KTPDITR	RIPTTD
NAGR	SEC
SEC	AGR
SEC	NAGR
NGAGR	SEC
KELL	EKLL
KELL	EKHLL
KEHLL	EKHLL
ELL	MELEFL
EISDIK	KDSIIE
VFMQL	LFMV
VFML	LFV
KHGEAQ	QIVDY
QRD	RDG
PKEG	RAE
VFMQL	MLFV
VFMQL	MLFQV
SCF	FSC
AQKTD	ALSCQL
LPTVNY	QNLPVY
LPVNY	NTVY
QQGI	KE
QNGI	EK
GEKSF	EGKFQS
SDR	RAD
AQEQD	KKI
ENQRYAAV	ENQYARRA
ILSVQ	AETQK
ILSVQ	AEEQK
TD	ELKH
TD	ELK
QDVNK	QDQGSD
QDVNK	QDQGFD
QYISKQE	ITAVGLV
QYISKQE	ITAVLVG
QYISKQE	VAITGLV
RKLY	VGTAGDA
YLQY	VQRQ
YLQYI	VQQR
QY	SAAV
YLQY	VQQR
DQAVSKQQ	KQSQAVQ
LDA	ALDL
VDQVSKQ	QKSQAV
QVSKQ	QSKQ
LDA	DAL
VDQSK	QKVVSQ
DATEAQSAQANAS	RSANQSADT
QAVK	QSKQD
ATEGALN	QQK
VDQAVSKQQ	QKVASQAVDQ
VADQAVSKQ	QKVASQAVD
VADQAVSKQQ	QKVASQAVDQ
ATADQSANSER	ASEQANQSEADATD
VADQAVSKQ	QKVVSQAD
DQAVSKQ	KQSQAVQD
DQSKQ	KQSQD
QK	QSKQD
DATEAQSAANAS	RSANSADT
TEGAL	QK
QAKQ	QKQA
QAKQ	VQSKQA
RLT	VAGS
QAVSQQ	IAVGL
QVSQQ	ILVAG
RRLT	VAAGS
QNGLAN	EETLK
RMKKSEAKDR	RDKEDSKK
ER	SKKCS
KAMPDY	GFIKK
SVNF	NFSV
ERLARE	KGDIGH
RRR	EEN
RNL	DSNV
SHDLLQFELTELLTRLTLALEKKTLLSVLP	VLPLTLEKLKTARLLLELLETQLFDLH
HDLLQFELELLTRLTLALEKKTLL	VLLTLEKLKTARLLLELTLETQLFDL
HDLLQFELTELLTRLTLALEKKTLLLV	LPVVLLEKTLKTARLLLELTLETQLFLH
HYPE	IPK
KDLAYFEWYR	RYEWFLAYKD
RTLLF	ERLTLF
TLLF	LTLF
WRK	RTHSY
KR	SFQL
SIE	RIQT
RKEKT	NTREK
RGSE	RL
ITNSEEVR	RVEESITNF
ESG	GES
NESG	EGRS
EVS	EVS
TRVQTLIK	QVRTTLIK
FTNE	ALGDYQ
IHWW	MYQT
RRPR	DKQD
EHWW	MYQT
IEHWW	MYQT
EE	SAMRY
VA	VGET
RR	DQDT
IED	QVT
RR	DTQKQD
IEHWW	MQYT
EHW	MYQT
IEHW	MQYT
IHWW	MQYT
TLQFYL	YLFQLT
DPVTN	DCALQ
RQSS	SSQR
GRI	QET
KHE	DMAL
SLE	PNLLLK
DIFK	NGAG
RNHSD	NSHSH
DRPG	GLL
SSEQIH	RMESESSD
LARN	EPKI
LAN	EPK
LARN	EPK
LAN	EKP
LAN	EPKI
HKQYNL	EYHELHH
TGLNP	NPGL
TLQFYL	LFYLQT
KCK	RDK
LYSMPL	LKSTLE
E	KVDTLQ
DDIFK	NAVG
NENN	QAM
YKHTNQ	KDGL
LNPE	FTEFS
KSVNLDL	QFVE
LGSK	SQLQRD
RRTM	EANMH
QLPYY	YQV
KCK	KCVEV
LEFKL	LFKLE
KS	EQMYR
KS	EQKY
FLF	FLF
QLPY	YQV
QVEKQHEQIL	LLLSPEGHQH
RFQ	ERQFY
MNLFGAG	NGMAGFL
MNLFGAG	GMAGFNL
MNLFGAG	NGAGFML
RLGNR	EFT
DQTAQQRDG	QRDGATQQD
DQTAQQRD	QRDAQQTD
DQTAQQRD	QRDGAQQTD
DQTQR	QRTDQ
REKQAHTLDWQ	DQWTLAHKQRE
HASRWT	RETL
IYW	VDGDASEM
IYW	VDGDASM
KGVG	NQEP
QLTV	TVL
QEQVHE	EVHQQE
DDERL	NTAVNGR
DDER	NANTGR
DDERL	NANTGR
DDER	NAVNTGR
IDDER	DNANTGR
DDER	NTAVNGR
HIEQ	QQL
H	PKYFK
RLDKGYY	LKRNT
HGFSKRSFTRQFT	FTQTRFSRKFSHG
EWHRVSGKFLR	RLKFSGVWHRE
VY	EVY
HGFVSREFCRT	YVTRCFERSVFG
RDHGFISREFHRKYR	RYRKFHERISRDHGF
EDHGFISREFHRKY	HRYRKFERISDHGF
EDHGFISREFHRKYR	HKRYFERISRDHGF
ERDHGFISREFHRKYR	HRYRKFERISHGF
EPGV	GPEV
EEK	KVGIV
EDHGFVAREFHRRYR	RRYRHFERAVDFEGH
DQKRE	EAQVRNKD
NQAE	EKAAEK
LFAAQ	LAAKQ
QKLAA	QALFA
LNL	LNL
QVWG	LAQS
VGV	LAMS
LME	RL
SLN	RSG
ATSTE	R
TSTEY	R
LGVTYK	LRLG
LGVTY	RL
LMRP	LVRA
KNY	EDSLS
SEDLS	YKN
SGYI	GYSIL
KLLYK	KLLTTE
RSG	KTPNL
VAGKLANGL	ALLNGGKVA
ESVKVGR	GVKVSEQV
RRL	LRR
PDVAT	AVTDP
NSRLTY	RSNLTY
QRLAE	QRALK
QRLAE	QQRALK
QRLAEK	QQRWALKE
IQRLAEK	QQRALKE
IQRLAEK	QQRWALKE
QRLAEK	QRALKE
QRLAE	QRWALK
QRLAEK	QRWALKE
QRWLAE	QQRWALK
LT	LTR
PVQE	GDRA
VSDR	QE
NLTIKSL	TIKSNLL
KAALN	ANALK
AVSTTIGL	ITGVSTL
STTIL	TIGVST
STTIGL	TIGSTL
STTIGVL	TIGVSTL
NVSLVNI	SLVNNVI
TPPTDM	PTDTPM
RRE	RFER
RLDVF	RLDEVF
NLTIKL	TIKNL
NLTIKL	TIKNLL
EDYK	YKED
NLTIKSL	TIKNLL
RNLTIKL	KTINLLS
RSR	EVSDVV
NLTIKL	TIKSNLLS
NIALSNI	ALSNNII
SANLTIKSL	IKTSANLSL
GVQLD	LDQGV
SRNLTIKSL	IKSTNLSRL
NLTIKSL	TIKSRNLSL
KKLE	GDLEKRMT
NLTIKL	TIKSNLL
SRNLTIKSL	IKSTNLL
NLTIKS	TIKSNLL
ESDQ	RQNRK
RTDQGRTE	NDVDRT
SAGER	DEG
GRRT	KFRR
VLVL	VLLV
AQLE	LEAQ
SCNSMAI	MSANSCI
LAT	VVN
LAT	VV
LART	VVNRR
QIVGC	EMIYK
QAGL	DMTV
HLI	DTPN
KRV	TDR
KRV	TD
DQN	IME
EQIVG	IEMY
IEQIVG	YIEM
QAG	RG
QIVGC	EMIK
QQIGC	EMIK
QIV	EMIY
HEAAGTS	GQL
RIKMQ	IQVQ
QVGC	EMIK
QIVG	EMI
GQIVGCSR	EMIKG
QDKR	QRSKS
QNLDKR	QRSKS
QNDKR	QRSKS
SRSKQ	KDRQN
PDAMTH	THMPDA
MTHP	EVTE
THP	TEV
PTENTE	NER
RATA	IEAAE
QR	SGQPR
KPNTQ	DAG
TGGNR	NYGG
PELLNAA	LAYQSH
QLA	LAQ
PTA	GAPT
PTA	TAVP
IYKNV	IKNVY
IYKNV	IKNY
EKA	NLI
EKLA	NL
DRGARAVT	VTRAAGADR
FYRLSTIF	STIFRLF
FYRLSTIF	STIFRLFY
FRLSTIF	STIFRLFY
ILLF	LLFP
YMEKQDKTLKIEG	YMEKLKIETQDK
LPFHY	YHFLP
KKA	AAKK
KKA	AKK
KKAA	AKK
ITAIAHS	IISAHAT
DIFQ	FRA
DIF	FRA
KGQ	KGQ
CG	CSDE
CGV	WCSPL
IHAEIRLQEIHKSI	IHSIKELIQHEIA
IHEILQEIHKSI	IHSIKLEIQHEIA
HVKC	LWKKK
HVKC	LWKK
DQRAEQ	RQDQA
REQ	REQ
REQ	EQR
CEHVKC	KLWKK
EHVKC	KLWKK
NKK	EQGF
KHR	RTDE
SVGT	RGVT
PIG	IGP
FLESS	FQNAV
QTKLI	ESDLFH
HAH	NHE
AHN	NAQK
KER	RKEH
KDLHT	THFDL
DLHTF	HTDL
GRAL	LRDPG
RGRVAH	LRDGP
NNHH	NNHP
SNN	NN
MQDYV	GLLD
GTTFTYTTE	TEYTFTTTG
FFDN	DFN
NDNG	TVK
TKV	NDNGD
KQND	DNDQ
EVCLEIQTVQSMMWWL	EELAILRLEFEFLFKALE
LEALCLAIDTENMDWW	RIRNLRRCLQFKLMFRAV
ELVACLEIQTVQSMMWWL	ELEAILRLEFEFLALKE
VCLEITVQSFTWWL	ELAIRLFSQEFLKFALE
LVEALCLNAIDTEQQFLDWW	RIRNRLRCLQLFQKLMFARV
LVEALCLAIDTEQQFLWW	RIRNRLRCLQQFKLMFARV
LVCLEITVQSFTWWL	LAIRLELFSQEFLKALE
KNYIRP	RIPYN
VLLNSC	AAAPSC
LKKR	YD
WPRSE	PNRSWPE
SNS	NSS
SKKLQEHLDQMN	NLQMHDLEKSK
LQRD	LAEK
DTDPALD	RQWDTR
NMETHQ	NNEDTHQ
EGTE	RDK
EGVTE	RDK
TPCC	PCCT
HKF	ASNG
RQH	HQR
PITSLEVIK	KIVELSTPRI
PRITSLEVIK	KIVELST
ANYPTAR	QNYHI
TGN	WRK
EVT	RAP
NDN	PGTTSL
QGRQ	RQQG
QGRS	RQG
ELFT	YQG
TGR	GQR
YQG	ELFT
YQGRS	RSG
YQGRK	RKYQG
QGRS	RSQG
KSLAKW	QEIKN
GYDI	QQENKI
GYI	QENKI
GYIN	QENKI
RQLG	GARPPV
RQLG	GRPAV
YEPVVER	PGLS
LII	VFLLEI
LII	VFLLI
PSLKG	GIL
LII	VFLL
VTLDIKN	NKIDTLV
AIGLD	VDKLLM
VT	LDAKT
RNSDGQ	RNSGD
FKYV	RQAD
RCEK	CKE
LFM	CRGG
LCH	LSH
ALV	LAV
LSH	LCH
HEALV	EHLAV
ICSLL	SLICL
SLYQ	QLAVH
QLHAV	SYQL
SLYQ	QLALVH
QLHALV	SYQL
CSLL	LV
LV	CSLL
QHLHAYLV	EYLHQLAV
QHLHEAYLV	EYLHQLAV
QHLHALV	SYQL
IVCLLEYC	LLVARFGF
ALV	ELA
EALV	HLA
EALV	HELA
VCCSVCLE	LHLCALV
CCSVCLE	HLCLALVC
YQENC	FKYT
LEAL	LAV
LHEAL	LEAV
LHEAL	LEHAV
EALV	HLAV
HEAL	EHLA
ALV	LEA
HAL	ELAV
GSHE	HLCH
GSHE	HLCHS
YSANH	YASNL
IVCCTSICLLEYC	LHLQCAVLRFFG
EAL	HLAV
HAL	ELA
HEALV	EHLA
EAL	HLEA
QHLHEALV	ELHQHLAV
ICSLYL	RLGV
LVRG	CSLLYQ
HEAL	ELAV
EAL	LEA
HEAL	EALV
HEALV	EAL
HEAL	EHLAV
HEAL	ELA
EAL	HELA
EALV	HLEA
HALV	ELA
EAL	LAV
EAL	ALV
EAL	HLA
HLGSHVEYL	YLEEVSHHLG
HLGSHVEYL	YLEVHLGS
LCH	LSHE
HLSH	HLC
IVCLLEYC	LLLVARGFY
CHL	LSH
LSH	CHL
LHEAL	LEHLA
VVEAQL	VVEAQL
VVKEASQL	VVESKAQL
VVKEASQL	VEVSKAQL
LQINS	HSKFG
SHKFG	QLNIS
LVQI	VVLDS
SALH	KRW
ESALH	RKW
EALH	RW
KY	DWAG
CDVCQE	ENK
EKY	WWAG
KY	WWIG
Q	KWGIE
EKY	WWIG
VGFRN	LIHDE
AVKS	AVKS
IDT	GR
TYKVR	HFP
TYVR	HFP
TYKVR	FP
RTKEW	EQKY
RKER	EKY
REW	KYLF
ERW	KYL
TCERGW	EKYLF
CERW	EKYL
ERGW	KYLF
GKQNY	YQNK
RKQ	YNL
LRQ	YNV
ATPE	PEAT
ATPE	PET
LTL	KTWSVL
SVI	ISV
TLKWSV	TLL
ATVGYG	TVGYG
TVGYG	ATVGYG
TVGY	VTGY
ATVGYGD	TVTGYGS
ATVGY	TVGYGD
TTGYG	TTGGY
WRQAH	MVAEWF
WVRQAAH	MVAEWF
KTLKF	LKFTK
KTLF	LKFTK
KFL	KRS
KRYL	RQA
RKFA	DQML
LNEAV	NSGDQV
FGRR	ATRE
EAFAQ	R
DENN	ENND
LSVRF	RLSVF
PDENN	ENND
DENN	ENNPD
PDEN	END
DEN	ENPD
EYGLAK	KKAGLYE
EYGLAKK	KKAGLYE
EDKN	KNED
PQAP	APQP
GTQKVTYL	LYTVKQT
TQKVTYL	YLVTVKQT
YLVI	VIYL
NEE	KAK
HSVVE	EVVHS
VVQ	VVQ
SAPD	DIK
EYE	NGV
AWV	WAV
FIAINQS	IAIFNS
FIAINQ	AIQFINS
FIAINQ	AQFIN
FIAINQS	AQFIN
FIAINQ	IAIQFN
FIAINQS	IAIQFNS
NKSQ	TTLTT
NKSLVQ	TTTLTK
HDS	PGH
TT	KYGK
DSI	GRCEVF
GGIQIAQEMKEELARKLIRQ	QILRKALREKMEEAIQQGI
SLM	LSML
YPLAVKASL	LAKSVALPY
LQK	KQL
SLLLR	LGEVAE
GVLI	IVTEG
SLLLKR	LGHEVAVE
SLLLK	LHEGVAV
SLLKR	LEGVAE
VYISS	TINYRK
SLLLKR	LHEGVAE
SLLLKR	LGHEAIE
SLLL	LGVAEV
LLLR	GLVAEVE
LLLR	GVLAEVE
LLLR	GVAEVE
SLLL	LGAEV
SLLLR	LGEAE
SLLL	LGEA
SLLLR	LGHEAE
SLLKLKR	LGHVEAE
SSLLLKR	LGEVAVE
LLKLKR	LVEAVGE
SLLLKR	LGHEVAIE
SSLLLK	LGHEVA
SSLLLK	LEGV
LLLKR	HAEGIE
SLLLK	LGVAE
SLLKLKR	LEVAGE
EVDDTR	QHEKI
VDTR	HEKQ
VDDTR	HEKIQ
VDDYTR	QHEKI
SYDEN	QDPQ
DMKQ	QHR
DMKQTG	QRKH
KEFSI	EKFSI
KSVTVLP	TLVIP
SVTVLP	TLVIP
KSVTVL	TLVIP
GE	KFPD
TDIIT	IITVTD
TDIITV	IITPTD
TDIIT	IITTD
TDIITV	IITTD
SKSFT	FTSKS
SKSFT	FTGSKS
KLNVKLIKVLSQLRELAKAKLRILEL	LLEELRIKAALKLEQRLVSLKILVKKN
DQSGEVL	VTLAVFN
EVLLENLLKLNKLIKVLSEQLKELAKKLE	VLLNELLKLNKLIVKLSQELKLKEALKI
MVLIENLLKLNKLIKVLTEKLQELVKKLEKN	MGVLINELLTLKNLKIVKLTKELQLEVKLKN
KKYG	TYMF
KKYG	TFYM
KKYG	TYM
RTMLQLLQKELTTNLR	TRMLLQLQEKLTNTLL
RTMQLLQKELTTNLRRLA	TRMLQLQEKLTNRTLLR
NEHF	NKGI
NEHFE	NKGIT
GHE	GSNSS
KALLMM	LINVFVV
KALLMM	LIVFVV
YQ	NSDG
NDG	YGQ
YGHTF	PDG
RGPR	GPRMG
MRGPRG	PGRR
RGPR	GPRMRG
MRGP	PGR
RGPR	GPRRMG
MRGPG	PGRR
MRGPG	PGR
RGLIGLKLED	RTGRARRQYRF
RNILLKGE	RRYF
RLLKGED	GRRYF
RLLKGED	GRRQYRF
GLRGLKED	RRQYRF
RLILKGED	GRRQYRF
RGLIGLKLED	KTGRARRQYRF
KGLLIKGED	GRKLYRF
HRS	RAR
KSR	TNGVLV
QAR	ERRVM
EVQ	RLN
KEVQ	RLN
GP	GVTG
EGT	NTG
TEG	GNTG
PGT	VTG
TGGEI	KGNT
PG	VTG
GETG	GNT
GAGR	SDQ
GAGRI	SDQ
GAMRAG	DYQ
SET	KGN
SEG	KGN
GET	AKGT
PRG	LS
PGT	GVTG
SRLNV	LGLLE
TAR	KSE
TR	NKSES
VRVA	LV
GLVR	NARY
IDDIFEEMK	KRIRVKDGK
DEIIEFMKGIG	KRIRVKLK
IDDIEEFMG	KRIRVKLK
IDIEEFMG	KRIRVKLK
HDIIEEFQQK	MGRRWRCRTDGT
DDYF	KRVRY
IDEIFQEKG	RRWRCRTDG
IDDIEFK	KRIRVL
IDIEFEK	KRIRVL
IDDIEFEK	KRIRVKL
IDDEIEFMG	KRIRVLK
IDDEYEFQGKQ	KRVRYLVGGNK
FFEIGEYGLH	IVGKRVRYRLDG
DVIEEFQQ	GRRWRYRTDGS
QRAPI	QKYVEA
RSKPV	QKYVEQK
RSKVP	QKYVDEQK
RSFKVP	QKYVDEQK
RSVP	QKYVDEQK
RSPV	QKYVEQK
RSKVP	QKDEQK
RSKVP	HQKYVDEQK
RSVP	QKYDEQK
RAQPI	YQKVDEAK
RARQPI	QKDEA
QPRA	DEA
RSVP	QKFVDEQK
RRAQP	AYQKYVDEA
RARQPI	QKYVDEA
RRLEPE	QKYKNEVK
RPFT	QEAT
REHSPL	QHNEVK
RARPQI	QKYVEA
AQP	QDEA
RARQIP	QKYDEA
RALRPQI	QKEA
RSFKVP	QKVDEQ
RSFKVPG	QKYVDEQS
KATHPI	AKVDEN
KATHPI	AKVDENS
RGP	VAQK
KRYQYP	QKYVDEAK
RSYKPV	QKFVEQK
RSPV	QKFVDEQK
RSKVP	QKFVDEQK
SRPV	QFVDEQKK
RVK	QKYE
RSFKVPV	QKVDEQK
RRLEGDPL	YQKHNEIK
KHPAI	AKVDEN
RSKVPF	QKYDEQSK
HQSQ	QPNSA
HGN	EQ
HGG	QPS
EGKKG	TPNSAL
EGKKG	TKPNSAL
RINLAQERRQ	LRLNPYVLKET
RINLAQEQR	LRLNPYVLKT
RINLAQERRQ	LRNPYVLKET
RINLAAQKERRQ	LRLNPYVLKET
RINLAQERRQ	LRLNYVLKET
RINLAAQEQR	LRLNPYVLKT
RINLAQERQR	LRNPYVLKET
RINLAQERQR	LRLNYVLKET
RYH	LKLPYM
RIYAKH	LKLNPYTM
RYAKH	LKLNPYTM
RTRLE	CRNPALLR
RKNKR	LGSEG
RYKH	LKPYT
VKVKR	KRPLKNVA
RNYA	VYLP
KGYIL	VRLIEVKRA
GG	GGDL
RHVD	DR
NHKE	KENH
ISLY	ISLY
NN	DTT
KENW	TYADSQ
EKLNGK	LSDRD
THGE	QRQ
TTV	TTV
SVQQ	SVQQ
NND	KDK
SAAD	DVLAM
SQFVSSADA	SMSAVLAM
QFVSSSADA	MSAVLAM
SAAD	DVLAMS
QN	AAGF
RQNA	AAGF
QRN	RAAG
LYTVQ	VQTLY
KDTLYQVT	TVQTLYK
KLYTQV	TVQTLY
TER	RER
RYEE	EER
REE	EEYR
REYE	EEYR
LRQQVQT	QTVLRQQ
QLRVQT	TQTVELR
ETGL	GLTE
LRTVQ	QTVLR
LHSQIAYLIL	IQLKIV
LDIDAQLL	QLKIV
TVLQTLL	IEASIVVIV
LTLTQL	IVQV
KNPL	WMNPL
YNPL	KNPL
HQAR	EDSQ
HARE	EDSQQ
R	EMDSQ
R	PPEMD
RIE	VETAD
IR	ETA
RY	LGRT
HHYQIGN	NGYQIHH
HHQIYGN	NGYQIHH
KVK	ELF
KK	ELF
KHKV	ELF
TGGQL	NNE
NYDASA	DNYPAAS
VTQN	NVTQ
NRPFNTAG	NRNPAFN
NNPANR	TAGNRPFN
KNEE	SFQD
QHK	IKAGK
ACKGQ	YST
LYMCCQK	YLCCKQ
LES	ATDI
PAD	GWK
AILTS	QTALN
FPRD	DRFP
RCEE	TNR
RCE	GDDTNT
QMDID	RRPL
QMDID	RPL
QSSGGIM	EQAA
HPGG	LNTA
RKVGKG	EEEP
QSSGGIM	EQA
HPGG	SLNTA
RKVGGK	EEEP
QSSGGIM	EQQAA
RKVGKG	ELEEP
TEEAT	RRA
MDGR	RESE
QMDGR	ERESE
QMDGR	RESE
QSKGKGS	EKEAESA
QSKGKGS	EKEAES
QSKGKGS	EKEAESE
QSKGKGS	EKEES
SSGG	QA
PG	LNT
RKVGKG	LAEAEPA
GTGEGAT	RRA
TEGAT	RRA
TGGEGAT	RRSRA
QMGR	ERESE
QMDRG	RRESE
DEW	HYR
NRTSEI	ACSKAEEVR
ADMLSRKR	KVIWNRQ
NVS	TN
ADHF	QRIRDFL
FEQLTPK	LKTLKV
FELQTP	LKETLKV
FEPT	LKTLV
FEQLKDT	LKETLK
FEQLKDT	LKETLKVTSN
FEQLKDTP	LKETLKVTN
FEQLKDT	LKETLKVN
FEQLKT	LKKETLKVTN
FELQTK	LKKETLKVTSN
FEQLKDT	LKKETLKVTN
GTSRYRK	KEHYD
SKRR	KED
RYRK	ET
FFFKM	LIPI
FMKY	LIPIT
KTE	LKTPL
RATILAEQL	EQLEAFV
EQL	AF
REHL	YFS
RGLA	PI
RLG	DPI
RRHK	DDLE
KTL	LKT
NYGEELHFVDQKKKLYFQETP	PTEFQLYKKKQDQFVLHGENY
KLTE	ELKT
NYGELHFVDQKQKKLYFQTEPD	PTEFQLYKKKDQFVLHGENY
NYGELHFVDQQKKKLYFQTEPD	PDTEFQLYKKKQDQFVLHGENEY
NYGELHFVDQKKKLYFQTEP	PTEFQLYKKKQDQFVLHGENY
KPI	DAT
RAHG	GTNAR
LNNK	WYE
LNK	WYE
LNK	WYEQ
RSE	YTNR
EKIGN	E
EL	PFDY
STWRP	QY
SRPST	QYG
TSWRP	QY
TWRPS	YGE
PDGE	NN
AWY	KPKSP
AWSG	KPKS
AWGS	KPKSP
AWS	KPKS
QR	STR
VDGSD	RN
DGS	REN
VDGSD	REN
VDGS	REN
VDGSD	RELN
EMITD	NIKRWA
ARPG	HNGA
RPGA	HNGA
HVMGRY	LVSM
IFVQAE	VTAGEK
IFVQA	VTEK
IGDC	AIVQ
IGD	AIVQ
TRF	EPGE
RTRF	QEGE
LWTY	LAPGEA
NL	VVDKMDV
LNSVH	VDKMD
LNHSV	VDKM
LNHSV	VDKMDV
QETGAQ	PS
VK	AHDF
QRRQ	DRKD
QRRQ	LDRKD
RQRQ	LDRKD
RSA	LGR
RAS	LGE
RSA	LGRR
RSA	LGRRE
RAS	LGRE
RR	LDRD
QRR	LDRD
RQRQ	LERKD
QRRKQ	LERKD
QRRQ	LEKD
QRRQ	LERKD
RRQQ	LDRKD
RQR	LDRD
QRRKQ	LDRKD
QRRKQ	DRKD
QRRQ	DRD
RRKDTQQ	LCDRKDQ
RRK	DRKD
RRQ	DRD
QRRK	DRD
RVMRQLE	LLRAIFGA
QARHGK	ETQLTPEEK
LEFLI	EELLIF
LEFL	EELLIK
LEFLI	EELLF
LFELI	ELLIFK
LEEFLI	EELLIFK
NTY	QLK
PR	DGV
KYRT	HGQ
KYR	YGSQ
KSRV	RG
VSQ	NQFK
VQS	NFKI
QVSS	NQFKI
WLN	SIDY
TPPTF	RTQM
EVLGEFD	GTADAEAA
EAARL	EAG
GEA	LEAAR
EAARL	EAGE
ERIL	LERI
TTL	TTLG
KSKRIRFLQ	NDLTFLRIRK
KSKRIRLFTD	NDLTFLRIRSK
PSRDL	RR
TTL	TTLS
NEDL	TKQEK
RVR	ISDLN
NAD	DAN
NDA	DAN
VVMRLIDLTVEKQLYIL	QRVEMRQMILREEQLLRIL
QRVEMQRMILKREALLIRKL	EMDVVMRQLIDLTAVLKIYLT
EMDVVMRLEQITLAVLKYIL	QMRVEMRQMIKLREALLRIL
IEMDVVMRLQITLAVLKYIL	IQRVEMRQMIKLREALLRIL
QRMVQEMRMILKREALLIR	EMDVVEMRQLIDLTAVLKIYL
EMDVVMRLQIDTLAIVLKYIL	QMRVEMRQMIKLREALLRIL
AHMLILKVIETGITLDREVMMED	MEMDVMRLEIDTTGIVELKIHLMA
IKLLQLGVLRMITQMVEQMVI	IQMVVEMQMILTRGQVLLIKL
IKLLQLEVRLITQMMRLVEMVIQ	IQMRVVEMRQLMILTREQVLLI
ILLQLEVLRITQMMRLVEMVQ	IQMVVEMRQLMILTREQVLLI
ERQMLREQLLILQ	EKDVMRLEIDTIVLKH
ELITQMMLVEMVIQ	EQMVVEMQLMILTRE
QRVEMMIQ	EQLIHLV
LHVLIVKIQETILLDMQRV	MQLIDLTEIQVLKIHLVQSEI
RLRQELLIKRLQ	EMDVMRLIDTTI
QMLKREQLLILK	IEVMRLIDTEIVEK
LERITQMMLVEQMM	IEQMVVMQLMILEQ
SLQHVLIVEQTIILLDM	VMRQLIDLTEIQVLIHL
QMILRQLLILK	MIMDVMRLIDTI
MVVMRLQILTEKQLVYILT	IQMRVEMQMILREEQLLRIKL
QMVQREMMILREQLLIRKL	MVVEMQLILTEQVLIYLT
MVVMQLILTERQLKYILT	IQVEQMILREQLLRIKL
MVVMLQILTEKQVLYIL	IQRVEMQMILREEQLLRIK
IEMKDVVMRLQIDLTEKQLVYILT	IQMRVERQMILREEQLLRIKL
RQQM	KDIT
IMDVIMRLQIDLTERQILKHILIP	IQRIEMRQMLEQLLRINL
IQMIREMRQKLTREQELIRL	IEMDIVMRLDLTEQILKIHL
MMEQDVMRLQIDLTEIRQLKHILIPV	MIQMRIEMRQMILEEQLLRINLR
MIQRIEMQRMILKQERELLIRN	EQMDIVMRQLILTREQILKIHLI
EQMDIVMQLILTIEQLKHIL	QRIEMQILREQLLRIL
MEDIVLQLTEQLIKHILIR	IQMRIERQMLEQLLRINL
IEMVIMRLQIDLTIEQLHIL	IRIEMRQMILREEQLRIN
EQMDIVRLMQIDTLEIQLKHL	MIQIERQMKLEEQLLRIR
EMIQDIVMRLQIDTLIEIQLKHI	MIQIEMRQMIKLREEQLLRI
IEMIVMRLQIDLTIEQLKHIL	IQMIEMRQMILREEQLLRIN
IEMVVMQLILTEIEQVLKYILT	IMVEMQILREQLLRIKL
IEMDVRVMLILTVEQLKYIL	IQRVEMRQLRQLLRIKL
NVST	TDFVS
QER	SSGGES
QER	SGES
ERVPSE	REVSP
EKKE	NYV
FREPQR	TYA
EDKR	KRED
GAK	DKD
KAHKG	ALDKE
MKL	MKL
MKL	MKLS
SDV	MKSG
SD	MKSGG
KSGM	AEDVS
LTR	RLTS
LSMRT	MRLTS
LRT	RLT
ELMQ	KQMGW
KHDD	DMNR
YGIK	VPMN
SSQDQ	QQDSS
SSQQ	QQDSS
REFA	EFAR
DA	GTN
FSQGR	FPFDK
FQGRS	FPDK
KYVIQ	VIQKY
TALEQ	EART
KFSG	TASE
QGMFPT	GSNR
WGQGAVTGPF	GWQGPFGAVT
SAMAYEIN	YAMIAN
GGR	WFGGR
HDKD	MNR
ESRK	KRSEEE
NQ	ANTG
KRD	NAHQS
HNNN	RHGYEF
EGQIR	QLHN
KFNT	RHG
NS	FGNS
IGNQ	NGI
NDGS	FGNSP
IGQ	NGI
NGS	FGNS
NDFGS	FGNSP
TFG	TDV
NAQN	NQAN
ANQN	NQAN
EDSP	EHQ
RP	ATEW
PPSLSLG	DLTK
RWGKVGRTG	GPDRWDPMY
KWGV	RVWGK
KWGVG	RVWGK
QEKTD	TSR
EGNCP	NCGE
QKVLQF	KYIVDV
KSGEA	THRQ
LPYSVTVEI	KIKSTISR
ERAAD	TGE
ERA	TG
ERAA	TGVE
VR	PGSI
ERP	AGA
RA	TGVP
RVTP	EP
RAA	TGVP
RAA	TGP
ERAA	TGP
ERA	TGP
ERPA	AG
ERPR	AGL
HRVTS	GIDAS
VRVT	GIDPV
VRQ	PDLEH
YHV	SGTME
ERTRR	ASVDVD
ERA	TGV
IERAADNAV	TGPVDEI
ERAAN	TVED
ERAANVA	TGLPVED
VRVT	PGEVI
VRVTP	GPEVDIQ
RAA	TG
ERAA	TGE
RPR	AGAVD
RAN	TGVP
RAN	TGV
ERPKR	AGAL
RAA	TGPE
RAN	TGP
VR	PGRID
VR	GRIDP
RAAN	TPGV
RAAN	TGPV
ERPAKR	AAGLD
RPAK	AGDLAL
RPKR	AGVA
ERPAR	AGAMDL
ERPAR	AGVA
ERPAR	ALA
ERPAR	ALAD
ERPAR	AADL
ERPAK	ALAD
KTP	PEDV
ERPAR	AD
EVRVTP	GPIQ
EPA	GVD
ERA	GTVP
RAA	TGVE
RA	TGVPE
RA	TGV
HRVT	ADI
EVRR	RPGI
ERAA	TGIE
RA	TGP
ERAA	GTVE
ERAN	TG
RAAN	TGVE
RAAN	TGE
RAA	TGE
KEL	LNAG
RGL	YVSGA
RLAPIVGKPLEIVFMKAK	ELLYGMDFRFSRN
RLAPIVGKPLEIVFMAK	ELLYGMFRFSRN
VNLNR	KSRYSD
NLNQ	KSRDYS
NLN	KSRDYS
NLNRQ	SKRDYSI
NLNR	SKRDYS
NLNR	KSRDYS
NLNRQ	KSRDYS
NLNRQ	SSKRDY
QG	QGGYQ
QAR	DAEA
VE	EDKHY
HEDK	ETE
VSGAEL	YHKT
GADRM	YHKTE
IGSGA	HYK
IGRSGA	HYK
TSSAR	YTKE
GADTSADR	YKET
VELK	YKT
AEKLKKLSELILTWEKLTEIAQRQQL	AEKLKLKSEILLWTELEKTAIRQQLQM
LEV	RTG
EGY	GPD
RVNDFN	EADKVS
EDEKK	QNHE
EQG	QGE
RFTH	TRFH
EPD	KMS
EAN	EK
LHQR	SKYNS
PHHRPGR	HPHRPG
PHHRPG	HRPHPG
PHHRPGR	HRPHPG
PHHRPG	HHRPPG
DPHHRPG	RHPDHPG
YLYL	VVY
RFAIVQLTL	TLLVQAIEFR
TDLKIKS	YIDLAQN
FYEVTLLD	LLDVTEIYFE
ILSILKQL	LLQIKLSI
LQIK	II
KDNKII	AINKIHD
RVE	RKW
REVE	KKW
SKAQR	YAD
SRVGLEL	GLELVSRV
SRVVGLEL	GLELVSR
ERTTGVEV	GVEVTTER
ERTTGVEV	VGEVTTER
RPN	LNLKQG
TYDE	RLAVLGHKR
DAQNQ	QKN
GAVYP	PAVYG
HALP	LPAH
AEWPT	LAEPT
AD	EKNW
VEVKGAF	KEGERE
RVLHDTI	LHRTID
PEQ	PEQ
IAPI	IAPI
R	WLQGE
RSGF	KLLP
LLKP	GFRS
TTP	PTT
RTSI	IRTS
NR	GDNI
IKGT	IPNVYF
IPNVYF	IKGT
IPNVY	IKGT
IKGT	IPNVY
TTYF	IKG
IKG	TYFT
TTYF	IK
IK	TTYF
IK	TYFT
IKG	TTYF
TTYF	IKGS
IKGS	TTYF
PGQY	IKGT
IKGT	GQY
GQY	IKGT
IKGT	PGQY
IKG	GTYF
GTYF	IKGS
IKGS	GTYF
IKGS	GTYFK
INVYTF	IKGTI
IKGTI	INVYF
NVYTF	IKGTI
IKGTI	INVYFT
INVYTF	IKGT
TTY	IKG
IK	TTY
IKGS	STYF
STYF	IKGS
DSF	TSFPD
IKG	STYF
STYF	IKG
IKGS	STYFK
STYKF	IKGS
IKGST	STYFK
IQGS	STYF
STYF	IQGS
AGLQ	IGDN
VGQYF	IKGT
IKGT	VGQYF
IKGT	VPGQYF
VGQYF	IKG
IKG	PGQYF
VPGQYF	IKG
VPGQYF	IKGT
STYF	IKT
IKGT	STYF
STYF	IKGT
IKGT	TYFS
IKT	STYF
TY	KGGV
VKGG	YT
LTEYD	LKNNKG
LKNNKG	LTEYD
TTY	KGI
KGS	TT
TY	KGI
IKGS	YTT
TT	KGS
LKLLETLHDQLKHEVLKELRLEERMLK	LRLKLELTHDQELHEVKLLELEREMLQ
VKMG	RI
RI	VKMG
TIK	GPKE
YNGNCSN	HHPENK
KL	GMDV
IELQ	LRGES
KGY	PG
KGAY	PG
KGY	PGE
KEQ	RLQQEG
KEQ	RLQQEGE
KELQ	RLQQEG
DYEK	KIGS
ARQNRNI	EQNGES
RQEGN	QERNIN
QGENRNI	RQQNEGES
QEGEN	QERINN
PGMTDNT	TNMGTDKP
KPGMTDNTT	TNMDGTP
KPGMTDNT	TNMLDGTKP
KPGMTDFNT	TNMDGTKP
KPGMTDNT	TNMGTDKP
PGMTDFNT	TNMDGTKP
VPGMDNT	MTNDGTP
VPGMTDNT	MTNDGTKP
PGMTDNT	TNDGMTP
SIPD	KN
SRNS	KND
VKE	NVK
RLAC	LARLAE
SDGE	ANYN
DGE	ANYN
EIH	RKDT
KTELLQ	TKELLQ
DDTP	PDTD
FRYK	YKFR
RYK	YKR
QA	KLSG
KLSGR	AQ
KLSG	QAG
GTG	YGLT
IHTYNGLLT	HITYNGLT
KDFS	FSK
KDFS	DFSK
FLQR	PSL
FLR	PSLL
IHETYTGLS	HITYETGL
YSI	YSI
SESAS	R
TMKAIAFV	VFAMAITK
HSTE	SHTE
QKM	GTE
TMKAIAFV	VKFAMAITK
QSEE	GKE
SDI	ASDLI
ETE	ETE
ETE	ETEE
DID	KER
FMSSS	ISPI
FMSSS	ISP
FRFK	FFRK
ESDGSS	RKLH
RKLH	SEGSSWSD
SQRDTAE	EDTARSQ
EDFKH	HGD
FDRK	HEG
DN	QVGS
SDQQN	W
W	SDQQN
NTTG	SYA
SRQRAENKNDRE	MQQTEKKT
SRQRAENKNDRE	MQQTETKK
VEKTMNKKNL	SLDGRAAQAR
VEKTMNKKNL	SLDGRATARQA
RRKQME	PYNVFGP
RRKQME	PYNFGVP
PTGKSY	YPAADQ
IDSTPL	NAKREIDS
TPNGQ	QL
TGG	GLV
IVINWVVVVAAVAF	LWPSTPVITILIN
FNWL	IW
L	VSGAF
WL	VLSGA
YIWLVLQ	DAKHFFW
FLLIVTD	ILLLN
IILVFLLIVD	LPRVILLL
YIWLPLQ	DAKHFFW
FLLITDL	ILMLNL
IILRVFLLIVD	LPRVILLL
YIWLPVLQ	DAKHFFW
SYW	RPFV
PRFVF	MIWRFL
IRFLII	PRFVFVL
MIFRFLM	DPRFVGVFV
FLIL	FLL
SYNW	PWFRW
SYW	PFVR
LMILST	VFLWDH
LMIS	LWP
FVSS	WIN
FVLS	YVLV
FGLS	FFDH
TLFGLSNW	FSGYWQS
LMILST	VLWDFH
LIS	LPW
HMLS	FV
LMIST	LWP
HMLS	FVL
MIFR	RQLY
VFFLVMLILS	VFFALIWV
WMIFR	KEN
LIST	WWN
LILLST	WWNP
DRR	ASSPG
MLTN	IIH
FLSTNW	LLLAA
LDRRVTA	YAVLDGPEQ
WMIFDPRR	PNAAG
VLMLI	FSL
MIF	VSF
WMFDPRR	PQPLAAN
FLMLI	IFSLAD
WMIRFM	MKGWAGFL
DQLY	RMAGAGF
WMIRF	MKWGAF
RQTP	RSD
NLLKE	ELEITV
NLLKE	ELITV
NLLE	ELITV
LLKE	LEEITV
LLKS	ESVIN
LNLK	EVIN
LLKE	LTV
LLE	LITV
NLLE	ELI
NLLKE	ELI
RDLLQ	ENAQIN
RDLLQ	ENAIN
KRLLQ	EAQYININ
YV	IIVYISI
Y	IIVYIS
EFSK	KEFS
EFSKT	KEFST
KYQ	FSET
LVYG	GTKK
VYG	KGK
VYG	KG
LVYGKD	GTKK
SFE	KYQG
KKGT	YGLV
KG	VYG
LVYGD	GTKK
KHI	KGY
YGK	CGKH
KKGT	EMLEGNE
HEKKPMT	MTKPEKH
KKG	YVG
FK	GIP
RLR	YAR
RHSLED	EDS
SLED	EDS
PDKS	SNGD
RNRHDW	DRRHRN
RDSD	KY
KY	RDDSK
QETIVNR	IVNRTQE
QETTIVNR	IVNRTQE
NTD	EGM
GVASHD	RS
GDASHD	RS
DASH	RS
GASHD	RS
GASH	RS
NNQ	NNY
NNQ	NNYT
NQ	NYNT
TNYN	QNN
TNYN	QN
SEKE	RELNEK
NEGK	DN
NRFS	NRS
EKNG	KE
KWK	DS
EVLEGQ	RKILT
GLEGQ	QGD
KRVDEIR	EGQ
LEGQ	QGD
MILP	FGP
MIL	FG
GMILP	FGP
QSG	QDKM
DVAK	KGH
DVAK	KHG
AAHAAKKSA	KSAAKHAAA
EEYFS	YWP
EEHI	YPCE
FTIE	TIEF
SHF	HSF
FTIE	TFI
FTIE	TEFI
TDKPVTRWH	RTWHVPDKT
EQKQ	QHLTE
PSL	PSL
REEQE	HGY
YREEQE	GHY
TGDPT	TDT
KILDAKAQANDAAADAADARARLM	SILANAASAARNAAQKAAANDALM
IDLSAQANADASANARAQAKAAANLDM	KILQDAAKAADAAADAADAARRLM
ILDATAKAADAAADAADAARLM	ILSANAADASANRAAQKAANALDM
KAADATAKAANDAADAADARAR	ADSAANAADASARNAAQKAAANDAA
ADASAQANAASANARAQAKAAANAD	KAADAQAKAADAADAADAARR
KAADAAKAADAADAADAAR	AASAANADASAARAAKANAD
KWQWDWWKWWDWAWDWWDWWWW	WDSWWWWNDWWRWWQKWWNAQDWAT
WWWWNWDWSWNWRWQWKWANQWDA	KQWDWWKWWDWWNADWWADWWWRW
KQWDWWKWWDWAWDWAWDWWRWW	WSWWWWNDWSWRWWQKWWNQDWAW
KQWDWWKWWNDWAWSDWAWDWWRWW	WWNWWDWSWRNWWKQWWANQDATW
DQDWWKWWDWAWDWWDWWWW	WSWNWWDWWNRWWQWKWNQWDWA
KFFDFFKFFDFAFDFAFDFFRFFY	FDFFQNFFDFSFNRFFQKFFNFFDFAY
FDFSFQFNFDFSNFFRFQFKFAFNFDFATYR	KFFDFFQTKFFDFFADFFDFFRRFFY
KFQFDFFKFFDFAFDFFDFRFRFFY	FDQFSFNFFDSFFNRFFQKFFANFFDFAYR
KFFDFTFKFFDFAFDFFDFRFRFFKY	FDFSFQNFFDFSFNRFFQKFFANFFDFAR
KFFDFFKFFDFAFDFFDFRFRFFYR	FDFFQFNFDFSFNRFFKFFNFFDFAYR
REYRSQN	RSQNEYR
KYASNLDEKFMQVLKMLLEQLSRQYKEFEKAHLQQFVKALREL	YKANMSLDKEFMVKLLQMLELRQSYQKNEFEKHEALQFQVKLAREM
KLLEE	LEELK
KYASNLDEKFMVLKMLLEQLSRQYKNEFEKAHLQQFVKAL	YKANSLDKEFMVQLLMLELRQSYQKNEFEKHEALQFQVLA
GCPS	GCPS
SCDSG	IKY
PCNGFGIYC	NPSIGLE
QLKVLNLTHNSLSGSILLNL	NLEVLDLNSSDFSGLFPLIN
QLKVLNLTHNSLSGSILLNL	NLEVLDLNSSDFSGFPLINL
QLKVLNLTHNSLSGSILLNL	NLEVLDLSNSDFSGLFPLLIN
QLKVLNLTHNSLSGSILNL	NLEVLDLNSSDFSGLPFINLL
SGS	SGS
QLKVLNLTHNSLSGSILLNL	NLEVLDLSNSDFSGLFPINLL
SLTTVDLSYNILSDKIFI	SLKYLDLNTHNLSG
KNLGWLFLDENKVKLLKD	KKLKSLSLENHGIDLLGH
KNLGWLFLDENKVKLLKD	KKLKSLSLENHGILLGH
KNLGWLFLDENKVKDLSLKD	KKLKSLSLENHGISDGLHL
NFRLT	SYN
NFTNLKVLNLSHNN	TLLSDEVLDLSYNS
NNGI	END
RNLKELDLS	EDLKTRNV
VTNLKELDL	LTNRV
AAA	GGGLD
ANASLTELSLRN	QLIQYEVVRL
AAE	ERQLS
NASLTELSLRN	LIQQYEVVRL
VNPALAELNLRN	QLLQCQVVRL
KNLNELRLDFNKL	TNLTALYELNYQLQ
KNLNELRLDFNKL	TNLTALYLENYQLQ
WLPRLELLDLRGNKL	LLLSRTLNSHRI
IIN	NSD
NSD	IIN
WPRLELLDLRGNKL	LLSLRTLNSHRI
W	FLKTL
LKNLEVLFLNGNSL	EKLGILYLNNNQL
QNLQQLHLSKNQL	QNLQKLKLYNEQL
TKLKEFSIVRNSLSH	THLIRLYLQNDQINH
VNLTELSLVRNSL	TSLRKLYLQNDHI
VNLTELSLVRNL	TSLRKLYLQNDHI
TNLQNLDLSFNQL	TNLQTLHLRNSQL
WLPRLELLDLRGNKL	LLLSRTLSNHRI
VNLTELSLVRNSL	TNLRKLYLQNDHI
VNLTELSLVRNSL	TNLRKLYLQNDHIN
TNLTYLILTGNQL	TNLKELVLVNEQL
TLTVLDLGTNQL	VHLKELFMCNCKL
TQLTVLDLGTNQL	VHLKEFLMNCCKL
TLTVLDLGTNQL	VHLKEFLMCNCKL
LSN	LNR
LNR	LSN
FLEELDLSYNNL	VSLHTLSLNDHMI
YGFALPNLLQLHLEHNNL	FPLPSLERLLLGNYEI
SQLQELYLQNNDL	TKLKKLNLNANKLR
SLQELYLQNNDL	TKLKKLNLNANKLR
TQLTVLDLGTNQL	HLKEFLMCNCKL
PLQHLNLQGNHF	GRLEILVLSFCDL
ALNTLELFDNWL	KLRELWLNRNPIE
SKTLV	TKLVS
LTILR	VVIFKI
IRQIIL	RLFLSK
VIVVLK	RIFIE
QIFVR	EALSII
KILLK	RIYL
ITLITS	RIVTQ
KEFPML	EED
IVVLR	IRLVELG
KMFLR	ILFYR
LYIRG	LKMIR
TLLQS	IRVVIM
IIMLEA	RYIVQ
IRFLIL	RLLVL
VSMTV	IRSLT
IVVLR	IRLVE
KMFLR	ILFYRI
VLYIRG	KLMIR
ITLLQS	RSIVVIM
IIMLEA	RIYVQ
RFLIL	RLLVL
IVVLR	IRLVEG
KMFLR	LFIYR
TLLQS	IRVVMG
IMLEA	IRYVQ
RFLIL	RLVL
VSMTV	IRSLTE
IVVLR	IRNLVEG
QVYIR	EALMII
IRYFIL	RLFMK
RIMLK	RGIYLV
ILSTVV	RINIY
LTILR	VVIFK
IRQIIL	RLFLK
DQIFVR	AELSII
KILLK	REIYLV
STVV	AIN
IRQIILP	RLFLK
IVVLK	IRFIE
QIFVR	LEAISI
TLIT	RGVI
KILLK	REIYL
TLITS	IRVTQ
EIFIR	LKVVIV
ISLEA	VRFQI
VRYVYL	RIFVME
VTLIST	RLFVD
EIYIR	SSLSVL
IKFIKL	RLELQA
VRYVQL	RVFLMIP
VVLVAP	RIFAD
ECYIR	CPILVV
KYLRI	VRIYL
LDQILLN	TSIYLV
VAVSH	VHVSA
VAVSH	HVSVA
VAVH	VHVSA
AEREEKRV	QAEREEKRV
NRSRIQ	NSRIQ
KFIVV	LRQITL
AQLLR	KLIFKI
VMYISE	SLLMRHG
LVSLSS	RIYIE
IH	IGEVE
EIGEV	HI
DIH	EVV
DNR	NGE
YIH	QNEV
DIFN	QPEA
KLNLDE	KKD
KLNLDE	KDK
DFN	PRLL
FN	RLLP
DGRV	YP
FEQI	YRQA
DR	ENAN
DRK	ENA
VGP	GEA
AEEK	KEAE
VKEAA	VKAKEA
VKEAAK	VKAEA
AEEK	KEE
NENA	NNEA
ESQFGSGG	GSGFGQES
VTKHI	GQKGSS
KRR	IGSEQ
DSAHKER	HKRDSD
MSRH	DAES
AESD	RHAMS
KAKDSD	QRE
NTHVQ	NHQTV
NIPDTAN	KGRTDV
GDQAR	RTDGRNK
NGNNIP	ATTV
QIRGC	WG
GIQ	QGI
RFE	GDIA
NN	GDWS
YQGISLSDE	AGIEDNC
RGISDSW	NN
FARGTT	RRF
RRYGTT	RRGY
EMRGLES	RGYS
YRRYGTT	RRGY
GVTE	AKG
YQGISLSDE	GAESIDCN
NN	RGISDWS
NARIS	QL
DQLD	RQ
DQLD	QLDE
DHALDA	KHALDA
NTEGGAY	EENLTK
NG	DTSR
NGK	DTS
RQE	QER
SDA	QTKY
SGV	KG
NCI	NCI
WTEQQ	ETQWQ
EQARHECIRA	SRMAEVKNGL
LRLHIQVEIIKLIVLKTALIHLM	LDLNEIVKIIILEIDLANTLEILVM
LRLHIQVIIKLIVLTALIHLM	LDLNEIVKIPIILEDILTNLIELVMM
LRLHIQVEIIKLIVLKTALIHLM	LDLNEIVKIIILEDILANTLIELVMM
LRLHIQVEIIKLIVLKTALIHLM	LDLNEIVKIIILEIDLANTLIELVMM
LDLNIEVKIPIILIDLTLIELMMI	LRLIHQVIIKLIVLTALIHLM
LRLHIQVIIKLIVLTALIHLM	LDLNEIVKIPIILEILTLIELVMM
LRLHIQVEIKIKLSIVLKTALIHLM	LDLNEIVKIIILEDILANLEILVMM
IHENQIILELLLKVIKKINQNILELSIM	IKEDNIKKLLSLEVISQIQRSILHLI
KIDNIKLSLLEVSIQIRQSILHLI	HINQIILELKLVEKIINNQISLELSMI
HEQSESE	GSHSTINK
KIDNIKLSLLEVIQIRQSILHLI	NIHQIILELKLLVKIINNQILLEMI
SESI	KK
KNISTEGSS	EESLSQH
KIDNKIKLSLLEVIQIRQSILHLI	HINQIEILLKLLVEKIINNQILELSMI
IHNIILELLLKVIKINQNISLELI	IDNILLKLSEVISQIQRSILHLI
KIDNKIKLSLLEVIQIQSILHLI	NIHQEIILLKLLVKIINQQILELMI
KIEDNIKLSLLEVSIQIRQSILHLI	HINQIILELKLLVKIIKNNQILELSI
IDNIKLSLLEVSIQIQ	IHNQIILELKLLVKIIKNQ
IHNQIILELLLKVIKKINQN	IDKNILLKSLEVIQIQ
IHNIILELLLKVIKKINQN	IDNIKLLSLLVIQESIQ
KIDNIKLSLLEVIQIQ	HNIQIILELKLLVKIIKNNQ
KIDNIKLSLLEVSIQIQ	HINQIILELKLLVKIINNQ
IHNQIILELLLKVIKINQN	IKDNIKLLKSLEVIQIQ
KIDNIKLSLLEVIQIQ	HNIQIILELKLLVKIINQQ
KIDNKIKLSLLEVIQIQ	HNIQIEILLKLLVKIINNQ
EDKK	KKED
KIDNKIKLSLLGEVSIQIQ	HNIQIEILLKLLVKIINNQ
IHNQIILELLLKVIKINQN	IKDNIKLLSLEVISQIQ
KIDNIKLSLLEVIQIQ	HNIQIILELKLLVKIINNQQ
KIDNIKLSLLEVIQIQ	HNIQIILELKLLVKIINNQ
LEVDVLAQGSVIKLSVKLAIEMA	LHKVVQKMVIQELVTTLIM
LDLNIEVKIIILEIDLATNLIEL	LRLIHQVEIIKLIKVLTKALIH
LRLHIQVIIKLIVLTALIHL	LDLNEIVKIPIILEDILTNLIEL
LRLHIQVIIKLIVLTALIH	LDLNEIVKIPIILDILNTLIEL
LDLNIEEVKIIILEIDLATNLIEL	LRLIHQVEIILIKVLTKALITH
LRLHIQVIIKLIVLTALIHL	LDLNEEKIVIPIILDILTLIL
LDLNIEVKIPIILEIDLATNLIELV	LRLIHQVEIIKLIKSVLTKALIHL
LDLNIEVKIIILEIDLANLIELV	LRLIHQVEIIKLIKSDVLKTALIHL
LRLHIEQVIIKLIVLTALIHL	LDLNEKIVIPIILDILTLIELV
AVII	AVII
RGM	LD
ESRIEA	EARISE
QIDE	TDFKQLL
RKY	EKII
QGD	GQDP
THI	IHT
NDTSLL	QQS
TTHN	ND
RGGS	GSRG
RAQLH	LNME
RAQLH	LNAME
RAQLH	LNEM
RAQLH	LME
QGR	RGAQ
AYLDII	YALIID
IQTSE	RRQ
KAKN	AE
RERGD	GGD
DTT	TDT
LR	PIGLAT
FEQIHELDTF	TEKPVNDA
FEQIHEDTF	TEKPVNDA
DGII	ATAE
PVYHGNE	ERAGN
EIAEE	HE
DR	ESGQ
ENKQ	TKG
ENKQ	TG
MDYGR	RSKKER
GK	GKD
KDLSPEN	DGIDASA
EGQS	GQES
KRERD	ESLA
ETRQ	QEN
EISVNAKVNRN	HFPKEECVE
SIKIDKVNE	LSYRISD
VRL	IDKV
AKV	FPSR
GIL	SEYRS
VNKVNRP	PKEFECE
RIDHT	VYDSIS
GIVIDRVNI	ITYKISDR
GIPVIDRVNI	ITIYKISD
DVA	ADG
MIIY	DIYST
MIEFVKN	IKDQDRE
MTLETVK	IKDQR
GIPEQ	EIG
INLQ	QNL
SSHV	SSHV
SSHV	KSYF
ED	SEK
KPKIY	WVDT
KPKIY	WVDGT
LYGLAGGRTTDLKIIVNSTS	GAGILLAANVEALVNE
PAST	RL
LAST	LR
GVQ	DSG
SVICP	RDIAY
DRIAEY	VSCPI
DRIAY	VSCPI
SVICP	RDIAEY
LWPVL	LEQGNA
LWPVL	LQGNA
QLGNA	WPVL
QLGNA	WPLVL
LPVL	LGNA
QLGNA	WLVL
QLGNA	PLVL
DQNLTKK	KTEVK
QLNA	WPLVL
NTH	NKQ
LGNA	LVL
QEE	QEEK
LPVL	LQGNA
LWPVL	LQNGA
ENL	HLL
LHL	LEN
NLSRP	RPSNL
LPVL	LQNA
LWVL	LQNA
LWPVL	LQA
EEH	HSEHP
EEHR	EHE
EEH	HEHPS
QLNA	WLVL
LWPVKL	LEQGNA
LWVL	LQGNA
NDE	DNEG
NTV	LASII
NTSV	LASIIE
REAEE	KK
ESH	HES
NAGIP	AGI
HAGSALAA	ALAAAGSVH
AGSALA	AALAGSA
SGERD	EGRD
EQ	HES
VHES	EQL
IKAG	KIADG
EDG	DEG
GERD	GRED
VLLIH	HLAILSV
SVVKDGL	KVVDGL
EIAG	GQLR
LDR	RDD
TSDF	GNQHIP
GNQPGD	QGDPGN
NRD	PGQH
EK	SGEG
RIEPT	HAMAQSV
LEMDAE	RNGLN
SLEMDAE	RNTGL
QKT	KGVEN
QQKT	KGVEN
QKT	KEGVEN
LEMDAE	RNTGLN
QTKT	KDSEN
DVGV	VEGV
DV	VDV
SIVKA	VKSI
VILH	ILVH
DRIQSSG	PGLTEQ
YHNLNVNNCK	NHYLNVNNC
YHNLNVNNC	NNHYLVNNCK
NDT	KPAI
TYSP	TYS
AKIP	DNT
TYS	TYSP
DPT	ARG
SKG	SKG
KNFNKKGG	KEDLSQDE
KEDLSQDE	KNNKGG
ASLSA	KSAELS
KADK	DKKA
DGVRPFR	RRTTGD
DGVRPFR	RTTGD
DGVRPFR	RRTTDG
LGAVLDGANLHGANLNNANLS	AMLTARNLEAQDLSAGRTTAG
FNGSALIGADLHGADLTNG	TSFKAGDLTANVLTAEI
FNGSALIGADLHGADLTNG	TSFKAGDLTANVLTAEIM
CIIRALFENS	NCSFKLNSINE
CIIRALFENSF	NCSFKLNSINE
CIIRALFENS	NCSFKNSILNE
MERFVDCKMLGVNWTAQAAL	GASELFRCILNSDLFLYYAK
MERFVDCKMLGVNWTAQAGAL	GASELFRCILNSDLFLYYAGK
DNTGP	NRSN
LGG	GGPL
DENTLGG	DETPNLGG
DNTLP	RFSN
DNTLGGP	RFSNN
HKEG	EPYLDPK
VKE	KEV
SLKE	KVS
AASFADSS	DSSASFLAAF
AFSWQ	GWSWSLD
AASFADSS	DSSSFLAAA
AFSFLADSSGQ	GWSWSLD
RDVE	YSKR
ESFK	GEEWWG
KGQLI	RSKSG
ESCK	SCKE
ERDVE	KYSR
KNQH	YNNPKL
KAG	DGYV
RT	GIQE
RMFE	PQQAMFALLQ
RMF	QFALL
FSFMLASN	MEKALLNP
FSFMLASN	EKEMLLNP
FSFLASND	MEAELKLNP
FSFMLASN	MEKAELLNP
KTA	NAYA
FSFDH	RYEVNKE
QKGIPV	PDEAYIRT
CADNR	RDCA
SDTI	LET
TLSV	VLT
EQQWVSGWRLN	RWLNSGVQWEQ
KTND	KNDTK
KTND	NKT
KTN	KNDT
KTNSD	KNDT
SKEKLS	KEKSLS
HRLA	ALHR
TKEQ	EE
GGR	SNE
VKEQ	EE
KEQ	EE
PDMN	RK
KM	QSLYG
SH	HSEK
SKMN	KMNS
EHGDF	IYG
GQ	PAG
KESG	EKAN
TEQ	QSH
ISTDT	YAR
TGSEIRARDDA	LESSYITIAVRHR
TSATES	NWLRQ
CTSAE	NWR
TSAE	NWR
TSATES	NWLQR
TSATES	NWRE
TSATES	WNRE
TSATES	NWRQL
TSATE	NWLRQ
TSATES	WNRQL
TSATESE	WNRQL
TSATES	WLNRQ
NVL	LNV
RNGK	NRGK
SK	KGE
HTPETVIDG	IDGVTTPEH
HTPETVID	IDGVTETPH
EQR	END
HVNVQPKS	QPKSVNHV
VRDK	RVDA
ARE	YRN
ERNY	REAR
PNDP	DVR
QFRNTFSTTKGFV	DLVLVATIAEGAL
LPFTS	WDT
NVNI	KYV
PLQ	VNP
DSR	RATVL
DSR	ATVLR
RDKHS	DRHVSSK
SPLQ	QLPS
KDIGM	DKMGI
KDIGM	DMGI
KDIGM	KDMGI
QYPM	YPMQ
DVSE	VSD
TLLR	LRLT
QPGQI	PQQIG
LSR	RPPS
TPVT	MY
GPVT	MY
EQA	NGQ
NEQA	GNQ
DK	PEKN
RST	EVPG
RST	EPGV
KNG	GNK
KLV	VLK
LSD	ADWRDK
TGS	WDR
QTF	DNE
TDKN	TTGY
KNQLIIT	YDASTGKIMM
GGSRER	RELE
DK	VQL
EVPE	SSMRSQ
EPE	SSMRS
EPE	SSSMRSQ
LGDR	RGDL
QTH	EYETHG
LRLA	YLSALL
SWSKD	GYDP
NNTE	ENTN
KERQGID	SEENK
KERQGID	SENK
KERQGI	SIENK
IQ	AEIA
QQN	QQMQF
EGKK	KSE
WYWTYHL	LHWTYYW
SNKG	SGV
GKATVQE	RLQ
AKTR	YTSYG
RGE	ATNQK
RE	ATLNQK
QLNQ	NG
PLSGILGLVVY	ELAASFIFW
PLDGLLGLFAY	EMAASFIW
PLCGILGLV	FITAMVTL
GFYYKR	LSIVGLGWVLLQ
GFYYKP	LSIVGLGWVLLQ
GFYYK	LIVGLGWLLQ
PLGLLGLFAY	MEAASFIW
PLGLVGLFAY	MEAASFIW
PLGLGLFAY	EMAASFIW
LATGGYY	WLVVTW
LLATGGYY	WLVVTW
LATGYY	WLVVTW
YLTAALFR	LVGLLIQ
YLLTLY	MVGIVLVE
YLTAALFR	LVLLIQ
YLTAALFR	LVGLLLIQ
LAAYFLFTAL	ATLVLVTSWW
LTSYLLALTY	AQIACVAFLW
LAAYFLFTAL	ATVLLVSTWMW
MMTGLIGFLLE	FSLSVFWGLLS
LVLLLI	VVW
LVLLL	VVW
LSLIVGWLGVLLQ	LFTIAVGLWN
SRRTP	NT
ERAQ	AQRE
SDQH	ISKDV
FNDQ	RKSVL
KAK	EGKE
KAK	EGEK
TVKITHI	GGF
QVDR	RQVD
TR	KRG
WEGSN	DGE
PSK	KGP
NRKT	HKC
NDP	DPN
SSNE	NESS
VPERR	TKE
PETKE	KE
PRR	KTE
VDPRR	KTE
NEGRY	RGYIDFG
DNER	REND
KNEGRY	IRYGG
EGR	RYFGGQ
DNERY	RENDY
EGR	RGYF
NI	ALKD
RSLEV	SVAKN
NVKASR	VEYRG
WHNIA	NIKALD
GR	YFGG
RTSEYV	MADSAQ
QASAPML	VEYTRG
NEGRY	GRGYFG
VPQS	AYPA
ILTN	MAALRVA
ILT	MAALRVA
ILTN	MAALVR
AKFLQAIAWVVVI	YYEAMVAIGFT
WVVGIGLFFKA	DPAALYSAYAMI
EYYAMVAGIFT	KAFQLAIWAVVVI
DPAALSAYYAMI	WVVGIGLKFFA
VNT	YGNAP
SQQL	DT
HSIG	VGAH
PRTP	KAER
NG	YPRR
IAEG	TKT
HN	NTVY
KHN	DNTVY
HN	NTVYD
HHH	HHH
QKE	KFEH
NAFT	NDIF
NAF	NDIF
TVPVVMVKASTRVTLDTPEVVCTNRLITGTLEVQKGGTMRGNIEHTGGL	KASTRVVTLDTPEVVTCNRLITGTELVQKGGTMRGINEHTGGELSSNG
MVKASTRVTLDTPEVVCTNRLITGTLEVQKGGTMRGNIEHTGGELSSNG	TVVPVMVKVLASTRTDVTPELVCTNRTLIGTEVQKGGTMRGINELHTEGG
TVPVVMVKASTRVTLDTPEVVCTNRLITGTLEVQKGGTMRGNIEHTGGL	KASTRVVTLDTPEVVTCNRLITGTLEVQKGGTMRGINEHTLGGESSNG
TVPVVMVKASTRVTLDTPEVVCTNRLITGTLEVQKGGTMRGNIEHTGGEL	KASTRVVTLDTPEVVTCNRLITGTELVQKGGTMRIGNEHTGLGESSGN
TVPVVMVKASTRVTLDTPEVVCTNRLITGTLEVQKGGTMRGNIEHTGGL	KASTRVVTLDTPEVVTCNRLITGTELVQKGGTMRGINEHTGLGESSNG
TCKTVEVYADESMTVDTPRTTFTGDVEIQKGLGVKGKSQFDSNITAPDATDHIHGDSGGTTG	EYADESVMTVDTPRTTTFGDEVIQKGLGVKGKSQFDSNITAPDAIINGTKHHDSRGT
GFMNK	WN
MNR	IGQGNE
GQGNEI	RMN
WN	GFMNK
GFMNK	WDN
DAG	EA
DAG	EAD
FALTNQAIETRLANALLQS	LANLATIRAENQTLFAMTEQ
TQLAYALG	QTLAYAGL
FALTNQASIETRLNALQ	LANLARTIAENQTLFATMQ
ITQLAYALG	IQTLAYAGL
FATNQAIETRLANALLQS	LNLATIRAENQTLFAMTQ
EFALTNQAIETRLANALLQS	NLNALATIRAENQTLFAMTQ
GGE	GGEN
NGGE	GEG
RTES	ERS
NLSM	LSN
QVLRSP	RSPVLQY
YQVYLRSPE	PRSVLWQYY
YQVYLRSPE	PRSVLWYQY
NEAGE	NQSIT
EAY	HN
EAYL	HN
RSPE	GE
NEGE	KT
KT	NETGE
NE	THKK
EKT	ETGE
RER	ESTPPL
SNEAISSCYY	RIGSF
SNEAISSCYY	REIGSF
SNEAISSYY	RIGSF
SNEAISSYY	REIGSF
NEAISSCYY	EIRGSF
SNEAISSYY	RESIGSF
SNEAISSCYY	RESIGSF
SNAISSYY	REIGSF
VTVGI	VTCGV
NKI	TELV
VLT	IKN
NKI	TLV
VELT	IKN
PVTK	KE
SEENK	KTELNL
CATK	KSND
GVESK	GVSKE
QQGAHHN	QPYNES
QQAHHN	QPYNES
GIGGF	FGIGG
W	GGIGF
GIGGF	W
GGVGGF	W
W	GGIGGF
MGI	HPT
INN	IWGIV
INN	VIWG
INN	VIWGI
IN	IWGV
INN	IWGV
KNN	RII
VNN	VIWGL
INN	VWGII
INN	WGIVI
INNK	VIWGI
IN	VIWG
INN	VWGI
INN	GIVI
NETP	WQ
NNET	WQ
KQGQG	EELE
KQGQG	EEL
KFVQG	QVGKF
RYVEDDK	DDVKVQGID
DDKVQGISD	RYEDVDK
KFVQG	QVGK
RYVEDDK	YEDDKVQGID
EDDKVQGISD	RYEDVDK
GVTGV	VGIAP
GVGV	VGI
YMENL	YLQ
YMNL	MNLY
NTEE	KNK
ANA	NKK
KRIL	LGY
QLY	SMV
GDDGQKS	QRSL
DLSK	RQ
TEQITRVDMEI	AYGHRKHK
QII	IME
GFVCL	QDFYCV
YVCLVVI	EVCVILL
KQQ	QKQ
MA	GGVEI
DSD	RGG
EEQ	LFDF
SND	GGE
EEQ	ADS
EDSD	RGGE
EEQK	LFD
DLFF	QKEE
FE	LCSA
RTLYLN	YILD
DLY	KALSKK
TLYLN	YILD
EICEQDKE	QQK
VVRP	VRP
GAETTSRAN	SRATETGAN
ALY	LLT
PALASYY	SYYAPAL
PLASFH	SHAPLF
PASHSK	HKSSPA
PMLASFH	SHAAPMLF
EPMLASFH	HSAPMLF
PMLASFH	SHAPMLFE
IMV	LFM
PMLASFH	SHAPMLF
PMLASFHA	SHAAPMLF
PMLASFHA	SHAPMLF
PVGAY	GAYPV
VRS	TNKS
ENKD	KEND
NGNGE	KEK
QVAT	ATQV
YYKL	KLYAI
DRN	RTD
RVSDQ	YWKE
WKHE	RSVDQR
ERIDE	SFPPQ
TAKN	NAKT
RRR	SPL
NDVR	DNVR
WDNKDA	KDANDW
NNDVR	NDRV
NDVR	NDNRV
SWDNKDA	DKANDW
NNDVR	NNDVR
EHPDK	TDGIKE
ENGKK	KNE
NKKP	SN
EKDTGI	DKPEH
AASPK	GTAA
YENGK	NDA
DKA	KEDG
EQG	EQG
KVVDKL	QAALAK
IKVVDKL	AQEALAK
DTSAVN	KFER
QRV	PEED
EDNL	NSGSRV
QRV	NKLDP
INSF	DIVSKNF
AEDDLSKL	RVSKIFI
KDIVNSF	SINF
ELL	SKRF
IWKTELKEKLNIIQRAILQGNVSKLGENLIENTRCLKSAKTKYEER	IWKTELEELKKNIQIERIALQNGVSLKNGELINRETLCKSATEYRKE
QVLVDTLSEIEAIALKK	QVERVLRVLPEEI
VLVDTLEILEAIALK	VVRLRVLPEESN
QVLVDTLSNEIEAIAL	QVEVRLRVLPE
QEVRVRLVSPELEI	QLVDTVLIEEAAKLLI
KKE	REKL
KKE	ERKL
KKE	RELKLG
KKE	RKL
KKE	ERLKLG
KKE	ERKLG
E	ERKLG
KKE	REK
KKE	REKLG
KE	RKLG
KE	REKLG
KKE	ERK
RVSN	KQDL
RVS	KNDL
KKE	ERLKL
KKE	QERK
ARHWR	FTEVE
LRPG	SQK
LRPGTKQ	SQKEQL
VLILLA	LILV
GSKYSYGHTN	NTHYGSYSKG
KLSLGLLTLFAMVEANKQAEQLA	KLRLLLTLAVMQANKALQ
KLSRLGLLTLFAMVANKQAE	LKDLSVRLLLTLAVMANQKA
KLSLGLLTLFAMVEANKQAEQLA	KCLRLLLTLAVMQANKALQ
KCLSRLGLLTLFAMVANKQAE	LKDLCSVRLLLTLAVMANQKA
CLSRLGLLTLFAMVANKQAELA	LVRLLLTLAVMANQAQL
KCLSRLGLLTLFAMVANQAE	LKDLCSVRLLLTLAVMAQKAE
ELKDCLSRLELLTLFAMVANKQSEQLA	LEKDLSVRLLLTLAVMANQKESL
ELKDCLSLLTLFAMVANQEL	LEDKLSRLLLTLAVANQKSQL
DIENELRAEALNVLTLFEAMVAREKIELNLTQL	IDNREAEALEVLTLFANVMARKDEIENLLL
ELKCLS	LCSELE
TLFAMVANKQAEQLAKILQEVLKLV	TFLAVMANQKAELQAIQKLVKELVL
ELKECRLS	RLCSEKLE
TLFAMVANKQAEQLAQKILQEVLKLV	TFLAVMANQAELQAILQVKELVL
IENRTENVTLFALVAEILNRLQLRKDLLL	INREENVLTLALVAKEINLLKQDLLL
IENRAENVTLFALVAEKIELNLQLKD	DINERENVLTLALVKDINLLLQKD
DIENERAEADLNVLTLFEAMVAREKIELNLTQLKD	IDNEREAEAELVLTLFANVMAKEIENLLQKD
DIENERAEEALVLTLFAVAREKIELNLTQLKLLLTQLLK	IDNREAEANLVLTLFAVAREKIENLKLTLDQLLLTLQLK
TIQ	ITQ
WG	HIN
WG	VKHNI
VPYVL	LLFF
RVI	PEIA
NP	SIF
PHFQ	QFPH
NNRA	RNSNT
ENRTA	RNAT
AEV	GFAF
IIFYK	FTN
VIT	IIN
LEK	WPK
FK	DYEQK
QGQR	KNQS
TGGC	QL
WKQSA	LDRD
WKQ	LRR
WKQSA	LRRD
WKQSA	RLR
WKQSA	LRE
WKQSA	RLDQR
WKQSA	RLRD
KQS	DQLR
SQ	GETRS
SQ	GERS
SQ	RSGE
RGMSVQ	PSILR
RWQTQ	FYWAG
VRWQTVQ	RFYWAG
EVRWQTQ	RQFYWAG
VRWQTQ	RFYWAG
RWQTQ	QFYWAG
DLNSDS	SDNLAGF
DNSDS	SDNLAGF
RGA	EN
KLDLKRQE	RKQELDLK
AICKE	RAKDK
VQ	TQN
KMAEVN	KSI
KAEVN	KSI
KRF	ASLE
LQDS	QSN
FLALNMAKL	AFLLNMLAK
KDAKKGKVD	DVGKKAKDK
NRG	RSP
QMPFRTVQ	RDKVQMPFT
NRG	ELRSP
NRG	RELRSP
MPFT	FTR
FC	TFC
RENTRQ	TSD
ENKDKCTVT	QHEPEQE
SQE	RHAG
KVMMN	YVRECDP
KVMMN	YVERCDP
KVMMVN	YVRECDP
KMMN	YVREDP
YTRK	AGY
RI	LQAY
LKNGI	WDD
PIYNS	SIYLNP
VRRH	KLEELP
QARE	QART
ARETT	ATRE
ARTT	ARTT
RQR	DDPY
RQR	DDLKPQY
RQR	DDKPQY
RQ	DDKP
RQR	DDKPY
RQR	DKPY
DDMTIAWES	DQGILGIKHG
GDDDMKTIAWS	DQIGILGKH
GQLALN	IILY
ILIY	GQLALN
AGNMQQ	WDAKK
EKFKDY	YDKEKF
DDQ	HKLK
HLKK	DDQ
TFTLQEF	FEQLTFT
TAEQ	TGD
FHELLK	QNHL
WFHLLGKF	NQLHLGKE
WFHLLGKF	NQLGKE
QN	DFDQQKN
DNQK	QN
TVKFST	QHME
YHGKIL	GATL
ATGL	HGKITL
LEYE	QGT
EYE	QGT
LEYET	QGT
ESSP	GHNN
PGNTH	DGH
PGNT	DGH
SSPG	NGHY
EGQ	HQQYVEQ
HNFPFKQYS	HNFPFYSQK
HTGRT	DGW
YDNVESFR	YDNVAFRE
QKDP	QT
QKDP	QTD
YHNG	LGYGE
LTKAEAE	AEAKTL
DQE	NEHW
VLGYNH	HNYGLV
VLGYNH	HNYGL
WRY	MSPTNP
WRY	MSPTNPD
NFQT	TQQNF
NFQQT	TQQNF
SYT	TSY
FNG	GKR
DYQAA	AQADY
HED	RTGAR
NKKE	EQ
NKKLQE	EQ
RRTK	DED
KLSKL	LLSKK
KLSKL	LSLKK
NKEDQKL	KKSERE
KSNEEQ	EENSK
LILTTNLTSQLLKLALLNFLYYM	ILIQLTNTLLTQSLLLKALLNFLYYM
LNKNENSFENLKELEKYSLSYNQKMDS	MSKDYNYLSSLLEKFNENNKNELLN
QKL	KSEQN
LNLLLENLNSIFKNKLLDYLRYQKML	LMQKRYLYLDKELKFNLIENSNLLNL
LNKNENFENLKLEKYSLSYNQKMDLS	MSKDYNYLSSLLEKFNENNKNELLN
NEDQK	KKSEN
SALA	AASL
KSLIP	Y
NPE	LDY
EKEN	NKTE
YSLSTQ	SN
DLTSELDLD	RDKIMK
DRSL	KPEL
FRRDRQ	AYAGETS
YRAL	LYRA
KHRRE	DDHQML
VMAGLVS	QQN
DNLADGQAQA	QAQAGQADNL
QNDN	GLVSAA
QEFY	YQEF
EFKT	NSLA
NSNS	AGTSNQAA
KNNS	TAGSNQAA
FHN	RED
RSP	IAP
LHV	VHL
VVPM	VVMP
SIH	IHS
KKQNYVG	KERVNFD
KINITLLRGQLIGIINLNLEIQQETNNLKLCLEDYI	EDQLILIEHNKNPLLIRYLRFVAQESKITVTKMI
KINITLLRGQKLIGIINLNLEIQETNNLKLCLEY	EDQLILIENHKNLIRYLRFVAQESKIRTVKT
KINITLLRGQLIGIILLEIQETNLKLCLEY	EDQLILIENHNLIRYLRFVAQESKITKTM
LQKSDYR	LLSKVST
LKLSVST	LQKSDDYR
EVKLM	KLMEV
EVKL	KLEV
LKLSVST	LQKSDYIR
LKLSVST	LQKSDYR
EVKL	KLMEV
LKSVSRT	LQKSDYR
LQKSDYR	LKSVST
SLRNIPFYEE	ELENKK
IKLQRLNNLT	LKLEAQE
HKFN	DTEQ
HKFN	DEQ
NLL	YHV
NMKG	KDHH
VYYK	LYTV
VYYK	LVYT
VYK	LTR
VYYK	LGSLV
VYYK	LSLG
VYYK	LVGSL
YYK	VGSLL
VYY	LGSLV
VYY	LGSL
VY	LGSL
RSW	DKRL
QLLKYL	SQNHL
QLLKL	SNHAQL
KFVLC	GIVLW
QLLKLN	SHQLQE
QVLLKYL	SNHQL
WLL	CTELL
NYGKG	KKY
NASQSAHA	KEYGKDLS
RLRDKALI	SDQDI
STRLRDKALI	ESFQCDDI
TRREDKLI	EFSDQDI
DNQN	NDQ
DNQ	NDQ
DNQ	NDQN
ERI	NLK
QDEAL	DRL
DFFYVFRQ	TQHGVQ
DHG	RFS
FSSE	KK
VDERD	KRD
EDEEDRS	YHRKYK
DYEDRKKKK	KKRDEEYDE
GI	ICLG
INVHAYAV	PAKERLE
IRINVHAYVRASDTKAK	LDDLAQLASEFAKAW
YEHDYR	WKRE
YEHDY	WKR
MIINVHAYVRADTKAV	DLSLDADQLASEFAAKRWY
IRINVHAYVRADTKAK	LDLADQLASEFAAKWL
MIRINVHAYVRADTKAVK	SLDLADQLASEFAAKWLY
MIINVHAYVRADTKAV	DLSLDADQLASEFAAKKRWLY
IRINVHAYVRASDTKAK	LDDLAQLASEFAKAWL
MIINVHAYVRADTKAV	DLSLDADQLASEFAAKRWLY
MIRINVAYIADTKK	DISDLADQLAFEAGKKLKFW
MINAYVRAVDTAK	LLAASEFAKLW
MIRINYVAVDTAK	LLDADQASEFKALYW
IRINVAYVRADTKAK	LDLADQLASEFAAKWLY
MIRINVAYVRADTAYS	DLSDDLAQLASEFAAKLYWN
EDERVSKK	KRWLM
MIRINVHAYVRADTAKYQKA	DLDLADQLASEFAAKLYNWM
MIRINVAYVADTAYQS	DLSDDDLAQLASEFAAKLYWN
MIRINVAYVRADTAY	LSELTAMMADSFAHMMY
IRINVHAYVRAVDTAYQS	LDLADQLASEFAAKLWNK
LISINVSSHVRASQLAYQ	GLDQLSESLATSFSKRLMW
NVINVADVQGVHTASA	LTEIADALAQKFANRVWM
NVINVADVGVHTAS	GLTEIADALAQKFANRVW
NVINVADVGVHTA	LTEIADALAQKFANR
MIRINVAYVRADTAYQKAKKMICCILI	LSDLADQLASEFAAKLYWNKMLIIIII
MIRINVAYVRADTAYQKAKKMICCILI	LSDLADQLASEFAAKKLYWNKMLIIIII
MIRINVAYVRADTKAVKYQSKAKKMICCILII	LDLADQLASEFAAKYLWNKMMLIIIIIY
MIRINVAYVRADTKAVKYQSKAKKMICCILII	LSDALDQLASEFAAYLKWNKMMLIIIIIY
MIRINAYVRADTKA	LDDLQSEAFAAKWLY
IRINVAVAVDTKAK	LDLDAQAFEKAW
IRNAYVRADTKA	LDDQEAFAAKWLY
VISINVAHVQANQLA	LDRLTEELSEKFSQV
EMIDR	VESQG
EMIDR	ESQG
EMID	VESQG
EMIDR	LVESQG
ENVDVI	IEQQE
EMID	ESQG
EMDRY	EHL
IVAVYVAVT	ILIRI
IDIEVEAVVEAVTK	ILHFRILEHIRIE
IVAVYVVT	ILLIRI
MIINVHAY	SLIKLER
IDIEVESEVESDLQAAQ	DRIARRLTNLKSILMLRI
IDIEVEAEVQNLSAA	QQLTRRLTNNLKSILM
RRKIG	QRD
RRKIG	QRDL
ANNPNS	GQPKT
RMGT	MGRT
LVIDAEAA	EVIDAAAL
EGQP	NWQ
HLND	DQG
GNEA	TESNR
DG	FVN
EAKWLQ	QLHSAHSS
QAEAAREHR	LFHLVDHS
KDGN	KE
EK	DGN
E	LDGNK
PSLL	YYV
PSLL	YVY
PSLL	YKVY
PLL	YVY
RPLL	YVY
PSLL	YYKV
PFSLI	YKYV
PPSLL	KYVY
PPSLL	KYYV
KDSIE	QNEK
GSN	PGDD
KGGNE	TSGADT
KGK	AIE
QGT	TIA
QGT	TIAL
EAT	KIA
EHSFGS	GSARGSN
TVTGL	IRA
TVTGPL	IRA
TGEL	YGEGQE
VTG	SKV
TVTGL	RIA
SDVSQ	HPRH
TISAPL	VKSE
ALL	LAL
ALPYA	AT
STAA	AYALP
KGP	AKGA
KGY	DTK
SYPE	PPE
ESYPE	PPES
KEVV	VKVE
TDT	QAK
NR	ERSF
RRNSDE	SDENRR
RARNSDE	SDENIRKR
RAIRNSDE	SDENRRA
RARNSDE	SDENIRRA
RRNSDE	SDENIRRA
RRNSDE	SDENRRA
GLQMRG	VGLSQ
RRVRNDDE	DDENVIRR
RARASDE	SDEARRA
RARASDE	SDEAMRRA
RKRYSLDE	DEYSLKRR
RNKYSDSE	DSEYSNKR
RNKYSLDSE	DSEYSLNKR
EGG	PSS
LLN	ITA
LQNW	AGK
QNLNKLKQEILKIALRKLYVITLEQNLQILEL	NNQLLKQIKKLEAILLKYVTILENQQLIKLELKA
RRRAQEDNAE	EDEARRDR
TWLS	TWSLD
TWLS	TWSL
LEDR	RDEL
VYDAPTK	KGVDA
NLYHEKTD	DTKEHVYLN
NVLYHEKTD	DTKEHYLNV
DDR	NSC
PVNP	NPS
LTLIL	FPHTWAL
SDTLTLIL	HFPTALW
SDTLTNLIL	HFPTALW
SDTLTNLIL	HFPTWAL
TLTNLIL	HFPTALW
PGAQ	QGAV
AAFV	FAV
DISKHKLTHEAADQ	QADEATLHKKHISD
DISKHKLTHEAADQ	QADEATLHKKHISHD
HDTEEAP	EPEATHD
AGSVS	RHAA
GSVS	EQAH
AGSS	RHA
MFLRNVEWSYIYLKVAAAVL	KIRGWKLFNFIKLVKT
KQSWK	KSWQK
KQSWKD	KDSWQK
VKAKEQIWEMD	DEWMQIEKAKV
KGGGK	QSLFQ
ENAL	NQ
EQHQN	R
ISDCLA	LSCADI
ISDCLA	LACSDI
WNR	QRARTSR
EYDR	SY
PNNQNE	NQENN
PNNQNE	NQENNP
TGQN	DLEA
GLN	DLE
GSD	DSS
RHNN	DDEEI
GQE	DLA
TQER	LTE
RH	GRRGE
NSH	QIGLK
LIVGTTIL	LIVGTTIL
EVATE	R
IATAHF	IKAIL
YTPN	NRYE
DGQT	VKEFR
DGQTW	VYFER
DGQT	VKEFRY
RDGQTW	EVKFRY
SGSLA	EGVRQ
FWK	WKF
LAALVV	VVLAAL
DR	TDSD
LCE	YCEL
CEN	ECN
RKLALLL	LLLTL
YVALSVQD	PYVIGERY
YVTALSVQD	PYVIGERY
HR	DNND
IAGLEFDTN	ITKIKPN
IAGLEFDTNT	ITKKIPN
IAGLEFDTNT	ITKIKPN
IAGLEFDTN	ITKKIPN
IAGLEFDTNT	ITKKINP
RGSHTI	PESGN
SHTI	SGNT
TPRGSHTI	EPSGNT
PRGSHTI	PESGNT
GSHTM	GNST
PRGSHTM	PESGNT
RGSHTM	PEGNST
PGSHT	PSGNT
RPGSHTI	PESGN
RPGSHTI	PESGNT
PRGSHTM	ESGPNT
GSH	GSN
PRGSHTI	EPSGNT
PGSHTI	PGSNT
MTFY	RIQE
GSHT	GNST
PFPR	RFPP
PFPR	FRPP
PFPR	RPFP
PFLPR	RFPP
PFLPR	FRPLP
GHTLG	RQL
LQA	RLGR
LQA	RLR
GACHCAR	RMSE
GAHCAR	RMSE
LNCIQ	RE
GCDI	RK
GYRI	QLS
GYRIG	QLS
LTGWG	WRSVMTP
GHDL	RQK
ITSYE	WRVSYCP
ITSYE	WRSVYCP
QR	GRLR
KVK	TSVKD
GEEQ	RVGR
GACHAR	RMSE
SQR	LGRR
GYKHN	WYLE
GYAKHN	WYLE
LLR	FWND
ESPDHD	YRN
RAE	GGHR
RAE	GPGHR
ESSDHN	YRWN
ESSDHNL	YRWN
GRLG	RLQED
GHDLS	RQK
GCLQ	RSE
GCLQ	RS
GLQ	RSE
CKRG	NTD
CKYRG	NTD
CKYRG	NDT
LRA	VHY
EQEPAHGD	HEQN
QEPAHGD	HEQN
CKRG	NDT
DDEENG	LKHQ
GHEN	RTQ
PMP	SDEA
HRLT	NADTRR
MRF	WVT
MRPF	WVT
MRPF	WVTI
RPF	WVT
NPGD	KTE
IPSTAL	YKNRI
RSY	NVLR
VD	AKAK
TQR	RAEE
DESG	SGKD
ALAARHG	GVARKA
RDQ	KKR
RDD	RQER
EN	ENG
ASEAGS	RTSN
AEAI	EKA
RRWE	RSNN
SNNR	RWR
RRW	RSNN
QE	SPGL
IGAN	NDK
QRAE	ETQRR
PAMEAQR	RAAMEPE
ERMQ	KDG
IGAGN	NDK
QDPL	KY
YGRN	PLRKYQ
YGR	PLRKY
AKRT	APNN
YGRN	PLRKYAQ
DELG	RGLP
QLQAPYTAAH	LQQATHAAYP
AKR	APNN
KDYM	MVKDY
IPVEWPKG	WPKVEIP
IPVEWPK	WPKVEIP
NKR	PLELQN
GPDN	PLKR
GQI	NGQ
REQD	EDRQ
RVGDK	GDRVK
KKDMK	KMDK
KKDYMVK	KMKDK
GRREGG	DWQGR
ADRE	QWR
LRG	KLRG
LRG	LRG
ARE	DDAER
CLGA	GLC
LRGA	LRGA
KLRG	LRG
NFEEDKED	DKEDEEFN
AMG	GMA
AFG	GAF
AFG	GFA
NGGG	GGGN
NGG	GGN
LLG	LGL
KTP	HPK
YKTD	KQGR
IADMLTGVVGSLKW	AIMDLGTVTGVSLKW
AAQ	QAA
SKNNN	KDAG
VHQM	VTGKVD
VHQ	DVTGKV
NVEKVN	KVNNEV
DSRQ	RDSQ
QNES	SDNEK
ENLTIS	ISETENL
DHLK	KYL
DDHELK	KYLND
KSR	QYT
GGSTT	TNAT
TATN	TTSGG
EMD	KFK
TGGADCTSCTACTGCGNCPAVTCTNSQHCVKANTCTGSTDCNAQTCTNSKDCFEANTCTDSTNCYKAT	ACTGCGNCPNAVTCTNSQHKANTCTSGTDCNTAQTCTNSKDCFEANTCTDSTNCYKATACTSNSGCP
CTGGADCTCTACTGCGNCPNAVTCTNSQHCVKANTCTGSTDCNTAQTCTNSKDCFEANTCTDSTNCYKAT	CTGACGNCPNAVTCTNSQHCVKANTCTGSTDCNTAQTCTNSKDCFEANTCTSDTNCYKATACTSNSGCP
CTGGADCTCTACTGCGNCPNAVTCTNSQHCVKANTCTGSTDCNTAQTCTNSKDCFEANTCTDSTNCYKAT	CTGCAGNCPNAVTCTSNQHCVKANTCTSGTDCNTAQTCTNSKDCFEANTCTSDTNCYKATACTNSSGCP
FEP	EPFD
PKQY	QDRD
HETI	EHTI
QFKE	DKEFE
DNR	NDR
FEP	EPF
NTAVLL	NALTLV
LLKEVYSKV	LLKEVYSKV
TLLKEVYSKV	VLLKEVYSKV
TVLLKEVYSCKV	VTLLKEVYSV
TLLKEVYSV	VLLKEVYSKCV
QFVSSGGSAAKTTINSGG	YYLGGSATGTSYNGRQG
QFVSSGGSAAKTTINSGG	YLYGGSATGTSYNGRQG
GCNKNDD	KDGRCNDN
KENN	KDSQ
DN	KLQD
WEKY	YKEW
RG	LEAR
EVLVY	NLVEVY
DLVLSKLVEV	RVLTQTLL
LVAVKAVQYE	LLTQTVLR
DLVLSKLVV	RVLQGTTLL
LVNAVKAVQYE	LLTQTVLRQ
DLVLSKLVV	RVLQTTLL
LVNAVKAVQYE	LLTQTVLR
VQL	LPGT
VYLE	LQV
LVLSKLVV	VLRQTTLL
DLVLSKLVEV	RLVTQTLL
LVQL	TLPG
VYL	LQVL
DLVLSKLVV	RVLTQTLL
LVNAVKAV	LLTQTVL
VLSKLVEV	VLQTTLL
NRLN	LSIHYSK
TLHE	YLH
RHKP	HRKP
KDRGDGQ	DGDKGRL
LRDDLIQRNE	LQQNRIRDD
KLSTGKKA	GLSTKKK
RDGE	DGER
RD	RNND
RNND	RD
TPGH	HGPT
EKAQ	QAES
PKGL	VPY
DLIQ	RLIQ
KYSSGK	GYSSK
KYSSGKP	GYSSKPK
RHDER	RLHDE
RHDELR	RLHRDE
WNDT	RPGS
APGE	KQV
APGE	QV
PTGE	QIK
LPGE	EQI
LPG	EQI
VQL	AL
QTD	TKQ
GEQK	TED
QTD	TKQD
EDDGK	QEGK
VGRD	RGD
YKK	RN
HTY	PGDK
QNGSTR	TRSQNG
AYPIAANDE	RLPR
EAVY	EGK
EAV	EGK
EAVY	EK
TAKY	NEG
QQGKSWR	TPLSDAQ
QQGKSWR	TPLSDA
QQGKSWR	PLSDT
QQGKSWR	PLSDTA
QQGKSW	PLSDT
GPV	AKL
VGSAT	AVSTR
SNNN	QRT
LKVFMTFLLIEESLYT	VKYLVVSSARL
LKFMTFLLIEESLYT	VYLVVSSARKL
LKFMTFLLIEESLYT	LVYLVVSSARK
LKVNFMTFLLIEESLYT	LVKYLVSSAR
LNFMTFLLIEESLYT	VKYLVSSARL
KGER	EGD
LGEDR	REG
YTDAASA	TQQIR
AAS	IQR
TDAH	TGD
NAGA	ANAG
NRD	VGNS
ND	VGNS
ENERD	NVGS
WPLAT	GVSV
LFTD	TKLR
VLPD	RNV
VLPDS	RNV
YELGV	RYLRR
ELGV	RTL
RE	KYDY
ARK	SGTLA
VVV	MVT
YE	KSSKYC
TWE	HWSED
SRNAK	RSNAK
TDT	SNK
KEAFR	YPID
RRGEV	RGTEWI
LRLWF	LLLW
WLLL	WFRL
WLL	WLFR
LLWF	LLWL
WLLL	WLFLR
LRLWF	LLWL
WLLL	WFLL
KER	EGN
KTADFILQS	SDLQIFDATK
DALK	NAG
N	SDVVN
EQKR	EQKR
GIAD	ADGI
HQS	SQH
EMD	LRDN
DEMD	RLDN
DRLQEG	GEQRLD
RQ	ETKD
HSKEK	EEDE
QR	SHG
ATP	TAP
ATP	AT
PAYLP	KEPH
HSKEK	EEFDE
QKDGK	DEE
LSRGK	FRDD
FASG	KG
KLANQR	DEKLANQ
SGDF	AGV
EPRAAAHL	HLAAAERP
ALH	HAL
PEAR	ARRPE
RWTN	GTWRN
RTN	TRN
GLLQ	HAPCK
ERT	SDVFRRL
YHVEG	HYVE
SYN	YNSS
NKDENG	NNS
NN	KDENGY
EART	RLTGW
TDESGR	TRA
TATSG	GFSR
QVDGH	TQTRQA
QVDGH	QRTQA
QVDGH	TTRQA
PAQ	QPA
ADEEK	RER
ADRQR	REQE
YHVTVAGV	VAGVYTHV
YWPK	YWPK
LK	EEYG
TPED	HM
RKAHFAMLER	AAEERKAHFA
TFSQL	EY
WERLQIQLRRQEKLVIERLLRAE	TWERLQRILQERKQEKLVRILEALER
SENTQ	SEN
NSET	FQSEN
RGET	NSE
GET	NSE
RGST	SNSE
GSTE	NSE
GEST	NSE
NEQ	QSENT
GREDPPR	SWHSPLNS
GDT	SWPE
SSQQ	SR
QDER	EQDAR
DGA	GAD
DS	GTPA
VAETTTFWK	WKTTFTVAQNE
VAQETKHFWK	WKKHFTVAQE
VAQTNYFWK	WKNYFTVAQ
VALETNHFWK	WKNHFTVALE
QEDFHE	EDFQHE
EALETNHFK	KNHFTEALE
EALETNHFK	KNHFTEAL
TEALENHFK	KNHFTEALE
RTLD	LDTPR
RTLD	LDTR
RHIA	IAHR
RHPIA	IAHPR
RHIA	IAHPR
RDAP	ERP
VQLVLQFEYKKVN	LQVLQVLAFQYKVFPN
LVLQQVLAFYVQKFPN	VLQVLQFYKKVEN
VQLVLQFEYKKVN	LQLQVLAFQYKVFPN
WNKITT	PNYPQVL
WNKIT	PNYPQVL
RYTG	NLYQ
RYT	QNLYQ
RYT	NLYQ
YRT	LYQ
KCKY	GFY
RT	QNLYQ
EEIYLGIYC	CYLIGEEI
EEIYLGIY	YLIGEEI
YRTG	LYQ
HTSQ	HPG
YYGD	PRFL
RYT	ANLYQ
EDI	QNY
QFATL	HTRTW
INSTV	FY
INSV	FY
LNAFM	YY
LNAM	YY
QKDLLKLAEQL	EKLELQALLK
LTYIM	LEQKLL
QKLL	LTYII
HVEMIIIALRY	LYIRIALMIVH
KDQK	QKDT
KDQ	QKDT
QMVYQQ	QMVQYQ
KRP	EFYQ
EMTQFG	KFQMTY
MTQFG	FQMT
RMYQTFGEY	KFYGQMTRY
REMTYQ	MTRYQ
SGGVPD	FYQ
RYTH	KRLYEYS
DEYS	RYT
QMMYKQQ	QMMQYKQ
QMMYQQK	QMMQYKQ
DQQ	QQ
QYQQK	QQYKQ
FQKEY	KEFYQ
KFQY	SNGDGVP
RMQTFK	KFQMTRE
FQMT	FQMT
FQY	SGDGVP
QKDTK	QKDT
SRPLYV	VELLYSR
DSEDLSVRD	HERRIRYGL
DSLQVDER	RRIRYGI
DSLQVDRE	RRIRYGIKK
DQLLVDR	RERIRYI
DQLLVR	RERIRY
DLQVR	RRIRKY
RDQLLVR	RRIRY
DQLL	RER
QLDVR	ERIRY
DLLVR	RRIRY
LSMDDM	RMIKY
DDM	KY
DLDM	IKY
QDLDM	RIKY
LDDM	IKY
LKA	MAR
WRWKTSQDDDQSL	LDQSDDQSTKRW
VIIIKWK	IIVYST
EILKSILFMMLQV	LTQVVVMRVKVLRDL
REILKESILFMEMLVQ	SNLQTQVVVMRNVVLRDL
REILKESILFMMLQV	LTQVVVMRNVVLRDL
DILKSILFMEMLVQ	LQTQVVVMRNVVLRDI
EILEKSLMFLQ	NRLQTQVVVMRVRDL
EEILKSILMFLQ	NLQTQVDVVMVVRDL
ETREILKESILFEMMLVQ	NLQTQVDVVMRNVVLRDL
ETREILKSILFMEMLVQ	NLQTQVDVVMRNVVLRDL
MLS	WWL
REILKSILFMEMLVQ	NLTQVDVVMRNVVLRD
EILISLFEMMDLVQ	IVKAVVLAARLDRGL
ERILEKSILMFEMLVQ	NLTQVVVMRVLRDL
LLKSMLFELMDLVQ	TLQITVMRNIVARGL
ELLKSMLFELMDLVQ	TLQITVMRNIVARGL
ELLKSMLFELMDLVQ	TLQIDTVMRNIVARGEL
RTEILKSILFEMMLVQ	HMLQTQVDVVMRNVVLRDL
RTLKSILFEMMLVQ	HMLTQVVVMRNVVLRDL
REILKSILFMMLQV	NLQTQVVVMNVVLRDL
ETRELKEILSFMMLVQ	NQTQVDVVMNVVLRD
REILKSILFEMMLVQ	LQTQVDVVMRNVVLRDL
EREILKESILFEMMLVQ	NLQTQVVVMRNVVLRDL
EILKSILFMEMLVQ	NLQTQVDVVMRNVVLRDQL
REILKSILFMMLVQ	SNLQTQVVVMRNVVLRDQL
EILKSILFMMLVQ	NLQTQVVVMRNVVLRD
LQLLL	IRLLLF
SYDLGKKPIYKKAF	SYDLGKKPIYKKAF
YDSLGKKPIYKKAPTNEF	SYDLGKKPIYKKAPTNEF
RILILFM	RILILFM
HDMDRNH	RMME
EVATGVH	HGVATVE
EVAGVH	HGVATVE
VEATGVH	GAVE
AAVAVGV	VGAVAVA
KTKEGVVHGVATVAEKTKEQVTNVGGAVVTVGTAVAQKTVE	KTKEGVVHGVATVAEKTKEQVTNVGGAVVTGVTAVAQKTVE
VVGE	TVQTE
VTVGE	TVQTE
VTVVGE	TVQTVE
VVGE	TVQTVE
AVAVVAGV	VGGAVAVA
EVAGVH	HGVAVE
EVATGVH	HGVAVE
EKHRSG	RRK
KKQETSE	TETNVHAHK
GYKR	KGYR
VKHQNERT	RETNHQVK
ALLI	LA
DQVK	KVDQ
HFLE	VADQG
LVAL	LALV
GHFVKRNHQ	EVNHQVKF
KR	SVTK
REEEFLLG	QTGYPYVDED
REQLEF	YDED
TQGQYPYE	ERAEGLEFLE
LPDDPW	RKG
LMNDAVQVTAKK	KAQKVTVNDML
LMNADVQVTAKK	KAQKVTVNADML
HLSTD	NLSER
RLND	LGAYA
RYKQR	VSVGS
MRSEQMI	HNETRSIQ
QMTK	QMA
LQQTE	LRQYVWE
IYV	IYV
HYVGDIKSAAARE	REAESAAIY
RDQ	EAQQ
VFEQ	VFLQ
VEQLAQ	VREAQ
NLRT	NLTRD
KEQ	MTNL
IIANF	AFDIAIN
ILLENMDLEM	IELENMDLLS
TNERRGRRV	DRVRGRRNET
QHEQ	RI
QPGRISDN	QPGIQ
IQQAR	GIQN
QGIQAP	QGIQN
QGPIQ	QPGIQN
QGPIQ	QRPGIQN
LVQLSANQLELTTIKELCLI	VLQSLAQNLETLKTEILTLI
ITD	AASK
VLQLSAQNQLELTTIKELTCLI	VLQSLAQNLETLKTEILTLI
KAAS	TDI
EQLHKAL	KELICL
IDT	AASKR
GEYRLKALKAEIRVAELAQLSQERIELVTTNKELTCLI	ERYLKAKLANEIVRAQALSLEQRILETVKTENLTLI
GEYRLKALAIREVALALSQIEERLVTTNKELTCLI	ERYLKAKLAEIVRAALSLEQRILETVKTENLTLI
QR	AQVSK
ITD	AASKR
GEYRLKALKAIREVAELAQLSQIEERLVTNKELTCLI	ERYLKAKLAEIVAQALSLEQRILETVKTENLTLI
LIRELQE	AHEQLQ
ITCD	ALHK
GEYRLKALAIREVAQLALSQIEERLVTTNKELTCLI	ERYLKAKLAEIVRAEALSLEQRILETVKTENLTLI
YALKAIREVAELQLQSIEERLVTTNKQELTLI	YLKAKLAEIVRAQALSLEQRILETVKTENLTLI
YR	LISICQ
INDKTGH	THGKPDIN
INPDKTGH	THGKPDIN
NIPDKTGH	HGKPDIN
DV	RDNL
DQVD	RNLKI
HDTAANVA	HHSDTATAVNA
HDTAANVA	HHSDTATASVNA
ATPCQHGLQ	PVCQAHGL
ATPCQHGLQ	VCQAHGL
TPCQGLQ	CQAHGL
TPQCGLQ	CQAHGL
ATPCQHGLQ	PVCQAGL
PAA	PAA
QP	AFGR
CYCN	NCYC
ALS	SLA
GT	AADQ
ESHR	HRE
SDAP	TS
SDERGQ	GRSDEQ
SDERG	GRSDE
SDERGQ	GRSDE
SAEGLE	GLSAEK
SAEGL	GLSAE
SAEGL	GLSAEK
TL	SDAP
EATG	VAQ
SVRLG	TGLSVK
VAQ	ATG
KVGLS	GLSR
SVALG	GLSVA
TSEQ	STE
TSEKQ	STE
SVEGR	GRSVE
SVERG	GRSVE
EQRE	QRES
DRFNTYCNL	KALRARNAEYNKRR
RTYNFCDNL	ALRARNAEYNKMRR
DTYGFCDLD	KRNAYNKRR
DCTGYFDD	KARNAYNKRR
DFTYGCDLD	KARNAYNKRR
DRTNYFCNL	KALRARNAEYNKRR
DLFGTYLFLV	DLFYGLTLFV
TSFET	ETSFT
DNS	KGVK
KYEQ	LQIDN
NR	HRTDA
NNVDRVLT	RVVDNNLT
FQKL	KFQL
FSADHE	FSAHE
FSAHE	FSAHE
ERN	REN
ANLS	NG
KKKD	ADSN
QLFQ	RNE
EQRN	QAQ
ADEK	RNE
ADEKK	RNE
NRE	LQF
AQQ	NEQR
QEQ	QLNLT
LGK	NTL
LGIK	NTL
LG	NTL
SRGY	SRG
RSR	SR
RGKS	SR
SRGK	SR
EMRGVY	QVEKQ
TAQE	IW
NLLD	ER
IAIVNDLTIDYLKITADELIVLI	ITIRLIIRSLLIRRLIINTI
IITRILIRISLLIRLRIINIT	INADIVLTIDYLKITADLEIVIL
INAIVDLTIDYLKITADELINVLI	TIRLIIRSLLIRRLIINTI
IAIVDLTIDYLKITADELINVLI	TIRLIIRSLLIRRLIINTI
AIVNDLTIDYLKITADELINVLI	TIRLIIRSLLIRRLIINTI
AIVDLTIDYLKITADELINVL	IRLIIRSLLIRRLIINTI
IAIVNDLTIDYLKITADELINVLI	ITIRLIIRSLLIRRLIINTI
IITRILIIRSLLIRLRIINIT	INADIVLTIDYLKITADLEINVIL
IAIVNDLTIDYLKITADELINVLI	IITIRLIIRSLLIRRLIINTI
IAIVDLTIDYLKITADELINVLI	IITIRLIIRSLLIRRLIINTI
IITRILIIRSLLIRLIIIT	INADIVLTIDYLKITADLEIIL
IDTIDYLKITADELINVLI	IRIIRLLIRRLINTI
IVAIDLITDYLKITADELINVLI	ADIRLIIRSLLIRRLIINTI
INAIVDLTIDYLKITADELINVLI	IITIRLIIRSLLIRRLIINTI
ITIRLIIRSLLIRLRIINIT	IADIVLTIDYLKITADLEINVIL
INAIVDLTIDYLKITADELIVLI	IITIRLIIRSLLIRRLIINTI
INAIVDLTIDYLKITADELINVLI	ITIRLIIRSLLIRRLIINTI
TATLVIAEALAKIVE	IAISVEIVKLAAAEIVL
ILRAALLLVGAQVI	VAIQVLLLARAIL
IVLAEALAKIVE	VEIKLAAAEIVL
RND	EAER
AHAS	PNV
YHA	PSF
YHA	LPTSF
RND	EADR
RND	EAERE
RE	HRSPG
SPHR	ERR
EKS	GA
LLAFK	IALDAAY
GVSHK	ETE
RGAYW	AELQL
RGYAWTH	AMELQL
GVARKR	ETDD
GVARRK	ETDD
GVSSSQQ	EVG
GVSAQQ	EV
GVEHH	ASAN
GIARKR	ETEQ
GIAKR	ETE
YGRP	NAS
YRPS	NAS
AFRKAETG	GETAFARK
HLSGAH	HAGLSH
LYYV	DRGELTDGH
GVEGVDR	KRIGLDR
KERTS	TRSEK
KRGILRD	GVEGVDR
RTA	TRIV
NNGAK	ETEY
NKNGA	ETE
NGKN	ETYK
TTGKFA	TGSAVIGE
LMAESG	LLSQDVV
GYAAMATK	ERQ
EAARG	RY
EAARGI	RY
EKGGLVE	GQASRD
FGDRG	H
QKTDK	DPYRE
REITVIEK	HQRQ
QTN	NSN
R	HHHFT
KYGAF	LEATAE
KYGFA	LEATAE
EATAL	KYFT
YF	EATA
YAPGT	PGYA
NSG	SNG
YNGR	RGYN
YFNGR	RGYN
QHREA	ATEKE
AGE	AEGPA
QES	ESGQ
YQLFEKR	KRYQLFE
HGSQG	SQHG
HS	PSELL
LY	VACNS
LY	VACD
PISR	RQEGVP
SCLRN	RSNCL
PISR	REGVP
ELKYG	YSGLDR
ELKYG	YSGDR
ELKY	YSGDR
YSGHG	NRAGFE
YHSGG	NRAGFE
EHKG	KEHK
RPKK	EDSTN
RPM	DSTN
MLPRVLWV	SDSYVLLS
FSRSKI	KETIKSRS
KSNP	KSNP
KSNPL	KSNPL
WPLY	YLPW
CSA	CSC
RLA	TQY
GRKDLLRPD	DRPLRKDLG
RRL	SGAGR
KPVVH	KKAVALVDL
KVPVH	RKKAVALDL
KVPVH	RKKAVALVD
KVPVH	RKKAVALVDL
RFPVPH	AKACILVDA
RFVPRPGH	AKACIELVDA
RFVPPGH	KACILVDA
LLRQKS	LERLKG
LLRKSQ	LERLKG
LRKLSQ	LERLKG
RLLKSQ	ELERLKG
HRFTK	RFT
QLPFY	YFLPQ
LPNYKF	FKNYLP
LPENYKF	FKNYLP
LPNYKF	FKENYLP
LPDNYKF	FKNYLP
LPKF	FENYLP
LPNYLKF	FKENYLP
LPENYKF	FKENYLP
PERKLAYR	YAKLPER
QQQ	HQK
HERN	EHRN
HERNQ	EHTRNP
HERNQ	EHRN
FNVPHNTFFQDQ	VPHFNQDFNTFQ
KNEK	ENN
FNVPHNTFFQDQK	VPHFNQDFNTFQ
RRRGAP	TRER
RRE	KRRG
PDKT	YSQD
LFGRDSR	LSRDGFR
LGFRDSR	LSRDGFR
GAARMWAR	AARWGAR
GAARMWAR	AARWGARM
LYGRSAR	LARSGYR
LYGRLSAR	LARSGYR
MGGWR	MRWGGA
MGGAVWR	MRWGGAV
MGGAVRWR	MRWGGA
MGGAVWR	MRWGGA
MGGAWR	MRWGGARV
MGGAWR	MRWGGARVI
FH	ERTG
MGGAVWR	MRWGGARV
MGGAWR	MRWGGA
LYGRLSAR	LKARSGYR
LYAGRLSR	LARSGYR
GGARWAR	GRWGAR
GGARMWR	AGRWGARM
GGARMWAR	AGRWGARM
GGARMWAR	AGRWGAM
MAGAKAR	MARAGAK
LGVKFRG	LRGGVKF
LGVKFGR	LRGGVKF
LLNGAKTR	LNLRTGAK
PTGGFRPEK	KPERGFPT
PGFRPEK	KPERGFPG
PGFREPK	KPERGFPTG
PGGFRPEK	KPERGFPG
MTVPSGNR	MRGSTPL
MPSTG	MRGST
MTVPSGNR	MRGSTPV
MTSG	MRGST
TSGM	MRGST
MTPSGR	MRGST
MTPSG	MRGST
TPSGMR	MRGSTP
LVFKGR	LRGVKF
LGVKFGR	LRGGVKMF
LVKFGGR	LRGGVKF
LGVKFR	LRGGVKF
GTVRF	VRFGT
VGTRF	VRFGT
KVVTEK	TAHYSTV
LKTATIAC	CLTATKL
NALRLCVC	NCLCVRLNA
SN	TCPSN
FNANT	CTGGSTIL
ITGSGR	PIIHVTT
PTIGIHV	AFTGG
SSAK	ATAD
VATDK	DTANKD
SVALMGTDK	QEDTANKD
QSQS	QSSQ
KTQ	ELNYE
KKG	SRD
RRE	VQVRR
DRYRF	HK
KSTN	GD
DDTK	KTDAD
VNK	NGEQ
KQTD	ETQ
QET	GEQTK
HLH	HLH
AGEVKN	KNEVAG
IYR	YIDG
RSLEE	LKS
TKDTEKE	KDTTEKE
WGMIESD	GRLFDKT
RDE	GEAC
HDEYWI	ETKHH
EKLA	KEAL
DYD	DQE
QDEK	KDYD
KYQFC	EWGGAT
ER	AQAAE
VTGG	GVTG
ERE	AQAAEK
SGK	EAG
GQE	KKAD
KAN	KAN
RQK	PKDN
GGI	NHD
MQLML	VIMGL
RRYA	ED
DRLE	DRLE
RDR	EQDA
DQAN	DKV
ERILESI	FTIESLRIE
FKLIIPD	FIPLDIKF
FIKLIPD	ILIKF
REITSIL	TISLRIE
REISILFT	TISLRIEF
FKLII	FIPLDIKF
FLIKDFI	ILIKF
FMLFTSIIL	FMTSLIFIL
FNLLIFLHFRI	FNILFIVHWRI
FVHWLF	TLLIFLLF
EAQLAQKCE	KIKNLDDR
KERARRD	FYADH
QTV	QTV
FTD	EIK
FTD	EI
EG	RRA
EGE	RRAN
SVYQ	AEAKP
SYR	GAE
ARR	RRAN
YNLETQFRWY	SKYPQD
NYLQWH	YGPTE
LNGSIAHLL	TRYPEL
LGNSIAHLL	TPRYPEL
QRTSAD	RSAA
QRTDS	RAA
QRTDS	RSAA
QRAD	RSA
QTCD	RA
QTD	AAG
YNLTQFRW	DSYPEPT
LYNETQFRW	TPRYPEE
AVVVWF	AVVVFW
IAVGLYVAF	IAVVGLAYF
QQS	SQQ
CDELVSEIKIGEIENLWI	RLRVAEIIRRIRNSLEIY
RLRVAEIIRRINRSLI	CDLEVSEIIKGEINELIW
CDELVSEIKIGEIENLWID	RLRVAEIIRRINSLIY
QVSR	GGELQVD
QEL	KGLQ
QVSR	GELQV
ELQ	QVS
VRVLSHLLLQLNDILQINQLVRQVQIQQI	VEVTLESHSLLQLNQILRIQQLNVVQILID
VEVTELSHSLLQLSNQILRIQQLNVVQILI	VRVLHLLLQLNDILQINQLVRQII
VRVLHLLLQLNILDQINQLVQRII	VEVTLESHSLLLQILRINQLVVQILI
VEVTELSHSLLQLQNIRLIQNLNQVVILIDSL	VRVLSHLLLQLNDILQINQLQVVRQIQIL
VRVLHLLLQLNDILQINQLVQRQIQIL	VEVTLESHSLLQLNQILRINQLNVVQILIDLS
VEVTELSHSLLQLQNIRLIQLNVVQILID	VRLSHLLLQLNDILQINQLVRIQIL
VEVTELSHSLQLLSNQILRIQQLNVVQILI	VRVLHLLQLQLNDILQINQLVRQII
VRVLHLLLQLNILDQINEQLVQRII	VEVTLESHSLLLNQILRINQLVVQILI
VVETELSHSLLQLQIRLINQLQVVILISL	VRVLSHLLLQLNDILQINQLQVVRQIQIL
VRVLSHLLLQNLDILQINQLVRQIQIL	VEVTLESHSLLQQLSNQILRIQQLNVVQILIDLS
VEVTELSHSLLQLQNIRLIQLNVVQILIDLS	VRVLSHLLLQLNDILQIENQLVVRQIQIL
LTR	KMHVN
LTR	KMHV
CKKYERNQTLLLYEAD	FKIQRQETFVMTRQALR
EENIKKLY	KREAFEVDITL
CKKYERNQTLLEAYL	FSKIQRQETFMITRAL
RMDLEK	DERM
SYFKTN	IKCYQPVSR
SYFPKTN	IKCYQPVSR
IKYQVPSKR	SYFPKTN
SYFKTN	IKCQPVKSR
GF	KFG
IKCQVPSR	SYFKTN
KSKFG	KRG
KGR	KSFGK
SYFKTN	IKCYQVKSR
IKCYQVPSKR	SYFPKTN
SYFKTN	IKQFPVSR
AQS	SAY
KICQVPSR	SSYFKTN
SYFKTN	IKCQPVSR
IKQVPSR	SYFKTNG
IKCQVPSKR	SYFPKTN
IQVPSR	YFKTN
SYFKTNG	IKCYQPVKSR
KDA	KCMNR
HNK	TAES
N	SQAGK
NHS	NRQ
FYLV	KLVLF
FTGLLL	TGFLLL
ECSCSLK	VLSCCES
CESCSLK	LSCCESEV
ECSCSLK	KLSCCES
DCKTS	TSKD
NDLLGL	LLDLGN
EGLI	GELI
LTLLW	TLLLW
EGV	PGE
EQGV	PGE
FPATS	SATFP
FATN	NATF
RYQ	RKQ
QQAV	PSAVV
QQAV	PSAV
RSQR	ACLGR
RSQR	ACELGR
RASQR	ACLGR
RASQR	ACELGR
NEDA	EERN
RNED	AEERE
NSEDTD	VNIPRR
NTSEDTD	VNIPRR
NSEDTD	VNPRR
NTSEDTD	VNPRR
HWSTR	GRAHH
HWSTR	GRHH
ENLSKLDN	NKLELDSN
KENLSLDN	NKLELDS
KEKDN	DKEP
MYEQ	YLMHK
MYEQ	YLMK
MEYQ	LMK
YMQ	LMHK
LALV	LK
LALVR	LKE
VQKLEH	IEAVYRL
NRVNGFE	DAQ
VNRFE	ADAQ
RNVNGFE	ADAQ
RVFE	ADAQ
QG	QGDY
SHAQE	EYEM
SHAE	EYEM
GRKF	SNSA
RGLD	LGDRL
RGDLQ	LGDRL
GDRL	LGD
QLE	DKV
AF	LYVL
AYVFQ	VLKIQ
AYVFQ	VLKI
RR	MSLS
RR	QMDSLS
RR	MSILS
DMADLTK	DTDLRADM
LAYM	LYM
MADDLRT	DTKDLADM
QDQS	HNSR
RIEAR	AIR
RSR	DYED
DRNFGLLH	HLLGNFRD
ELH	GLT
TNL	HEL
LRLFVILEVVTAQDKLVLI	LLCLETFEVLNVEVAAHQILSVLEI
ECVNR	KNV
FTIVLRE	TIVE
LLTFILEVVTAHACQDKILKVLI	LLCLETFEVLNVEVAAQHDQILSVLEI
LECLTFEVLNVVAAHQILSVLEI	LRLKTFIVLEVVACQHDILKVLI
LLFKIVLEVVTSHCQDKILVLKI	LCLETFEVLNVVAACSHDILSVLEI
LRLFVILVEVTCQDKILKVLI	LLCELETFEVLNVVAASHRDQILSVLEI
LLECLTFEVLNVEVAAEHQLSVLEI	LRLFIVLVRVTAQDLVLI
KELELLFEVLNVHLIRIELVQLL	LRCLKTFIVLEVRVTACDKILKVLI
KEVT	DQLF
DDKALGE	KDLLK
KEIG	DQLF
KALG	DLA
TETI	LSQ
RTDE	ALSQ
RTDE	ALSQR
R	EESQWGS
DRVQNWFTN	RLRIRRA
HRKQLQ	LSEQ
DRVQNWFN	RLIARR
RLTVEDE	KLAASRNE
RRIQDGYAYDR	KLEHRLVE
RRIQDGYAYDR	KLEHVRLE
RRIQDGYYR	KLEHVRLE
RRIQDGYAYD	KLEHVRL
RRIDGYYDR	KLEHRLVE
RRIDGYYDR	KLEHRLE
YRRERTRATLN	NYEKETDLT
KRD	SA
YELTGNRI	RYDVQRRDYA
YELTAGNRIR	RYDVQRRDYA
YELTGNRIR	RYRQRDDYA
YELTGNRIR	RYDVQRDRYA
YELTGNR	RYVQRDDRYA
YELTAGNRR	RYVQRDDRYA
RRIQDGYAYR	KLEHRLVE
YEGLTAGNRI	RYVQRNDDRGYA
YEGLTAGNRI	RYVQRDDRGYA
YLELTGNRI	RYDVQRDRYA
YELTGNRI	RYVQRNDDRGYA
YELTAGNRIR	RYVQRDRDYA
YELTAGNR	RYVQRDDRYA
YLELTFAGKNRI	RYDRQDRGYA
YLELTGKNRI	RYDRQDGYA
YLELTFGKNRI	RYDRQDGYA
RRIQDGYYR	KLEHRLVE
YLELTGKNRI	RYDQRDGYA
YLELTFGKNRI	RYDRDRGYA
YLELTGKNRI	RYDRDGYA
YELTGKNRI	RYDRQDGYA
YLELTFGKNRI	RYDRDGYA
YLELTGNRI	RYDRQDYA
YLELTGNRI	RYDRQDGYA
YLELTGKNRI	RYDRQDRGYA
YLELTGNRI	RYVQRDDRGYA
YLELTAGNRI	RYDQRDRGYA
YELTGNR	RYRQDDRYA
YLELTAGNRI	RYRQDDRGYA
YLELTAGNRI	RYDRQDRYA
YLELTAGNRI	RYDRQDGYA
YLELTFGNR	RYDRQDRYA
RRIQDGYYDR	KLEHRLVE
QSNELLY	KTRKHRD
YKEETQLSE	YLKGIR
GGLRP	FSSTF
HRPFA	INY
SFSF	GKRP
TVW	SAVRPFG
VTF	SVRPG
NSF	RPLG
SNF	MRPLG
SF	MRPLG
TIF	RPFG
FSSTF	GGLRP
KRTFQ	EEDH
DY	YSFS
RYD	YSF
DRY	DRAI
RERA	EER
EQAD	FSSDAK
VAGHTS	SGHVTA
GDRE	GDP
VTAGHS	SGHVTA
PDPG	ERHG
VAHTSG	SGHVTA
WLI	FPFLL
RWD	DDH
CTNCAGRIKYFSIDKC	NCDPRIAYGVCPR
PAKMRD	WERGQA
GVL	GVL
KES	DEEEN
TRE	ETR
RTE	ETR
QLGI	LGQ
KAELFLK	KLEPLK
AHRIIQ	TSVI
EWSL	SIL
WLFQL	LLFQW
FWVQRELLNLTEALSAIVLTRREALAF	FWVEQLRNLTELALSLAVILERARALF
EFWLLL	SLLLLF
LI	NSLEW
TLELKLAQKK	KTLELK
RAG	YLTK
VRQG	PNI
QV	MKAT
WSN	PN
SIWN	PN
PRL	RQDAI
FLSLT	VLIELIL
FLLST	VLITLIL
FLLST	VLIETLIL
LFSSL	IESV
LFSLT	VIELIL
FSLT	IELIL
VAAL	WTI
AVA	SWT
FLVF	YFL
QFLVF	AYFL
LQTLYEISFVPTNGAVL	VELNRLGLILLASYFFN
LQTLYEISFVPTNGAVL	VELNRLGLILLASFFN
LQTLYEISFVTNGAVL	VELNRLGLILLASFFN
LQTLYEISVPFTNGAVL	VELNRLGLILLASFFN
KTIYLTIFANFT	SVELNRLGLIFAFF
IKTYLPTIFTNAF	VELNRLGLIFASFF
KITLYLTFIPTNAAVF	NVELNRLGLIFLASYFFN
KITLYVLTFITNAAVF	NVELNRLGLIFLASYFFN
LQTLYEISFVPTNGAVQL	VELNRLGLILLASFFN
LQYTELSIPVFTNGAVF	VLNRLGLILLASFF
LQTLYEISFVPTNGAVF	VELNRLGLILLASSFFN
KITLYLTFIPTNAVF	NVELNRLGLIFLASYFFN
EFRLFAIFICYET	NRTYLLLVALSSF
EFRLFAIFICYFET	NRTYLLLVALSSF
EFRLFAIFICYFET	NRTSYLLLVALSSF
EFRLFAIFICYFET	NRTSYLLLVALSSYF
EFRLFAIFICYET	NRTSYLLLVALSSF
EFRLFAIFICYFET	NRTSYLLLVALSSFN
FREFAITILSYEV	RYLLFVVSNF
EFRLFAIFICYMET	NRTYLLLVALSSF
EFRLFAIFICYMET	NRTYLLLVALSSYF
EFRIFAISTLLYEV	NRTYLLFVAVSNFN
EFRLFAIFICYFET	NRTYLLLVALSSYF
QLLIALLVIIVQST	QLLIALLVIIVQTS
QLLIALLVVIIVQST	QLLIALLVIIVQTS
QLLIALLVVIIVQST	QLLIALLVVIIVQTS
QLLIALLVIIVQST	QLLIALLVVIIVQTS
IIFALLAILVKS	IFIALLALIVKS
LLIALLVVIIVQST	LLIALLVVIIVQTS
IIFALLVAILVKS	IFIALLVALIVKS
IIFALLVAILVKVST	IFIALLVALIVKTVS
QLLILLVIIVQ	QLLILLVIIVQ
QLLILLVIIVQST	QLLILLVIIVQTS
QIFALLVIIVQST	QFILLVIIVQTS
QLIFLLVVIIVQST	QFILLVVIIVQTS
IIFALLVAILVKST	IFIALLVALIVKTS
EMTI	MLTV
EMTI	MVLTV
ETI	MLTV
EMTIF	MVLTV
ETI	VLTV
MEVL	FTI
MTIF	LTV
MTIF	VQLTV
MTI	LTV
EMTI	MVFTV
EMTI	MEVFTV
MITI	VFTV
MEVLF	FTI
EEPFVR	EKD
NVGEL	DGQH
NVGEL	GQH
FD	WSGER
MSVT	GE
SFQDF	RFE
PVDDLF	LWAAMF
FFF	FLWW
FFFF	FLWW
KVQR	QD
VQR	QKD
MWI	GIIFA
MWI	GIPIFA
MWI	IIFA
MWI	GPIF
MWI	IPIFA
WI	PMIFA
WI	PIFA
MWI	GIFA
FVIVPASP	MIAILLRRGN
FVIPVASPQ	MIAILLRRGNL
VFIVPVASDY	MMIAILLRGN
FVIPVASD	MIAMILLRGNL
FVIVPASPQS	MIAMILLRRGNL
FVIPVASP	MIAILLRRGNL
FIVASQY	MIAILLRGN
FVIPVASPQS	MIAILLRRGNL
FVIPVASPQ	MIAILLRGNL
FVIPVASP	MIAILLRGNL
FVIVPASQD	MIAILLRGN
FVIVPASPQD	MIAILLRRGNL
FVIVPAS	MIAILLRGNL
FVIPVASPQDS	MIAMILLRRGNL
FVIPVASQ	MIAILLRGNL
FIVPVASQD	MIAILLRGNL
FVIPVASQD	MIAILLRGNL
FIVPVASPY	MIAILLRGNL
FIVPVASPQS	MIAILLRRGN
FIVVPASP	MIAILLRRGN
FIVPVASQ	MIAMILLRGN
FVIPVASDP	MIAILLRRGN
FVIPVASP	MIAMILLRRGNL
FVIPVASQPY	MIAMILLRRGNL
FVIVPASQD	MIAILLRGNL
FIVVPASQD	MIAILLRGNL
FVIVPASQ	MIAILLRGNL
FVIPVAS	MIAILLRGNL
FIVASPQ	MIAILLRRGN
FIVASPQ	MILLRRGN
FIPVAQS	MIAILLRRGN
FIVASQY	MIAILLRRGN
FIPVASQY	MIAMILLRGN
FIPVASQY	MIAILLRGN
FIVPVASP	MIAILLRRGNL
FVIPVASQS	MIAILLRGNL
SYVL	FI
IYI	AFL
AYVL	FL
LIYSI	AFL
IIS	AFL
IIYIS	AFL
SYVLQ	FI
ILLVA	FMAFI
VMYAV	TFL
MYI	FLV
FSLTIGL	LFLLVL
SAALIGL	SLPLLLVL
SAALIGL	SLPLLLAVL
ISLIGL	LLLLVL
ANYTLGS	LSLPLL
NAATILGS	LSPLL
NAATILGS	LSLL
NAATIGS	LSPLLA
SGKN	RRE
NADLLP	FYFHAGDF
KEQI	DL
IV	INRP
LYRIMGLQ	LVTDSLPPFIYR
IKNLNG	LK
IKG	LK
IKLNG	LK
SYQ	VDGA
SYQ	VDGAK
KKNLPAV	KKNLPAV
NDD	KML
KLK	NDK
LAEQKD	ALQEKLD
LAKEQD	ALQEK
TLAEQKD	TALQEKD
ALEKD	LQEKLD
RLQTNFDRF	DFNRFGTRLQ
LAKED	ALEKD
LAEKD	ALQEKD
LAEK	ALQEK
LAEKD	ALQEK
LAKED	ALQEKD
LAKE	ALEK
IVVAIM	IVAVIM
LSVAIM	SLAVIM
LNVAI	NLAVI
LSTAI	SLATI
TNY	DFSTA
RKPG	TQGDR
TVALSK	TAVLSK
TVALS	TAVLSK
VALSK	AVLSK
HVLA	VHVAL
LEAALA	ELAALA
VALARE	AVALER
IVVVAIM	VIVAVIM
ELRN	NLKEN
QLAGH	KDLR
LRGDPR	AGHTQL
NIENEDRLG	KERNNNI
EKLL	QKLVG
VGQV	LEKL
QRGERL	DPADK
VLLIAVIQTQLRQQMVAIELLAHTTVLVKVVNVSLQILQ	VLIIVIQQLEQMEVIQLLGHTSVLLVRVVKVRLQAILE
VLLIIVQQILEQEMVIQLSLGHTSVLLVVSVVRLQAEIL	VLLIAVQIQTQLRQMAVIELLAHTTVLKVVNVVSLQQIL
ALLILVIQQVEMQELVQVLLAHTAVLLASVVRVVENQVEQVL	VILLVIIGVSQRMRQLSVVELLDHTTVLKVHVVRVQRVKVTQL
ILLVIIVSQMRQLSVVELLDHTTVLVHVVRVQRVVKETQL	AILLVIVQQMEQQLEVVQLLAHTAVLLAVVVRVEQNVVEQLL
ILLVQSIVQQEMQELVQVLLAHTAVLLAVVRVVEQNVEQVL	ILLRVIIVSQRMRQLSVVELLDHTTVLVHVVRVQRVKVTQL
RLHQKKLE	TRRS
LKKLE	RR
GILV	EILV
VFEL	VFEL
LLSKG	FDLG
LGEDLSK	DLKGEL
QP	EEPD
RR	DAVQ
HCNRVA	VRCNAH
ELHTMHYAVHLLIL	NGVFFSCHKSHEFVA
ELHTMHYAVHLLIL	GVFFSCHKSEFVA
ELHTHYASVHLLIL	NGVFFSCHKSEFVA
ELHTHYASVHLLIL	GVFFSCHKSEFVA
FESLKEQ	KDQ
KDQ	FESLQK
DFY	QLQM
QQML	DFY
PAE	QY
KYC	MKQ
EQAYDQIR	EREAQRRDD
IAALV	MTA
FRET	VNNFR
SLEPRG	PLEPSEA
IDVPITL	VIDTILK
QSHRKQIS	NDLKELEGRR
QSHRKQI	NDLKELEGR
QSHRKQIS	NQDLKELEGR
RLEGREQDLKN	SKQIHRQS
QSHRIKQS	NDLKELEGRR
RLEGREQDLKN	SKQIHRQ
RRLLTKE	ETVLKLER
NEFS	RIGNF
FEDYV	TEFHGA
REA	EERA
ERAE	ERA
PGF	WDN
ERA	ERA
NAY	EVE
RAEE	EER
DRL	QEFE
KNPK	NPKK
NPI	KNKQ
VDN	VDT
YLG	GLY
KTG	LDNIT
NESL	PRGL
ENSL	RGL
RGPL	ENLS
ENLT	PRGL
QEML	SFLET
RGL	ENLT
EQML	VSFLET
FSVLET	LQEM
PRGL	ENLT
ENLT	RGL
FSLET	LQEM
ENLAT	PRGL
RG	ENL
ALLPDLTL	TDLPALLL
KFGDV	VHDLGVK
KFG	VDLVK
APNPS	PSNDA
RVEWRSNEARDD	DREANSWRVRE
RVEWRSNEARD	DDREANSWRVRE
RWVERSNEARDD	DDREANSWRVRE
RAG	REDAE
AEDKRE	GAR
AEDRE	GAR
RGA	REDAE
AERED	GAR
RAG	KREDAE
AEDEKR	GAKR
ARG	DAE
SNLSDS	SDLSNS
NEPG	EPNG
ER	QMVHF
TSNN	RE
SNND	REK
KAE	VFEG
KAVEI	VFEGW
KAVE	VFTEGW
RAVNVGFAFAQ	PNLWALGFVF
KNFE	NFKE
GLY	LYLSY
GLY	LKLSY
GLY	LKYLS
GLY	LLSHY
GLY	LKLSH
GLY	LLSY
GLY	LLSYD
GLY	LYL
GLY	LKYL
LY	LLHL
GL	LKYL
GLY	LKYLHL
FNNDK	DFNN
YIVV	IEFK
IEKF	YIVV
YIVVG	IEFK
IIG	SLKL
IG	SLKL
LQIDIHY	QILHID
LQIDIH	QILHID
SDSFELDKQKT	QILQQSR
RSQQQEQ	QKTKDKELSS
RLQSDF	SDSQLRL
ALQLEQESVFVLSLI	LQELVSEVQFVSLQQLI
ALQLEQSVFVSLQLIL	RLQELSEQFVLSLQLID
VEKSR	IEQDEQ
VITIE	QIEEQ
MIANEVL	FWKVALH
MIAEVL	FWKVALH
YAKE	YAKE
NNY	MAGGG
YDGHW	EGS
MKRK	IITAE
KEPKKGY	ITAE
ITAE	KRK
EPKKGKY	ITAE
EYPKKKG	ITAE
RKK	ITAE
EYPKGKK	ITAE
TAE	KK
MRKK	IITA
PKKGKEY	TAE
MKK	IITAE
KK	ITAE
EEQK	KGT
VKN	TEHL
FNDL	RQIK
QK	EKFN
FSED	SEDF
RDHAD	KN
HRD	DHR
IKDK	IKD
ETG	GET
QRT	YDI
GIRSY	TIEP
NESW	DMVGKV
ETGV	GET
RLYP	AENRA
TERQADK	KTGYNKQR
VKTFRI	KGTFD
LSAFRD	SLAFRD
TEG	VGET
HDH	HHD
RRD	TEEQ
YVPGNI	DDPIEKAK
PAHISTQ	AKE
RNK	EES
RNK	EFES
SSPYR	SSPYR
SNSPYR	NSSPYR
YFQG	GQFT
ATTV	SN
DGVC	RCGV
IGV	RLY
KSIGV	RLY
KSIGVE	RLY
KIGV	ERLY
KIGV	ELY
KSIG	RLY
RSN	FRDR
IRGV	HELY
RTIGV	THELY
SKSIGV	RLY
YIAYR	QIM
KSIV	RLY
KSSIE	ERLY
KSEIV	RLY
DIKEHLILYLVILTRE	KDHILEYILLRVETILR
RSLIAQQENILQIYI	SRLAIQEINLQYIII
YTVLLEHL	TYVLELHL
YTVLLEHKLLDIKEHLILYLVILRTRE	TYVLELHKLLKDHILEYILLRVTILR
NIIIA	NIIII
QNIIIA	ENQIIIIL
NIII	NIIII
QNIYII	ENIIIIL
DRMGA	AGRMDE
VQEREY	SASE
RLLGR	EFES
LLE	EFKA
IWER	KELRT
IGSPAET	KELT
IPGSAET	KELT
RGD	EDLI
GVNN	NNGV
LIED	GDR
DRVGQPHERD	RHDEPQRVGDDG
GDH	HGD
VWAGG	RRE
CSE	ECS
HRRSARSL	ENKSKK
HRSARSLQ	ENKSKK
HRSARSL	ENKSKK
RRP	EVNK
RGRLRY	LRGR
ENKSKK	HRSARLS
QWQELRN	NLRWQEQ
EQTWQLRN	NLRWQEQ
WQELR	LRWQE
EAID	AIGDL
MNPGF	VMFGNP
RKQPF	SEPVDT
LTMAGLL	GLLALTM
LLAILE	IELALL
IISVLR	VRLSQIIK
LLKAILE	IELALL
LLKAILE	IELALLK
NK	HGVD
TEGAG	GAEGLS
RAGGLE	QITEGAG
PGKQT	VWVRN
PGKQT	VWVVRN
PGKQ	VWVRN
ALE	SFR
LHE	LHEE
RAKT	KNEA
AEKN	TARK
QL	KNADAGLT
GAMGTSD	NFR
RAKT	QKNEA
NFR	AGGTSD
RAKT	KEA
KNADAGLT	QL
GM	AVSLS
AVSLS	GM
GPKV	AAPAI
AAAPI	KPGV
TELI	LTI
KYFLKVVSQEADAL	AELADQSVKVFLKYK
LTLMVVQ	QVMVTLL
MVLTL	LLY
LLY	MVTLL
LTMVVQLA	ALQVMVTL
RLSH	RLH
RLSH	RLSH
HHTRR	EAHLEND
YVT	VAVIFG
LRGHH	VADVGG
QDFKEI	EIDFQ
DFKEI	IDFQ
RRG	DL
IESL	DPFTY
LYRAD	KEDLSLNG
KMFAG	DTL
MFAG	TL
IEAA	FE
FVE	FLRR
GGANG	DSN
RGGANG	DSN
LIVE	FLIVQ
FLIVQ	LIVE
RY	PDFEE
LIMVE	IVQE
IVQE	LIMVE
IVQE	IMVQE
IMVQE	LIIVQE
NIMDK	KDIN
NIMDK	KDINM
RALA	SDM
FDM	IQA
FMLK	AQIE
LTAI	IQSL
RAAG	GALR
LAIE	ADHR
IAQA	IAQ
QNKGY	ENKYT
KADL	LDKA
KADKL	LDKA
DKAL	LDKA
RKHRD	QVADYE
DKQPM	KIDQPMKV
AFVLR	NDMALS
KKNS	YG
DPKH	AGLTLGD
SAL	WG
TPAL	GRSE
TNSL	IWGS
LLR	LLR
INRY	IYNR
LLRY	LYLR
IRNY	IYNR
LLR	LYLR
SDV	VSD
TLMEGGTA	ALTGMET
TLMELGTA	NALTGGMELT
PTGEY	NTK
RREEKRL	ELRKGETD
NK	TDTTK
YD	GVS
LSAG	GLSA
VEALMG	MLAVE
VSS	MGL
GLM	SSV
KKVEASLM	EMLASVE
YTINSTGIQIGYAN	PLVNIYNCSGVQVGD
DVVIN	VVVGD
GAIIIQT	TIIQIGA
NIYNCSGVQVGD	TIYNSTGIQIGAYN
VVIVN	IGAN
TIYNSTGIQIGYAN	LVNIYNCSGVQVGD
VVIVNL	IGANYM
PVNIYNCSGVQVGD	TIYNSTGIQIGAYN
TIYNSTGIQIYGAN	VNIYNCSGVQVGD
GDVVIN	VNIVVGD
LVKNRLA	ISCTEM
ISTCTE	LVKNRA
KLVNRLA	TISCTEMK
ISTCTME	LVKNRLA
GVEK	EVKG
RRQLE	QLERR
NRKRQLQEEALP	ALPQEELRQRKN
SLSYELFS	LFSYELSS
YNQTR	RYQ
YNQR	RYN
YNQR	RYNQ
YQR	RYNQT
YNQR	RYQ
YQR	RYNQ
DYNQTR	RQTYND
ADYN	YND
ADIYN	YINDA
RSDNRS	SRNDRS
DNRS	RNDR
DNRS	RNDRS
YNR	RYNQ
RQVQHYS	QVHQYS
RSR	SNRPS
FNRS	RNS
RR	SSSPD
ADYNQTR	RTYQNAD
ADYNQTR	RTQYNAD
HSCCPE	DSSL
QVQHYS	HVQYSC
DLSS	SPHYC
DLSS	HCSCP
VQHYS	VQHQYS
HSCCP	DSSL
VQHYS	TRQVHQYS
SDN	RSD
RSDNR	RD
ENS	SCCP
RR	SSSD
YNQT	TRQYN
YNQTR	TRQYND
YNQT	QTYN
YNQT	TRYQN
YNQTR	TRQYN
YNQTSR	TRQYN
YNQTR	TSRYQN
DYNQTSR	RTQYND
YNQTR	TSRQYND
RDR	HSNS
YNQTR	QTRYN
YNQT	TQYN
ALTLTTHE	PSITLTTIK
KGK	GKK
AEGL	FST
ADVP	VPAD
LN	NNHG
HGNN	NLT
LNT	NNHG
HGNN	NL
NPAPLPG	NADAVDR
DDW	DKSW
QSSWPKSSPGY	QSPGSYPKSWS
DGELRR	RELRGADE
ADEGELRR	RRELGEAD
KGHLNSEE	ELSEHNKGW
QSSWPKSSPGY	QSSPGYPKSWS
QSSWPKSSPGY	QSPGYSPKWSS
QSSWPKSSPGY	RQSPGYSPKWSS
QSWPKSSPGY	QSSPGYPKWSS
QSWPKSSPGY	QSPGYSPKWS
VPTS	QPF
KEA	PKQVNQ
ASE	AAQ
AS	AQA
ASE	AQAH
ASE	AQA
ASE	AAQH
CLPVK	HVKPP
CLPVKC	KHVLP
HDSVATLHVH	HHVLHATVHS
VAL	VAL
SEDILLRVGYPR	RYPVGLRLSEI
SEDILLRVGYPR	RYPVGLRLSEDI
ERD	NSFR
QDDAG	RR
PRLSPR	PRSLRP
LDD	LDD
SLDD	DLD
SLDD	DLSD
DRWGR	VERT
TQCE	ERG
ENA	TPDF
TPE	DLH
RFA	AGRF
ESQ	QES
ASQ	AAQTS
SRNR	RSN
PID	NY
GWRKD	NGIEE
ET	PDN
KARG	KK
KKNPE	GRFA
KKNPE	GFR
AAH	AAH
LNLVEE	ETVQK
TSD	GSD
TTSD	GDS
NKR	NRNQI
NPKR	NNIRQ
QSCFQS	SQQCFS
CFQD	QCFD
DMTQ	MTQED
GVFNV	PGDHK
GVFN	PG
ENDK	KDN
ENDK	KDNE
LKVV	QV
NQE	DR
NQKE	DR
INQE	SELDKR
ELFLLEEEKILQYFRLL	LELRYFQNLIKELFLEL
KWGQRK	EKPTID
LCTH	CTHT
KFDL	NKTS
WDLNGILHVVKQLDLLQ	WLTNILVVEDQLRLIQ
WTLNKILEVKVDQRLELILQ	WDLNGILHKVQVDLLDILQ
DLNGITLHVVKQLDLILQLE	WTLNKILSEVVDQLRELIQQL
LNKILEVVDQRLELFIQQLLLLS	LGILHVKVQDLLLQIKELLSLEV
LINGILHVVKQLDLDILQLELSLEVE	HMTHLIDILNQTKIYKLLRTVKQ
WTLNKILEVKVDQLELIQQLLLL	HTQLDISIQLQTMIKYLSLTLV
VVQE	VVQ
HES	HES
DW	PSIQ
QPSI	WD
RPKD	EARERR
REAER	KPDR
PLNTQ	RR
QRQ	DSQN
TS	PTSS
PTS	SPT
FTV	TFV
FEA	FEA
FEA	FEAM
VTDK	DTVP
PVTD	KDTV
YEAT	YEAT
YEA	YEAT
FTI	TIF
HNL	FDE
LHNL	FED
LGGVV	LGVV
QRQYS	RNSQFA
KEDMNN	EKDNMN
RENLAANH	ERENAA
RVQEQRENTNN	NNTEENRQQQER
EENN	RNELAI
RQEVQRENATNN	NSTNEERQQRE
REELAN	ERNNALAH
RQEQRENTNN	NNTENAERQQQERV
ADYIQ	EHNTN
RVQEQRENTNN	NNTNEERQQER
RQEVQRENTNN	NNTNERQQERIV
FIYI	IASR
AGGQFE	WVQADGSR
ADGSRQVW	QFEGGA
GQFE	QVWADGSR
ADGSRQVW	QFEGG
AGGQFE	WDVQADGSR
ADGSRQVWD	QFEGGA
ADGVWD	QFGGAA
PILLGLF	LPILGLF
PILLGLF	PLILGLFR
PILLGL	LPILGL
PILLGLF	LLPIGL
LFL	LFL
ICPTQ	WS
EGQ	KALT
LEIKTNV	NTVKLEI
ACRETLWQYK	YMEFLSSAD
WRMWKIK	LLPEYPDNV
KLYLQLKVEAKF	FADQLVKLYLDAI
HKQEKD	DAHEKQ
KLYLLKVEAKF	FADQLVLYLDAI
YYIDDLEIQHQQG	HQLHILIDLY
LEIHQGLHLIIDL	LIIHQGLHELID
YYIDADLILL	DADYILYLILL
YILIHLQQGLHLIII	IKLVDLIILHLQQQGLHILI
YYIDLLIL	YIYDLLIL
YALIKLKQQELSLII	KIIILLQSLQKKR
KLQQLSLIIDIK	ILLIQSLQKKLIAY
YYIDLIHLQGLHLII	IKLVDDIILGLQQLHI
IDLEIQHQQ	LQIHLIDL
NDVVK	VKNDV
LNDVVK	KVNDV
QTAKQVVQ	FGEAI
RER	GRVR
RER	GRPEA
YAEQDVKV	VDVKQEAY
EEDSE	EKRTGG
EES	KRTG
IREIPGHKGNE	GNKEHGPIERI
GAY	GNK
FEVIILAFA	FEVIILAF
FIMI	EGKSTEL
FLM	SATELN
FLIM	TEES
FLIM	TEESR
KNLKDNHQRE	QREHNDLKNK
SAV	DLAD
HKIAKN	AKTHKI
QGKG	EKPL
PQAALVAQ	VAAQAQP
NPAPD	DPANP
KTR	PND
DTPSHY	LE
PND	KTR
PRKLR	SNVAN
PRKLR	SNVANV
YQG	QG
DEA	GDSK
FQ	DGIK
FQ	GDKD
NDDAK	QRQE
QREQ	NDDAK
NDDA	QRQ
KERC	RE
EG	NAGR
YKQM	KQMY
KTTDR	YKDAN
DANK	TDRT
KDDN	KGAK
QG	AQNQ
EDS	EDS
ELIQ	LQE
ELQ	LQE
RPRQ	PRQR
DEA	TNP
ET	SETE
PSEYAK	YASEP
PSEYA	AYPS
SYA	YAPS
PSYAN	YAPSE
DNQILSTR	RDNTLSDNQ
DNQLSTDRN	RTILSQND
DNQILSTR	RDNTLSDN
DNLSTDRN	RISTLQND
DNQLSTDRN	RILSTQND
PSYC	CYSP
NK	GVQ
LPRVYDFSFIR	VESDKGRYG
LPRVYDFSFIR	VESDGRYG
LPRVYDFSFIR	VESDGIRYG
LPARDEWDAERL	VEDRRRY
PARDEWDAERL	EDRRRVY
MGREE	QKGIK
LPAREEFAR	VEDKRA
ESRRPQ	RRPSQV
TSLG	TSLNG
GKTDNQ	QKTDN
KTDNQ	DQNTG
KTDNQ	QNLTTD
DSMPER	PERMSD
EKQ	KLLQD
KQD	EPKK
SETDR	RDETS
SETR	RDSE
ADSN	NADYS
YTGTSA	NAQDK
KAG	AGKK
NGVG	GVGN
EKVFGK	FKDGKD
HEEK	PERK
LANEAW	VWSDT
LANEA	VWASD
WASVD	NEALA
LANEAW	VWASD
ANEAW	VWASD
MILVACAALSV	LLALILF
LVAALSV	LALLIF
VACALSV	LALLIF
IIVACALSV	LLLILFFM
ILVAALSV	LLALIF
ILVACALAVGD	LLLLIFR
ILVACAALV	LLLLIF
ILVACALAVN	LLLLIFMFS
IIGVALSVRG	LSTLIIFN
VFITAAALALY	VFVVILYVF
ILISASIGLAL	LYVVYS
LMAAVAVLGLV	FVIY
LMAAAVAVLGLV	FVILYV
WLVSIGVEI	LIMLAPIKIMH
WLVSIVI	LIMLAPIMH
WLVWSIVI	LLIMLAPIMH
LVTII	FFVMLAI
WMVWSIEI	LVFLAPKII
WMVWSIEI	LVFLMNKIP
MDRDK	DRMDK
IKA	RYYE
KGVNV	DLT
KTDLV	DGVNVK
KGVNVD	DLTK
KTDL	DGVNVK
KGVNVD	DLTVK
TDL	GVNVK
DQS	RCG
SVFGRDNP	KADHVA
DAQHV	QHADV
QH	QGH
QGH	QGH
DAQHV	QHADFV
QLAAAE	KAAALQ
PHNE	HNE
ARNERRKA	RQEL
DKPGGGF	GAGFGPK
FLPVA	PVAFL
FLPVA	PVAF
FLVAL	PVAFL
FLVA	VAFL
FLPVAL	PVALFL
LL	LILP
TLL	LLIYP
TLL	LLIP
EDA	PAQ
DIQGDVL	HEQN
NPGS	PAYSH
DQDVL	HQN
QPDR	RHPQ
TPFVI	PVIF
DQD	QQH
LLL	YF
LL	LIYLP
QGH	QH
LPIYL	LL
LPIL	LL
SQM	GNLE
AE	EGR
TFSD	GDE
WKL	NSDD
LSETFLW	DPEWF
LRSLLLVPL	LLMSVPLLL
IEL	ILK
LSLLMLVL	LLSMVLLL
LSLLMLVLVYEQ	LLSVLLLKRE
ELEALLK	KLLALEE
ELALLK	KLLALE
ELEALLK	KLLQALEE
MFEL	MELF
MFEL	ELMF
RMFEL	EMLRF
LALLKAQ	LLALKQA
ELEALLKQ	LKLALEEQ
ELEALLKQ	LKLAELEQ
LEALLK	LLKALE
RMEL	EMLR
LEALLK	LLKALEE
LEALLKQ	LLKALQE
RELEALLKQ	KLLALREEQ
RELEALLK	KLLALREE
ELEAK	KLAEL
ELEAK	KLAEE
RELEAK	KLAEE
EIKL	KIEL
IKL	MIE
RNILLSL	QMVPSLKLI
IKLSM	LLSIE
ILKL	LLQME
EIKLESLM	LSMKELIE
REFE	YQYL
GSD	YYLT
EIKLESLM	LSMKELIEE
REFE	YQY
EEIKLESLME	MELSELKIEE
GSDETYY	DETYY
YYLQ	FRE
TYY	YYE
EEIKLESLML	VLMESLKEIE
EEIKLESLME	MELSKELIEE
EEIKLESLM	MELSKELIREE
EEIKLESLM	MLSELKIE
YRFMKK	YDYT
YYLQ	YYQ
EEIKLESLM	MELLSELKIE
LSLLLV	LLSVLL
REEI	EER
LSLLLV	LLSVL
EDY	GRE
EIL	KIL
EIKL	KILN
IKL	ILE
IKL	ILEN
RELEALLK	KLLAELRE
RMEL	ELRM
ISLQ	ILSL
KISLLMYLT	LISMLTLY
EMI	KMI
MKI	MKIE
EIKL	KILE
KLSLLSDV	DLLSSLKD
LSLLSDV	LLSSLKD
ILKL	ILE
LELSDVV	RQV
LSLELSDV	LLSSKLV
KLSLLSV	LDLSESKLV
LSLLSDV	LLSSKLV
SDVVPASD	APSDDVVS
KLSLLSV	LLSSKLV
KLSLELSDV	DLLSSKLV
KLSLLSDV	LLSESKLV
KLSLELSV	LSDLSKLV
KLSLELSV	LLSESKLV
TFSGQSNAVIGTQ	QGTVAIQSGFT
NN	GNNS
VPGT	TGVP
QPS	KAN
GELN	DHD
CTFT	FTTLC
GSPKISDK	AKVFKD
AQKVFDK	GSPKSIKD
ANSN	VVLRQ
RVFR	YAD
AQVF	YSAA
AQVF	YAA
PAQVF	YSAA
RVFRN	YADR
PAQVF	YAA
EDGNNF	NGNFD
DGNN	GNND
DGND	GNND
DGNN	GNDD
DGNN	GND
HE	AVA
LAVA	HE
HE	LAVA
AVA	HE
KED	DPGRF
KEDL	DPGRFY
KED	DSPGRF
EEDL	YSPTGRFY
KEDL	EPGRYY
KED	DPRF
KED	TPGRF
KEDL	EPGRY
KEL	DPGHY
KEDL	EPGRFY
KEADL	DFRY
KRYR	ETANL
AFSK	VNEY
WTM	DNRTL
WT	DNRTL
AWT	DNRTL
TAWTM	DNRTL
KSD	DEGS
LFPWD	LWFDP
EVS	EEL
RDTSD	SDRDT
AL	LGQ
RHGEC	NE
EN	GERHH
KAL	GLQ
DAVDR	RVADD
SDAV	DAV
AVDR	VRAD
DAV	DAV
SDAV	SDAV
DAVDR	RVAD
SDAV	YSDAV
YSDAV	DYSAV
YSDAV	SDYAV
RPTE	EYTRP
LQQR	QQLR
RD	KEES
YSWYR	YSWYR
SFEE	DR
YEP	VNYAP
EGTK	QE
LLSEQLN	RKHKR
MSECN	QYG
LYQKHREF	RLQYLD
TIA	NMD
YHS	LYN
FFKHGYN	HELHTSL
KRHRKDK	QLSNELLY
YYDS	DVD
KYYDS	DDVVD
YYDSM	DVD
KYYSTDR	DDVVTDE
YYSTDR	DVVTDE
YYSTDR	DDVVTDE
YYSDR	DVVTDE
YYDS	QVVD
YYDSK	QVVDD
QYYDSK	DQVVDD
QYYDSK	DQVVDND
KYYSD	EEIVSD
KYYSTD	EEIVSD
KYYSTDR	EEIVSD
KHYTDR	DPISD
KHYTTRD	DPISDVG
HKYTTDR	DPISD
KHYTRD	DPISDVG
YYDSK	QVVD
YYDSK	QVD
YYSTD	HQVVSD
YYSD	HQVVSD
YYSTDK	HQVVSD
YYSDK	HQVVSDN
KYYSDR	DQVVTD
KYYSTDR	DEVVTDD
RYYTDK	EELVADI
RYYTDK	EELVADD
RYYTKD	EELVADI
HYSD	NNVSDR
KYHTTRD	DPISDVG
HKYTTRD	DPISDVG
HKYTDR	DPISD
KHYTDR	DPISDVG
HKYTDR	DPISDVG
NKYSSRDN	DPISDIG
NKYSSRDN	DPISDIIG
NKYSSDNR	DPISDIIG
KYHTDR	DEISD
HKYTMDR	DEISD
HKYTDR	DEISD
KHYTDR	DEISD
KYYTDK	EEVVSDD
YYTD	EVVSD
KYYTD	EEVVSD
KYHTDR	DPISDVG
HKYSDR	DQISD
KYHSDR	DQISD
HKYSTDR	DQISD
KYHSTD	DQISD
HYSTDR	DQISD
KHYTTD	DPISD
KHYTTDR	DPISD
KYYSTDR	DQVVSDD
RYYTDK	EELVADID
HKYTRD	DPISDVG
YHSTD	NDEISD
YHDS	NDEID
YHSD	NDEISD
HYSDR	EPLRD
HKRYSD	EPLRD
HYSDR	EPLRDY
HKYSDR	EPLRDY
HKYDSVR	EPLRD
HKYSD	EPLRD
HKRYSVD	EPLRD
HKYSVDR	EPLRD
HKYSVDR	EPLRDY
QYYSDK	HQVVSDD
QYYDS	HQVVD
QYYSDK	HQVVSDND
YYSVDN	DVVTD
EYYYDS	WRGRCNN
EYYYDS	WRRCNN
KYYSVDN	DDVTD
KYYSVDN	DDVVTD
KYYSDN	DDVVTD
KYYSD	DEVVQD
QYYSTD	HQVVSDN
HKKYSHDR	DEIQDVD
KKHYSHDR	DEIQDVD
KYYSDQ	DEVVQD
YHDSV	LPLDR
HKYSDR	EPLRD
HYSDR	PLRD
HKYSDR	EPLRDYS
YHSVD	LPLSDR
YDS	RAN
YHSVDR	LPLSDR
KHYSHD	EIQDV
HYSIHD	EIQDV
KKHYSHD	DEIQDV
HYSVDR	EPLRDY
KYYSTDR	DDVTDE
HYSDT	IPLVD
HYDST	EPLID
HYDS	PLID
HYDS	EPLID
KHYDS	EPLID
HYDSI	PLIDR
KHYTDR	EELVADI
KYYSTDR	DQVVTDD
KYYSDR	DDVVTDE
KYYSDR	DQVVTDD
KYYSDK	EELVAD
KYYSDK	EELVADD
YHDTR	LPLVDD
GHLYDT	LTRA
HYDR	LPLDD
GHLYDT	LRAQ
HYTRD	LPLVVDNHD
HYDTR	LPLVDNHD
HYTDR	LPLVDND
YHTDR	LPLVDFD
GHYDTS	LRAQ
HYTDR	LPLVVDD
HYTDR	LPLVDFND
DGHYDT	PLRAQ
YHTDR	LPLVDD
HYTDRH	LPLVVDFND
GHYDT	LRAQ
GHLYDTS	LTRAQ
YHDR	LPLDFD
LGHLYDT	HLTRAQ
HYTDR	LPLVDFD
GHYDT	LRA
YHTDR	LPLVVDD
HYDR	LPLDFND
HYTDR	LPLVDD
YHSDV	LPLSDR
YHSDVL	LPLSDR
HYDSV	LPLDR
HYSVDL	LPLSDR
HYDSVL	LPLSDR
YHSDVG	LPLSDR
HKYDSV	EPLRD
HKYDSVR	EPLRDS
RYYTDK	EELVADIND
RYYTDK	EELVADIN
HRYDSR	EKLHDD
HRYDSVGR	EKLHDD
KYYTVDQ	EDLVTD
KYYTD	EDLVTD
KYYTVD	EDLVTD
KYYTVD	EDLTD
KYYTDQ	EDLTD
HYTD	PLID
HYSTDV	PISDK
HYDSV	PIDK
HKYTMRD	DEISDVG
KHYTMDR	DEISD
KYHTMDR	DEISD
RYYTDK	EELVAD
RYYTD	EELVAD
HYSDI	PLVD
HYDSI	EPLVD
HYDSITL	EPLVDR
HYSDI	EPLVD
RKHYTMD	TDEISD
KHYTMRD	DEISDVG
HKYTRD	DEISDVG
HKYTMDR	DEISDVG
KHYTDR	DEISDVG
KHYTMDR	DEISDVG
KHYTRD	DEISDVG
YYSTDR	AVVSDD
YYSTDR	AVSDD
HYSI	EPLVD
HYDSIT	PLVDR
HYSD	EPLVD
RYYSVHD	EEVVSD
RYYSVDH	EEVVSD
YYTVD	DLVTD
KHYTRD	EELVADI
HYSDIM	ELSDR
YHSDIM	LELSDR
YHKSKD	NEPISDI
YHKSVD	NEPISD
HKYTD	EPLVID
HLYDT	LARA
HKYTD	EPLID
HKYTD	EPLVD
HYTD	EPLVID
HY	EPLD
KHYTD	EPLID
KYYDS	DVVD
KHYTDR	EELVADIND
KHYTDR	EELADID
KHYTDR	EELVADID
KYYSTD	DQVVTD
YYSTD	QVVTD
KKWE	EDDRR
KKE	EDDRR
YDDDS	SKGKRE
KRPP	SGEV
ETLS	TS
YRYLE	RPLAER
YRYLE	ARPLAER
YLR	RLLE
YYLR	RMFEK
WQMRR	RMLEEQ
RIQRL	ETVMK
EQRLSE	RRLDR
PF	DNRA
RGFSER	RWAIGPHD
RASDREDI	REDIASDR
QTKFE	KQFE
AVVA	AVE
FYLF	FFKYL
LFFSK	FFKIY
SGKE	GSEK
RIAE	PEAAIR
KNNA	ERVR
KPN	ERV
KHKL	ISI
HKLK	SI
KHL	KSI
EP	KEF
RNAPV	ERVM
RPNA	ERV
RNAP	ERVM
NRPV	ERVM
RNPV	ERVM
GAG	GLP
KPNN	ERV
QGRTP	NQAN
PQALM	VYR
MKGL	DEKL
NRAP	ERVM
NRP	ERV
PNVKL	RVDR
NPVKL	RVDR
PMG	KAV
KD	SLN
LLSVLPP	LVVWSQQ
LLSVLSPP	LVVWSQQ
LSVLLPP	VVWSQ
ESE	HKKK
GQAPS	PSQAG
HGKGRE	HGGRKE
TKDRKSD	TKDKHRD
TKDRKHD	TKDKHRD
DSAKQW	QSDMTQET
KPN	ERL
PAY	RQ
AYNP	RQ
FQGP	REL
FQGP	RELW
GGR	SAWGD
AKSF	AEE
KV	EEEY
QTKRR	KNYTSP
MLRVPQ	LLCNLPI
RLTPQDC	ALSAPH
RLTPQD	ALSAPH
AKP	RYA
HTRTHLHS	RGTNYNR
LAP	KRG
DPVAE	DAKK
PLGAH	KRGR
VAPPSDPL	QWGQKRAV
RYYKS	LYRISK
SQNQG	YTNY
KDSRGLEK	DSRGLEK
DQNY	QDNK
QSHGQ	AALES
DQNY	QDYN
EDPKE	KND
LRAKAE	EAKALR
GQNDKSH	EKNR
FAG	FAG
EFPG	QLFKH
FPGE	QLFKH
FQQM	RYAF
GDK	AEKN
AFK	NETL
EDNQR	KKS
NTYE	PYE
RAV	LFQ
GSQ	KTTN
RLPPVPCGDVLA	LVACGDPVPPKLR
RL	LEKSAL
RTLES	LEKSARL
RTL	LEKSAL
EDVRY	TQEK
ILKLELMEKE	KEMQELLKELIK
VQN	VQN
ILEQ	EIQL
KKEKS	QSKH
SVA	PVT
KVLHE	GKS
KHE	KGKS
MVRL	NELEI
PSDK	DPS
PSDLKN	DPSLKN
PSKDN	DPSLK
QFEDYY	FEDYQY
DMQEL	FCL
NNKFI	EPSYD
DGLS	FRR
QLLITAIIDVS	TNLIFNSG
QLLITAIIDV	QTNLIFNSG
SRTSST	YQKG
KYQ	SSRTST
QKYG	SSRTST
SRTSST	YQK
GVGR	DAAL
KY	KDIM
RNP	IEE
RSRGKK	ENDEHE
PSD	FGSAD
GSAFD	SPD
APD	LYGASK
PDS	FGSAD
GSFAD	SPD
YHDT	YHDT
AKPD	LYGASK
YGLASK	PAD
YGLASK	PADK
GNSSTVS	QIVDNGALLSGN
GRE	KVE
GER	KVE
EGR	KKVE
KK	GFSR
HIV	DYLN
HIV	QDYLN
IVH	QDYLN
GDKIE	QRKS
GFD	DGF
QTST	STTQ
GLAQ	SNRR
QL	LQG
MTGDKEK	GKMEDKT
NNG	NGN
QRDE	AREQ
DQR	REQ
NRIESDE	QRADEIKRR
ADEIS	MSR
NRIED	RADIK
RS	IAEGN
NIED	RADEIK
KNIED	NRADEIK
EQ	KGNE
QSE	KEGNE
IAIS	TTITI
PPPAV	DY
DLI	KEVGT
RYTL	SGAAAQF
KSGTRNTAIGN	RSSDADKRYEIT
LEDGMSGA	LEAGGDMS
RYTL	SGAAAMQF
DL	KEVGT
RHW	AMAGAT
PEEDQ	PEDREQ
RR	RRE
RSMDLMVNQR	GTLGAITAQQ
DNYE	RFPGLG
SF	DVQQV
AELE	DTGV
FIG	AEAAA
GFQI	GAAGVMQF
FQKKHS	SGAEGMQF
FQKHS	SGAGMQF
FKHSQ	SGAAGMQF
FKKHSQ	SGAEGMQF
FQ	AAGAMQF
KRRE	LQAG
GIF	KAAAGAMF
HFE	KMEQ
VNDPYD	KKLE
VNDYDP	KKLE
FKK	DRYL
QTAFVFEN	NFVTAFQ
QTAFFN	NFTAFQ
TAFFR	FTAFQ
QTAFVFREN	ENFVTAFQ
LQN	LLQ
QES	YSE
NQES	YSK
NQE	YS
NQEL	YSEKE
NQEL	YSEK
NQLE	YSEKE
AFMH	PAA
HAFMH	PAA
PILTGC	QRL
RL	ILTPGC
VPVLL	YMAK
VPVLKL	YMAK
VDPR	VPDR
FFTGNSK	TSKGNFF
FGK	TGNFF
LTL	LTL
NKFRF	LVKNYG
KMHQQLQHQLFQHLIEQRQKLLLEREP	PRELELLKQQRLIEFQHLQHQLHQQMK
HIEERFSFQIRLQQKQL	LKQQRQLIFQFESREHI
SLT	NKGVD
NKGVD	SLT
DTPKE	TPDKE
EDLN	QDLN
GIN	KGKY
KNRDV	INDKKQ
CEGRAW	AWGRCE
LARW	LALDEEV
MLARW	LALDEV
LAERW	LANLDEV
MLARW	LALDEEV
MLAERW	LANLDEEV
MLARW	LADV
MLARW	LALDV
MLARVAWYD	LALDEEVAAK
MLAERVAWYD	LANLDEEVAAK
LARVAYWD	LALDEVAAK
PLADRV	LS
PLADFV	LG
PLADFVDEAA	LGWRQAV
YYW	IDATF
KD	VSDV
DRL	SDVN
IRD	SDVN
RLD	DVN
DRV	DSNDR
ERQ	NDPR
VGR	FDLA
FDL	VG
KDKP	KK
AVY	AGM
TA	KRN
QTKADA	DAATQ
QTAAD	DAATQ
QTAAD	DAATKQ
VLT	LER
PRWVNER	TRQT
GTTGE	EGTGTA
GTTGE	EGTGT
VREK	SGAN
RLERINN	EEEQ
QEEE	NLERRIN
LRERIN	NEEH
EHE	LERRIN
TTE	SSLR
NLLI	GFGG
KTPA	PEAK
QK	QNEY
NIL	LN
KNIL	EL
KILN	ELNKE
KNIL	ELNK
LNI	ELN
KIL	ELN
NIL	LNK
VMQI	YFSKL
KNR	NGI
MSTQ	VDSGI
RKNR	NNGI
KNRR	NGI
MST	VDSGEI
MST	VDSGI
RKN	NNGI
RKNRTK	NNGI
MST	VDSG
KRC	DTSF
RKED	PDR
EVG	GTT
ISGGAGDDRDGGAG	QGTDGNDVLIGSD
RITPPA	LTFGTE
DKG	KGD
DDKG	KGD
VEKAA	KERL
SQQL	QLSQ
SAFSMEFND	DFNMEFSSA
KAEFAMVT	YVETAFR
TMVTF	TYMVF
TVF	TMVF
EQ	QTYIVE
EQ	QTYE
NVVIGDNNIKMANAINLYG	EAKIGENVEIAPFVYIDR
YSTVGEHSYIHPRVVIRERVSIGKRV	CQHHGSACHIGSGSVIGAYSTVGE
TKIIGDDVVFGSDTQLVA	GDAEIGDNVNIGAGTITC
TKIIGDDVFVGSDTLQVA	GDAEIGDNVNIGAGTITC
TKIIGDDVVFGSDTLQVA	GDAEIGDNVNIGAGTITC
HPILEDDVIVYSNATILG	GATSIIGNNVKLYQGVTLGA
DAKIGNNVVIKQGARILSDT	EGAQLGDDVVIEAYAYVSK
SKVGNNCVLEPRSAAIGV	PAAGDDTFIGMQAFVFK
SKVGNNCVLEPRSAAIGV	PAAVGDDTFIGMQAFVFK
SKVGNNCVLEPRSAAIGV	HPAAVGDDTFIGMQAFVFK
GHVK	HD
NEK	NCF
GVA	SRE
GGSEE	TKHK
EPFNED	NKYR
EPFNEDD	NKYR
PFENEDD	QNKYR
PFENEDD	NKYR
IKNG	NGI
GYNIK	GIK
MY	RVNK
VNKR	YM
IKGL	YNGIK
GYNI	NGIK
IKQ	IKQ
IKYNG	NGIK
IKGN	NGIK
IKNG	YGIK
IKYNG	NGI
IKQ	IKLQ
REAPFL	LPFARE
RRGKD	NE
NKIDK	ADDMEP
RKSAT	DTKR
RHD	RNY
RDH	RSNY
RH	RSNY
KTSA	DTKR
NFKIDK	ADDMEP
NIDK	DDMEP
NKIDK	ADDME
NKDIK	ADDMEP
HQRH	HRDYGH
GRDYHH	WQHRH
HQRHKQ	HRDYGHK
RDYGHH	QHRHK
HQRHK	HRDYGH
RGVESE	YGDKLYH
DLERER	RERLELD
LELDERR	RERLED
ILLD	LLPIR
LIDL	LLPIR
RAFN	YP
RAFN	YAP
NRFD	AYAPKK
GK	DYGQ
GKK	DYQ
NRGK	RGYKQ
ASHADHK	HKDAASH
QYIIN	KGD
RQEGEN	GENRQI
GD	QINY
RQIEGEN	EGENRQ
PSAL	QK
NSKLKE	QTECKK
QGAT	QAGK
RTKE	KER
WME	LRG
WMEN	LRG
EWMEN	KLRG
ALSDQR	DTDT
NYAQ	NYAQ
YAQN	NYAQ
GNYA	NYAE
NYAE	NYAE
ENYA	KNYAE
KAYKKS	GNYAQ
GNYAQ	KAYKKS
NYSE	NYSE
NYAE	NAE
NYAEK	NYAE
NYS	NYSE
NYSEK	NYSE
TTHGS	NYSE
TTHGRS	NYSE
SHTSRTKG	KSRTTSH
KHRYS	EGNDLKV
HS	KQVHPDT
YQKST	R
STTKSHG	KSRTTSHG
YSEN	NYSE
YAENK	NYAE
KQST	NR
NE	NYAE
QNYAR	RNYAQ
NYSE	NSE
NSE	NYSE
NYA	NYA
KPKKG	KKGPK
NYAE	NYA
NERKS	PKY
NAE	NYAE
STTRKSH	KSRTTSH
STSRTK	KSRTTSHG
STTTRKH	KTRTTSH
NYAQR	NYAQ
DKEQK	KQKAAKE
AAH	AH
ATPVDM	VTERP
VLWT	FV
ATPA	VTEA
PKLSKY	FDQEIK
PKLS	FDQEI
ATPADM	VTERP
QLQKVWPGDRC	RTSTGDE
ATPVN	VTEE
VCPV	VTEA
SGYP	KGYPA
ITLDY	ARISIK
NAE	ITD
IKRH	TLDDIAE
DADT	RKI
IADT	RKI
QQQEE	TDEAED
EGAEK	RLE
PE	ESTP
SPE	SETP
RDE	ERG
ALDTEQA	QLAPH
KALDTQEQA	EQELAPH
ERDG	RRAK
ERDG	RAPK
QY	SYGVH
KDGS	GSDK
PNG	TAH
TSTL	GCITA
VDNPNR	N
AMMMA	MMAAM
TGRVY	KE
GRVY	KE
VY	KEK
VART	FPLN
IAR	FLN
VIR	LQSR
VIR	LPLSA
ILR	FPLS
IARD	FLR
REE	YVPES
EEL	SEL
ELSR	ELE
WMDALGN	DALWMGG
WMDALGNR	DALWMGG
QGR	IRELK
FRDLDPN	DFRDLNP
MAEE	EMAE
KEGQK	QRKGE
KNR	RYEHND
MGDLGIGAK	QNEKARTE
MDLGIGAK	QNEKARTE
DRT	RDT
VADHS	RE
RRVK	QDGD
VGK	VGK
FRYS	FRYS
LMFTVAIL	LYMFTLVAIL
SSE	PKLED
SSE	PK
VR	KDEYQG
VR	GKDEYQ
VR	GKDEQ
QGTL	DED
PG	RTVI
VPGQQ	YRNY
YLD	RFDAQ
KY	EGTSA
NSGR	ETSG
MSKY	YGQ
GTT	ESKWV
GN	MVQF
GNQRLIND	MVQFQK
GSMVRER	KDAE
RDGGDQ	VMYQP
VDKR	RDS
KY	QTA
KY	EGTS
NSDT	KY
SDTS	KY
KY	STDS
KY	SDTS
KYI	SDT
YV	GYV
NQM	ESG
SGEES	NAM
GES	MNQ
QKY	RAQT
KY	ARQTG
PGV	DARG
RPGDR	RAESVE
GTG	ARNG
FR	VADAE
MSTK	HE
GMSK	HNE
FR	AAASE
AGDK	NRE
PGDR	AERE
GT	SGAE
PDR	DSQE
SGDR	ADNE
PGR	ESAE
RPGR	SDAT
RPGR	ASQE
PPGT	NGAK
RPGR	EARSE
RPDR	SADQE
RSGDR	ADLRNE
PGT	NGA
PGT	GS
PGDR	AESE
SGDR	NADNE
PGR	AESEM
RPGD	AQDAL
SGDRK	NADNE
RPIDR	NSTGAERSE
RI	DSADA
PGT	SGAA
RPGR	ADSEM
RSR	DNREM
RPRID	NSTGAERES
PGR	DAS
RSGR	DNAE
RPIDR	NSTAERSE
PGRIR	DAGATL
RPGDR	NSEQM
LRSDR	NDANRE
GTK	ASGAE
RPGDR	INSEQM
LRSGR	ADNE
YVKR	RTSGLES
GV	GAD
RPGLDR	SGAEKGTE
PGCG	SGAD
RPGDR	DQE
RSGDR	NADNLE
RIDR	ET
PGT	SGAK
RSDR	DRNE
GTT	TGA
RIDRK	TAESTE
PGTK	DSL
RSDR	ADNRE
PGT	GAS
PT	SGA
GT	ASGA
GTTLR	NGAN
GTGKT	TGAER
TGKLLRA	GFNADN
RRIDRK	AETMFIRR
PTKT	DGS
TL	SGAEK
PGTL	NGA
RSDR	NREM
GTG	NGA
PTGKL	DLSGA
LRSDR	NRE
GL	FNGA
PGT	GAVK
PGCTK	SGANQ
LRSDR	ADNRE
PGR	AAVE
RRIDR	AET
GTGKLLRA	FGNADN
GT	SGAD
PGDK	AENQ
PGD	AENNQ
FR	SASE
GT	GAD
SGR	RNTE
PGT	NGAQ
PGD	ARS
PG	NGA
PGR	DAQE
PPGT	NQGA
PGDR	ARE
PGR	ADAE
DR	KAEGE
PGDR	ADSQE
RSGRDRK	NDANEM
PG	NGAQ
PG	ASGV
PGLDRK	GAKEGEY
RPGLDR	ADSNQE
RSGDRK	NDANE
PGDRK	AESRTEM
PG	SGAA
SGRDR	ANE
PGDR	AESME
RPGR	SADAKE
GT	ASG
RPGDR	ADNSQE
GV	TGAD
RPGR	SDAAE
RPGDRI	SADAKTE
PGDR	ADAE
PGDR	ADKAE
RPG	SADAK
PGDR	ADKATE
RPGDR	SADAE
PGDR	ADAKE
RPGDR	SDAAKTE
PDR	ADKAE
RPG	SADKA
RPGR	SADAE
PGFDR	ADKAE
SQSGA	RLR
SQSG	RLR
GC	SGAE
GCGL	FSGA
GC	SGA
GCGLR	FSGENAE
PGDR	AERSE
RPGDR	AERSTE
PGDR	AGTE
LRSDR	ANRTE
PGDR	AESEM
GT	GAS
RPDR	SDAQTE
GTG	SGAD
RPGDR	SDAGKTE
DDVPT	SKD
DVPT	SD
DVPT	SKD
VPT	DVR
PGVG	DTIAL
NEVPETLK	TPKHTS
EPGVG	RLPD
MAGESR	VNY
YTVSEQ	KTRK
TQD	ENK
RRR	TRP
SRRR	TRP
LDGMK	MRC
SLH	HLN
TFLF	FV
QKNNYSDE	NDQIKE
MRKE	LGEEN
EGYS	MVRW
PP	DGGHD
SRLVGSP	GSP
TGSP	VGS
TMADTLVDNK	QEDVSG
TVDF	FSD
SG	GRA
LSG	DMG
SGS	DMGAR
PEQGPR	IRRTHER
TG	VYGAR
TG	YAR
PTGV	EYG
PTGV	EYGRA
PEQGPIR	IRRHTRE
DPEQGLPR	EIRRHTR
PEQGPR	IRRHTRE
PEQGLPR	IRRTHRE
LNLDE	RRQR
PEQPR	IRRTRE
DPEQGPR	EIRRTRE
TG	KTGAR
QI	REM
KGA	KDTDR
KG	KDTDR
KKEYS	EDDTR
EEPG	QR
EEPG	RQ
EPGD	RQ
EEPGD	RQ
TVFHLKVA	LQVLTAMN
FHLKVA	LLTAMN
IRGYGY	HV
PVIQE	RIK
PMEFTDF	QQIRS
VEIG	HIE
DDSGK	N
EQNH	QENEH
KMN	MKN
RTEGMIKV	YLSNRE
DMK	KEE
NEER	STQ
NEER	TQS
EER	TRSQ
RL	IKQV
QEMK	KTQA
VKL	KVPD
DMK	KQESAE
DMK	KEQA
PN	DGSP
RAR	LEGI
IRRK	VLNE
ERRM	HN
LR	KDNE
EFEN	RDANNA
AARDT	AAFE
LTLL	LK
TLL	AL
TLL	AGL
KTQ	KAL
AVHAQEFENAAN	QERILSNH
KNT	KAL
DRHDG	HDGDR
CVG	VGC
KD	EDYPKTSK
NCG	CGN
AVG	VGA
RKREG	RPIYD
PRIY	REK
PSYSW	NGV
NGV	PSYSW
CVG	GVC
NKAGI	HQ
QAGV	GVQAA
ANPV	RMEK
AAPV	RME
KAG	DGT
ANPV	RME
VGD	FYN
VGDR	FYN
VGFDR	FYN
YE	LLKK
KEGYTTPETGNKG	EGYKTTETKGNGP
HRE	HRE
HFL	HF
VTLSGGR	GRSGLTV
AGSTK	LLTN
AGSTK	LTLN
AGST	LLNT
AGSTK	LLNT
GSTK	LLTN
QKKK	PNELVD
NDG	DKGN
QTGAPTETV	TETVAGPTQ
EA	DHH
RRHRER	QDEDR
TGRKA	ARPQ
HNTDQ	HNTDQ
TPFGQTS	RDRVRLG
TGQTS	RDRVRLG
TFGQTS	RDRVRLG
NEKCPADM	NEKCPAYD
YNEKCPAD	ANEKCPYDM
DLGFDDRF	DLGFFDRD
LLGT	PGAS
LSLA	LLAS
ESAVA	AESVA
GNDR	DGNR
TRMA	TMAR
SYQ	YQS
EASS	RSAK
PPSQL	TGDKEYG
HET	ETRNG
AYAGP	AAARK
LEVL	LKLV
EQNFLSRG	GRSLFQNE
ADD	KTR
TRK	ADDQ
RR	AES
EAFKT	KAFTED
GKSEEAD	KAEVEG
LVPRPGF	GFRPPLV
EYLNDHPA	HYD
AGS	DE
DEMERN	KIRKAR
IARGC	GCRIA
DEMERN	KIARKR
KHYQRE	HKYQER
YPFLAQ	APFLYQ
YRLH	NIK
YRDH	IKN
HRQLV	EHQLVR
EHRQLV	HQLVR
EHRQLV	HENQLVR
ENHRQL	HENQLVR
EHAG	KGKHE
NSISQ	QISNS
RRG	GFESL
DPW	RELG
ERLG	WDLP
DLW	REG
ERG	WDL
EGNN	TEPYESGN
PYETSE	GNE
EGN	YETEPS
RETV	QTREV
RQG	RRD
DPDD	RKNK
LSE	QKHIKQ
LE	IEEGD
QHQIK	LES
LNVRSL	LVSNRL
PSRGR	QYD
KDLYQ	KITELP
AEAQR	RRGFER
AEAQR	RRGFE
RRG	AEA
QAA	AS
AVEQVN	NQVEV
VNP	HEE
VEPH	EEH
RNRDT	EVK
RRDLT	DLTR
NNQ	RGLFT
LK	LKD
IAEKNH	QEEF
TIRESRVVG	VVGRRESTI
RQNI	EAQISE
HRQNI	ASEIE
HRQNI	AEESI
PHAAED	NPARE
RWYD	WMW
AEWERWYHWQ	WWSWKFY
WKFWWKF	WEYWQY
AQWEWYHWQ	WKFWWKFYS
AQWEWYHWQY	WFHWVWKFSY
DEERK	VHNQD
AEWERWYHW	WWSWKF
WFWWQ	WYWQY
AQWEWYHW	WKFWWKF
AQWEWYHWQY	WFHWSVWKFYS
QAPIHWVQ	QWVQHIAP
QAPVHWVQ	QWVQHVAP
RNR	RVRPND
DGQT	WRLT
ASK	AKS
FTHQR	DDLGK
THR	DDLGK
THQR	DDLGK
FTHR	DDLGK
KQK	LEPESGEN
THQ	EQ
GYA	VMQG
EESSIHH	HHSSIEE
EESGSIHH	HGSHSIEE
TERG	PKA
RKE	NPLR
RKE	NPR
RKEG	LNPR
RKE	PLR
RKEG	LNPK
RKE	LNPR
RKEG	NPLR
QWTQEEA	EAQTEQ
PKAE	ADPR
IR	PRAV
GDLKKIRISAPQR	YETDVDPE
IRISAP	ETYDV
LIGE	TKR
DLGE	TKR
DEAG	PTNL
YNR	RVA
QQ	TSNT
QGVMVGMGQKD	NDTSTKAD
QGVMVGMGQKD	DSNTKAEDTYE
QGVMVGMGQKD	DSNTKAEDTY
LEMRPF	GAKT
WELR	TFPKK
WELR	TFPKLK
LMAGD	LQG
SVAPTER	TGRIE
SVAPER	TGREI
ILRPD	ILRPDI
HQAIE	QHAIK
HQAI	QHAI
GQL	QGL
HQAIF	QHAIF
FQLM	QFLM
TQLY	QTLY
EWL	EWL
FQAV	QFAV
AGT	AGT
AGRT	AGT
AGT	AGRT
FQGLW	QFGLW
FQLT	QFLT
NQGIF	QNGIF
NQYLF	QNYLF
HQGIF	QHGIF
HQGIF	QHGF
HQSVD	QHSD
HQSVD	QHSVD
HQSD	QHSD
FEGVF	EFGVF
KQLA	QKLA
QLNQK	QLNQK
FQLNQK	QLNQK
FQLQK	QFLQK
FQGLH	QFGLH
QVIF	LQVIF
QVIF	QVIF
LQVIF	QLVIF
NQL	QNL
ANQL	QANL
RANQL	QRNL
RANQL	QRNLI
ANQL	QNL
RNQLI	QNL
NQLI	QRNLI
RQA	QRA
RQAFD	QRAD
FQMQD	QFMQD
NQGVF	QNGVF
RQIIH	QRIIH
FQLV	QFLV
FQLG	QLG
QLG	QLG
LYSNSY	MWGGMD
LYSNSAY	MWGGMD
YNRMA	ALQNR
YTAGSY	WGLGMD
YRTS	RYTS
PYA	YPA
TPED	ETPD
TPGQ	PRP
RPP	GQTP
YAASRQ	LSGWD
YAASRQD	LSGWD
FTHPD	IAGA
RAQ	PG
QLTQYW	RWDAQD
WDAQD	LTQW
EMR	DEA
WRK	EEE
DEE	RWQR
QCLDGNC	EMSCD
CLDGNC	ESCD
CLDGNC	EMSCD
CKNGK	EKCD
CKNG	EKCD
QCKNGK	EKCD
QCLDGNC	ESCDM
CLDNGNC	EMSCD
SQLKG	KNRD
NKR	DNKFA
GYDVSGI	KN
RWVNEA	SCEI
INCWPSESDVNIE	TAEFLSKLKD
FTE	QIRTF
IAHGFT	HGFIAT
DLAYKAN	YADLN
DLYAN	YKDL
KVK	EETLG
GADGF	KTH
DRS	RSQTD
ERS	RSE
HDVTDR	QEDTGEG
HDVTTD	ESGQ
RNPT	LAPR
YD	LLTP
RST	RST
WAGVR	AYTD
SIVSSYL	RQNVTRMPLTVY
RDLLL	SRDLLLLL
DLLLTL	KLLLLL
PDH	HGPD
IDDTR	HRDY
ELDSNL	HYERKN
SDDTR	HRDY
ELDSNL	HYRKNE
ELDSNL	HRYEKN
ELDSNL	HYEREN
ELDSNL	HRYEEN
ELDSNL	HRYKNE
ISDDTR	HRDY
ELDSNL	HRYNEK
YLTL	LTYL
LNYTYLEQKKLY	YKLKLQYETNY
QLSTA	GGVNN
QLSTA	GGVNPN
REVASRVDFFTM	LKAAAGGVKAYVM
REVASRVDFFTMVRG	LKAAAGGVKAYVM
QFTFE	ETFFNQ
NLICLIILL	IFIILLM
NLIICLIILL	QLIFLLLIML
NNLIICLIILL	QIIFLLILLM
NLINLIICLIIILL	QILFCILLLICML
LQFICLILLCIML	NNLLIICILIIILL
IEMQRQLQFILILLCIML	NLQQANQNILICLIIILL
MQQNQNINLICLIIIL	ARLPQQQQIFLILICM
PQQARQLQFILILCIM	QQMNNQNILICLIIIL
MQQNQNINLICLIIIL	ARLPQQQQIFLILLICM
MQQNQNINLICLIIL	ARLPQQQQIFLILLICM
MQQNQNINLICLIIL	ARLPQQQQIFLILICM
GGR	RVGG
AGVVG	VAGVG
VCNTK	QNKGE
GTNE	NV
SGR	RGSG
YSLKE	ELKSY
RNICK	ELLD
NKY	GKSIQE
IIQETGK	KYN
SGG	GR
STAPATN	NTAAPST
KDTEDKE	EPKERFK
LTKAQK	QWDK
QPELESD	PLESEDE
KQ	QHAVS
LKAQH	QDWKPEE
KVRE	QQFCVG
TKVRE	QQFCVG
KVRE	QQFC
TKVREY	AQQFCVG
YHAGKQLGAI	IGAQLKGAHY
TGCHEIVQGI	EIVQGIHGTC
HSLLWGPE	NLET
HSLLWGPE	NLTE
HSLLWGP	NLTE
HSLLWGP	NLET
HSLLPE	NLT
HSLLWGP	NTE
HSLLGP	NLT
HSLWPE	NSLE
HSLWP	NLTE
HSLWP	NTE
HSLWPE	NSTE
HSLLWP	NLTE
HSLLWGP	NET
HSLWPE	NLSE
HSVI	SGSL
LEG	LGS
LEG	LG
HSVI	SLGS
HSVI	SGSLL
QSVV	SGSL
QSVV	SGS
FHSVDV	LLGSS
HSVI	SSLGL
SVI	GSSLL
SVI	SSLGL
QSV	SGS
LEGN	LGSS
NII	SSYNL
SQRF	ME
SQI	MEV
VNSFGIA	IRIA
VNSGIA	IRIA
VNSGI	IRIA
NSGI	RIA
VNWSFGV	IRPI
NSGIA	RIA
VNSGVA	VRIA
VNGAFS	IRPI
VNGAFSN	IRPI
NSGIA	PRIA
VSGI	IRIA
VSGIAS	IRIAP
VNSGVA	IRIA
WEA	TEGR
WEAA	TEGRS
HFWEAASE	EGMRSTDD
TLE	IPRK
PRIK	LET
TLED	IPRK
LLRGN	RLR
RGN	LR
RGN	LRG
LRG	RNG
DTRG	GYPG
PGY	TRGD
PGGY	TRGD
DTRG	GP
YTN	YTN
KQVADN	NDNSTAST
KYYE	EYYK
QAGY	TASD
DAST	GAY
AGY	ASTD
DAST	AGY
AGY	AST
AGY	DAST
DAST	GAQY
KYYSE	SEYYK
AST	AGY
AG	DAST
QAGY	TAS
VSNA	NSTNSSA
PGY	SRGD
DSRG	GYP
NTSNSS	VSNA
VSDNA	NSNTSS
NTSNSSA	VSNA
VSNA	NSTNSS
NTSNSSA	VSNDA
PGGY	SRGD
KQVADNA	NDNSTAST
PGY	DVQ
DVQ	PGY
PGY	VQGD
DVQ	GYP
PGY	VQD
PGY	ARGD
DARG	GYP
PGY	AGD
DTRG	GYP
PGY	TGD
VSN	NTANAST
NTSNAST	ASNY
ASN	NTANAST
PG	TRGD
ASDYN	NNATAST
PGY	TRDG
NTANAST	ASN
NTANAST	ASND
VSN	NSTNAST
KAEK	TPIG
DTG	GYP
ITPG	EKAK
DTRG	PGY
QNTDYNA	DNSNTAS
QNTDNA	DNSNTASA
QVADNA	DNSNTAST
DTR	GYP
NTSNAST	VSN
NTSNAST	VSNDA
VSNA	NSTNAST
NTSNAST	VSNA
VSN	NTSNAST
TSNA	NSTNAST
NTSNAST	SNA
NTSNAST	TSNA
KEK	TPGIP
PGITP	KEK
TSNA	NSTNAS
RPGY	VQGD
DVQG	GYP
PGG	ARGD
NTGNASS	DSN
DARG	GYPG
NTGNASS	DSNA
DARG	GP
PG	ARGD
DSN	NTGNASS
NQK	AGQKA
YHDG	HDYG
YHDG	HYDG
WWM	WWM
GGN	GGN
SV	TELLE
EHLGDF	QP
YRPK	PKYR
KFPIAD	YGCVIN
KFPVKDIML	YGVVGVNA
KFPVKDIL	YGVVGNVSA
KFPKD	YGIVNA
KFPVKDIL	YGVVGVNA
NPTDTILLAL	DTPNLLTILA
RAEFF	FKGFFGF
EFFF	FFF
LRYQKCLDA	LDKCYQLR
LQMRIRQY	TDLKVLLEEK
DELRLN	NLRLED
SNLVALSLENLRS	NSLVLASLNRELR
RMYR	YLAMR
DSSR	RYLD
QLRK	RGALE
QLREPRE	EGALISPRG
QLREPRE	ALISEGPRG
EVGGL	QRAG
RES	DGLS
GLRSD	ESRR
YAAAG	GAAY
RES	DGLRS
GLRSD	ESR
YAAAG	AGAAY
HRE	RGGD
LETSCQ	SETCQL
SRG	IN
TT	QGT
AKV	TG
ILKERILERLKEILKKL	LIKEIRELLRKEILKLK
LERELKREKEK	IKKLREEKE
ILKERILERLKEEILKKLLQ	LIKEIRELLRKEILKLEKLQ
LERELKREK	IKKLREER
LKILLEILLQ	KILMILLKILLK
EGFDPDGK	PDGKDFGSE
EGSFDPDGK	PDGKDFGE
HELNR	NLREH
NRPK	KPRN
RYLATNE	YTLNRN
RYLATNE	YLNRN
KISGSA	SIGARS
KIG	IGK
MGE	MLGC
KENR	PKR
RVTE	RREK
DKR	KDD
YQ	RGELV
HHD	HQK
AI	DLLG
SEE	KR
EKV	PKDLG
EIH	TYQN
QIQ	SRRIG
KQ	DENK
VWHR	NVHRW
NVWHR	VNHRW
KK	VGEAN
KIGK	EDDPV
RV	QAED
PYT	PYT
ENER	NEERT
QEESPY	YPSEQ
NDTK	QTK
THQH	QY
ENER	NEER
GDN	NQ
KSGH	DSS
QAED	RV
YAFD	KG
GKGK	KGEN
FTK	QG
LDFRVRF	QALKAD
FLDFRVRFK	QLKAD
NLGCNDSVRE	RRQEKMRD
KD	DNGSQ
LHRI	RHIL
RPD	RPDGP
EDVE	YSQK
DG	QTID
PPGL	RD
MKHK	QN
RECNRQ	RQNCER
LGRC	YVS
MRIE	RMQM
KVKV	DNQ
REYER	DGT
ERMQM	MIRN
EMQM	MIR
MRIN	ERMQMK
ERMQKM	MIRN
EMQME	MIRN
MRIN	ERMQM
EMQKM	MIRN
ERMQM	MIN
MRIEN	ERMQME
ERMQME	MIRN
ERMM	MIE
DGIPEIKE	RYIQDK
PGLHQ	DRFY
DGESIE	KGERQIMR
KGTG	TGGK
RECNRQ	RQNECR
GS	SDYG
GSDY	SDG
IKP	KPI
PEN	FRRF
RHAR	SERDL
DGQFT	NQI
HERDHI	DERIHIH
HERID	DERH
ENR	ETSGV
DAQE	KR
PITLVF	IPTLFV
GGVIE	FGGIR
LTVA	YRE
KYLGD	VNRL
VNRL	KYDLG
TELKY	KKSEL
TELKKSQK	YKSLKTE
DTELKSYK	KSYQLKET
IILIPLY	AIFVVHL
LIMIDVYT	ITVVFEAYTLR
LIIDVYT	ITVEAYTLR
LIMCIDVYAAQ	ITVVYEATLR
IFFPLVG	LIIVL
IFFPLV	LVIIVL
IVIPLFGIM	LIFVWFHIGL
LLIQ	IIGHKR
VFIGCD	IILGHK
LAQFATN	IAIIHIR
VFIGCD	ILIGHAK
IYVE	IIIGGG
LQF	IVH
FLQ	IGVH
RWHMP	PFMT
KEGGQ	GQGKE
YDAN	NAYD
ELNSPR	LDEE
DEEL	NPRELS
DEEL	NPLS
DNEEL	NSPEL
VRQ	HNGS
GDST	KDNY
RRN	RDGAY
IRLSIKLMILLTLN	IELEEILSLILNL
IELEIELILLL	IRLILIKMLLL
IRLIKLMILLTL	ILEEILLILRNL
IRLSIKLMILLL	IELEEILSLILRL
MLT	NLRL
SMGLRT	TLM
IELEIELILLN	IRLIKLIMLLLT
IRLILMILLL	ILEEEILLILIA
IRLIKLMILLL	IELEEILSLILR
IELEIELILLRL	IRLIKLIMLLL
SSLRK	EASE
SIRLIKLMILLL	EILEAEILLILR
GRT	TMGL
IRLIKLILL	ILEEEILSILL
IRLIKLMILLL	ILEEEILSLILR
IELIELILLLN	IRLILIKMLLL
IRLIKLILLT	ILEEILLILN
IRLIKLMILLL	IELEEILSLILRN
IRLIKLMILLL	ILEEEILSLILRL
IELEIELSILLL	IRLIKLILLN
IRLILILLL	LEEEILILLL
ILILL	ILILL
IRLIKLMIL	IELEEILSLILR
ELEIELSILLRLN	RILIKLILLLT
IRLSIKLMILLLN	IELEILSLILRL
SIRLILMI	EIELILLIL
HFLAS	ADILLF
YHFL	NILLT
KE	NEGK
KE	DEGKN
AAGGTATHHASAAPAR	PVLRTGDVLGMIR
AAGGTATHHASAAPAR	PVLRTGVDLGIRM
TMDS	VRHE
VHRE	KTMD
RRFQGEDM	RQRV
RRFQGEDM	RRV
RRQEDM	RRV
RRFKGEA	RR
RRKGEAM	RRV
R	RRKGE
RRFKGEAM	RRV
RRAED	RR
R	RRFAGE
RRFAED	RR
KE	NIAGS
KE	ENIAG
NIAS	KEL
RRFQGEDM	RRQV
RRQGEDM	RRV
GSAK	FDAS
RRFAGED	RR
GRVR	AMSE
KVN	LNDH
RRQEDM	RQRV
FPGN	FGH
DAKK	KD
FGHPF	PHGF
RRFQGSEDM	RRVQ
LNHD	KNV
LNHD	KV
NHD	KNV
KVN	LNHD
RHKEAM	RRV
RHFKGSEAM	RRVH
RHFKGEAM	RRV
RHFKGSEAM	RRV
RHFKGSEAM	RVHR
RHFKGEAM	RRVH
RHFKGSEAM	RVR
VKLASW	KALMDP
RRFKGSEA	RR
RRKGSEEM	RRKV
RRFKGSEAM	RRV
RRFKGEA	RKR
RRFKGEAM	RKRV
RRFKGSEAM	RVRKR
RRFKGEAM	RRKV
RRFKEEAM	RKRV
RRFKEAM	RRVR
RRFKGEEAM	RKVRR
RRFKGEAM	RRVRK
RRKGEAM	RRVRK
RRFKGSEAM	RRVRK
RRFKGEAM	RVRKR
VRRFKGEAM	RRV
RRFKGEEAM	RRV
PRN	ISSPR
RRFKGEEAM	RKRV
RRFKEAM	RRV
ENDNA	KGR
KGR	ENLDN
TDF	TH
TDF	THR
PH	DTFG
AER	RAE
RRFQED	RR
RRQED	RR
YDTFTG	KE
RVRQ	DERRQ
NKAR	YPPERMS
PERMPSY	RANK
NKAR	YPVPERMS
PERMPVSY	RANK
EEIP	HN
VRRQGEDM	RQRV
RRFQEDM	RRV
RRFQEDM	RQRV
RHKGES	RKR
RHFKGESM	RRV
RHKGESM	RRV
YILTFLELR	IYLTLFLER
YILTFLEL	IYLTLFLE
YILTFLER	IYLTLFLR
NVDKA	AKDNV
VPQVPDNNDH	PQVVPDNNHD
VPQVPDNNDH	PQVVPDENNHD
SNQTRYKLPY	NEGRYQTTE
NEKL	STTRYGEK
QLTS	TPNG
NEKLP	STTRYGEK
LEEY	RTSR
SEEY	KSNK
SLYL	RILL
FQH	TEDGY
HMGGVEVLEVRTG	VRTGLEEVGVMGH
HMGGVEVLEVRTG	VRTGELEVGVMGH
HMGGVEVLEVRTGQ	VRTGLEEVGVMGSH
HMGGVEVLEVRGQ	VRTGLEEVGVMGH
TGP	NSSDQ
FEMI	FEMI
NVP	VPEN
ED	DKPN
SSAQ	DE
KLASEY	TSIR
NVP	VPQN
LERY	FYSDE
SDFY	ERYL
SDFEY	ERYL
SLDFY	ERYL
LVS	VLS
NVP	NVE
VAEQIEKR	EKIAEQV
VAEQIEK	EKIAEQV
VAEQIEK	EKIQAEV
SGPY	YSGP
ADRGT	WNEW
WENW	GTRDA
LYY	PTTNILI
LYY	TTNIPLI
CSSD	IH
YTSV	YTSQV
LLR	APEMG
NGRGDD	RMKKVRGP
SNG	NSG
SNG	NGS
NSKD	NSKD
ETERT	REQAA
ILS	LSK
QTYYN	YWNTY
WDNDQTYK	QKYDTND
WDQK	YTY
DNQYDK	KQYDTD
TAF	TAF
RQKKK	DVASI
GIEIPDEQ	KEEFGIE
SLTVVMEIPDAE	LAFRRQ
VLTSMVMEIITPFQ	QQSMVVRQ
ESLPANT	PGSVR
SLPANT	PGSVQ
ESLPAN	PGSVQ
ENLPPNM	PGSVR
ENLPPNM	PRSVG
RAELQ	SNYS
NV	NVK
TQE	TQE
YLLEEK	LYEKLE
FNVVALDMC	DEFFSLKA
FNVVALDMC	PDEFSLA
FNVVALDMC	PDEFLSA
REY	RKPE
DNGAQG	QLPSR
NCKY	NCKY
TLNTVA	NCYK
FFV	IAIFL
SILY	FIILA
NLIIA	LLII
FFAPI	FLL
FQTG	PAWSYS
EEGKE	RNK
TSDY	RE
AIIKN	IAIKN
DLKGEAEIN	INAEGEKDL
EYEGKD	KGDEYE
ALKD	LADK
KAEAE	EEAKA
KLV	LKV
KL	HGDL
HGD	KDL
AAG	RAI
LAAG	RAI
HE	DGGV
TDLWVDRSEFY	RPLVIVKTV
DLWVDRSFYE	PLRVIVKTKAV
TDLWVDRSFYE	RPLVIVKTKAV
TPFL	KFI
DVL	DTGI
TADDVE	EADVDT
RGVSLD	ESDVLG
EKNGVSL	RESLDVG
DRRDT	KSEWRPE
DRRDT	KSERPE
NE	QQRE
NE	QQRER
PHGLD	DGLPH
HGLD	DGLPH
EGKA	RLSY
KEPT	KEA
NGVN	NGVN
RIYSST	YRISS
RIYSST	YRISST
NGMD	DGMPN
NGMD	DGMNK
RIYSS	YRISST
PGGLD	DGLPG
PGGLD	DGLPGK
WDRFER	WWDRFRE
PNGVN	NGVPN
GGLKD	DGLPG
PHGID	DGIPH
RISY	EGRV
HRIY	YHRI
NGVN	NGVPN
EDMGVVFV	FVVVMGD
EDMGVVFV	FVVVMGED
IGES	RES
RIGES	RES
RIEES	RNG
SSF	RRSA
ERN	GAERL
RIGDS	RN
VVV	GVVV
HWGQPHWGQ	PQGHPQH
GQGQGQGGQ	PWHPWHPWHHPW
GMPHHF	MGPHHF
TGPTM	GPTMT
TGPTM	TGPTM
TGPTM	TGPT
SGMPHHF	MGPHHF
GMPHHF	MSGPHHF
FLYILENLKQLTNELLKLTQRQE	FLYILNELKQLTNLELKLQATQRQR
DMT	HGTNS
NEE	NERAA
KQEE	QEQEK
QTEKE	EQEK
KQTEE	QEQEK
DHIQ	NTDE
HTT	THT
NQFDAQ	KRW
NR	YDERG
DF	IWKQ
PYMD	IL
NE	EHNTN
REY	KRSD
EFFSV	VFSEF
NE	RNEGYH
NK	NEGY
NKEN	KN
DQR	NE
FWFEQRILKIEVLWIDE	FFEWKQRILKVILWIER
FWFQREIELIVLI	FFEWQRILKVILWIE
FWFQEKRILKIEVLWIE	FFEWQRILKVILWIE
REED	RED
VFWFQEKRIELIVLWI	VFFEWQREILKVILWI
FWFREQIKELIVLWID	FFEWKQREILKVILWI
VFWFREQILKIEVLWDI	VFFEWKQRILKVILWI
EAEKWPN	HKEDENH
EAEKWPN	HKEDEN
EKGDT	KDERE
EKGTD	KDERE
KLS	KLS
TENS	NRQA
DKYN	KYND
KPLA	KVF
GSNG	KNLAAGW
TVDQ	LDRL
FVNR	LGLG
TVNQ	LRL
VINPK	LNQL
INPVK	LNQL
KTCQK	NET
ETNL	KSKG
EFKWDG	WDGL
FKWDG	WDGL
MKQN	QEK
LDKNGG	LDKNGG
FKKLA	K
KQN	QEK
KVREIVD	KREVIVK
PR	DKPP
PR	DKPG
PRF	DPP
PPR	DKPP
RDEDR	NRQ
RRLENE	TNEELR
VAQELRMI	LIERRVMAQ
LQLVRLSMRINFALRENELVQLML	LALETLEIDNFQLRNLHVLRL
LALETLEMINFQLARNLHVLMRL	LQLVRLSMIRNFALNLEVLQML
LQLVRLSMERINFALNELVQLMEL	LALETLEIDNFLRNLHVLRML
HHFHE	HHEFH
RGKKL	KRLGK
GKKRL	KRLGK
GEKAK	AKKGE
PVGG	RTG
CSYC	FIKEY
KKEQ	QNKTPED
KDQ	AFKFV
AG	YSG
VKREAAE	YEE
RNPVDG	DGVPRN
LR	VQANQ
HTGT	ES
WAGHH	EWLAHGH
RAAAA	AAAAR
TGR	QEGT
GIS	DRK
TRG	QEGT
QEHE	EHQK
GN	EMD
GVM	VRRI
GVM	VRI
GMV	VRRI
GV	VRRI
GYA	VRIE
GAY	VRIE
WDE	YLEN
LLPYAV	LLEKN
NKELL	VYAPLL
LLAPYV	LLEKN
LLPYAQV	LLEKNAD
LLAPQYV	LLEKNAD
NQSPA	PRA
SIGN	FD
TLDP	EGNR
WRNVP	ELRS
VRYY	QDV
GRGR	NQQ
ERT	NLE
PDPRY	RER
PDPRY	REER
NLGYECY	LEGSEIRR
LHDLD	KSKR
RSED	DHN
ESDSQR	QRDNFRL
RGII	VEH
NKKV	KNKV
SSADDDR	DFYSYQ
SRFDEAR	DYRSYY
SRFEDAR	DYRSYY
SRFDEDR	DYRSYY
LAFDLARV	RTYY
SRFDER	DYRSYY
SGYDERY	SYRSFL
SGYDEARY	SYRSFL
IRDEG	RQLNYI
LAS	DAFN
LAKF	LV
QGRY	PPDR
QQGRY	PPTDR
YHK	GGTS
FWQALQ	RGLTLEQA
QLA	LEQ
KSSNK	NLDD
FLENDD	R
FLEND	R
VETND	R
FFNND	R
FNNTD	R
QRVD	ERGG
RT	DNDAN
NDNDA	TR
SGSKS	NDA
QQDR	DKKGY
KKLGY	QD
KLQAGE	EQAELK
KELQAE	EQAELK
KNEN	HQRRPQ
DYK	KYND
DKYESKEE	KGNQMEKRW
KDYESKEE	GNQMEKRW
KDYKESLEE	KNQMEKRW
LAV	LVL
LVL	LAV
KFK	ISDL
ETLLRKYTVLEVTLR	TEKLRYLTVELVTRL
IQRQNRE	YVS
IQRQNR	YVS
EPNVIVQNGT	NPVITNGQV
WEG	HYSNA
NSSR	NKRQ
TKT	VYPD
LKNKA	QA
QA	LKNKA
RALQVPQ	QPLQAVAR
RPTAL	TRDQVPL
RPTAL	RDQVPL
RAE	GRL
AIGFD	GSR
LLRAY	LYQASL
GNG	NGG
QRR	EPNYR
SFSN	EAQ
AQLKDAESQFK	FKSAQEKADQL
ADQLKAESQFK	FKSAQEKADQL
AAQLKDAQESFK	FKSAQEKADQL
AQLKDAQESFK	FKSAQEKAADQL
ADQLKAESQFVKL	FVKSLAQEKADQL
DQT	RHFK
EDEGKFY	DEFYG
KKY	EYGK
QQV	TESGV
QKQV	TESGV
QAV	LTNSGV
QAV	TNSGV
Q	TNSGV
QAV	LTHSGV
QDAV	LTHSGV
WESLLVK	LRRLNLKKY
HDS	HDS
WRTE	KK
PVFL	PFVL
KHIEQGEK	AYVTS
EAATQ	EAATQ
GKGE	EKGG
RYWR	EWNSNED
PKKL	CEK
NREF	FERN
TSEGGK	LISE
FTQRTK	WDDN
RQT	NDDN
RQT	NDDNQ
RQ	NDDSN
RQTL	WDNDDN
LQVIKED	YKEVILQK
LQVIKED	YKEVILQSK
HDHSIVP	EPVIHSD
TYG	TY
GRA	QK
SVNF	TSMM
LQRS	LSQT
EIR	RIE
SRA	ARAS
QKVVGD	PLQKVVG
EEY	RRRE
KAG	DAR
HTKTYVLLKTTFVFFQVFQNIDQGIQLQQGLLILILNDEL	TRYVQLLKNFVEFFVSFQNIQQILQEQQTLIALIRLL
YVRGTQLLFVNKEFFVVSFQNIQQILEEQQTLIALIRLL	GTYVTHLLFVTKTFKFQVMFQNIDQGILQQQGLILLINLDLE
HTKGTYVLLKTTFVFKFQVFSQNIQGIQLQQGLLILILNDEL	TRYVQLLKNFVEFFVSFQNIQQILEQQTLIALIRLL
VAPF	QL
EAS	PSA
QNQNS	SNQQN
HTDVTRLDK	LRTVHTDE
DTHEVTRL	DKLRTVHTDE
MRILYILTVDKLYRQ	MDIELEILVVRYYLIGLSKEGE
MRILRYILTVDKLYQ	MDIELEILVVRYYLIGLSKGE
KSDSVY	SKDSV
KSDSV	SKDSV
QKDS	QKDS
QKSDSV	QSKDS
KSDSVY	SKDS
QDS	SQKDS
KDS	SQSKDS
REPP	RSD
PED	NKSD
RL	PEDT
QIGQTNQIPLNT	YMNAGSVTL
TRKG	KGTRV
TRG	KGTRV
VVNQIKPE	EIKVVNQ
VVIKEP	EIKVVQ
VVQIKEP	PEIKVVNQ
TDS	DTK
ELKELIVQQLLTLSVVKNKELNELGIYL	NEEKLIQVLQTLLSVVKENLKENLGYILM
QNQVKSE	ERLQET
QTE	QTTE
LTQTT	QTTE
DALARTIA	NATIARA
DSV	ISKL
FKKK	IKRGPKGVE
RS	GSMD
FKKK	IKRGPKVE
KRLEYK	EHQGLW
RGGENP	PENGGLE
EFVPG	GPVEF
EFNVPG	GPVEF
ARQLQLQQ	LQQAQL
QQLAAAFATH	HTFAAAQLQ
LARQQLQQ	QLQQARQL
QQLRAAFATH	HTFAARAQLQ
EDAR	DEAR
QQLAAFAT	HTAFAAAQLQ
LARQQLQQ	QLFQQARQL
LARQQFQL	QLQQARQL
RK	DED
PIFGPA	NHV
DYEN	KGFN
VNNRL	RNVNL
RNNKET	NAKEQK
IDL	DIL
GENQSE	VENLESYQLMEV
DGYFRKG	DASGQE
TAGFEAL	LEAGFAT
VATM	VATIM
ADV	DVA
VATM	VATM
PERRGRER	REGRRE
AETNHA	QIGGK
AESENP	YLISGK
RRN	VLG
EK	VARLE
SGL	YS
VGM	FA
NDA	DNA
NPDA	PDNA
KVQ	SAG
KVQQ	SAG
SNSCE	IPWRH
IDCS	WVKQH
IKLLNLEEYLEQTLYMQLEELQDIIILEVL	YELRLSKLYRLQTILYRLQSRLKQIIRLVEL
ELRLSKLYRLQQTILYRLSRLQKQIIRLVL	ILKLNLYELLQETLYQLEELQQKDIIILVEL
ILKLNLEEYLEQTLQMYLEELQQDKIIILEVL	EILRLSKLYRLQTILQYRLQSLQKQIIRLVEL
ELMLEGRKISS	SKSIGRLMLEER
DREILKLNLYEELQETLMYQLEELQDKIIILEVL	YILRLSKLYRLQTILYRLSRLQKQIIRLVL
EILRLSKLYRLQQTILYRLSRLQKQIIRLV	ILKLNLYELLQETLYQLEELQKDIIILVEL
EIKLLNLYELEQTLMYQLEELQKDIIILEVL	YEILRLSLYRQTILYRLSRLKQIIRLV
WY	YPLPAF
TKV	TKT
KTT	KT
DTRTK	RTKT
NGR	EETY
DKW	QDLL
TTREW	RYLI
TKDE	VR
NKLVC	SGRL
HANR	RNHA
QERD	DRQE
YNSS	TDGS
EV	KTLA
HLNTDLYRFRLKD	HLTDLKYLDRRF
HLTDLYRNFRLDRK	HTDRLKYLDRRFN
LSK	SKL
LEQLSLST	SLTKSQLEL
LEQLSLST	SLTSQLEL
LTSK	TSKLL
VYVTG	YVGTV
RTD	PDD
KEFQI	EQIPG
VGAICLAQ	QACLIGVA
VGAICLAQ	QACLIGV
DDRQ	ATL
EAE	AK
RSNES	SESNR
YQL	YPLL
HYKQL	YPPLP
HYKQL	YPPLPL
HYKQL	YPLL
QN	MKLD
GETE	EEEDGIMHNKL
WGEE	EETEIMHNKL
MKGAN	FAYRN
VKGAN	FAYRA
KTVLQAKL	PLAKKQTVL
RFHI	PL
FYDNQQ	AGFR
LFDD	LFKD
KDRD	DEAWQ
QNT	QTN
NQIDNAQ	QNAQIND
NDQINAQ	QNAQIN
RYYLD	TFLR
YVHN	NYVH
KEHLID	HLIDY
HLYE	KEHLID
SATGK	QIVVV
QDD	DDAQ
IVQV	TKGSAY
VVIQDA	IVVVD
KSATYGT	QIVV
QDDA	DDAQ
ELAV	AVEL
KIEQ	ELVEVEH
ELVEVEH	KIEQ
EVLA	AVEL
ELVEVE	KIEQ
RNHEMREA	RERNHK
FQANQLSLF	LFSQLNFQA
FAALTFCL	FCLALTFA
FTTALFCV	FCVGALTFT
FLTLEGFTV	FVGELTFLQ
FQTLEGFVT	FTVGELTFLQ
FAALTFCL	FLALTFA
FLSESITLR	LRTISLSFE
GWSD	WER
TPAMLRT	QCVDD
YRRI	KRETASLF
YRRI	KRETAESLF
EEV	RRVL
PYR	NKLPLR
VGVA	VF
VGVP	LL
VDVA	SFK
EENNK	QAVFEK
QQ	EKEG
HFFLIQQ	DEMFSN
YSEFI	RARTKAQQ
YLIF	ARTKLQ
QVTIK	KITQV
KED	ETQT
KKDE	TETQT
KKED	TETQT
KKDAE	TQTQ
KKDAE	TQQ
HE	DRKD
IYNDKLE	EKYNID
TAK	IALEETQ
NP	ENEA
RNV	AGPIEPG
DVR	HQA
TKAG	IALEET
TKA	AL
KTKALD	VGGPGHK
GVQ	TIKA
TAK	IALE
IALEAAT	TKA
GGPQ	TKA
TKA	LAAE
DDTT	TERNH
RTN	DDT
QVV	GGYL
GREN	NWGRE
GREN	NGRE
LEHVLRL	HLVERLL
INLKALA	YLLGKIN
KR	IDEV
TIIGPT	GIITPK
TII	GII
KPTI	TPGI
IIGP	ITP
TII	GIIT
PTIIG	PGIIT
EKRGL	EKRGL
GAK	LSEQ
QKQMALQKL	ERPLFADLAILQNDT
HVSDG	TATLWRY
KHVSGDR	TATPLWRY
GNPVE	ND
HQMD	ELTADG
HQMED	ELTADG
HMF	ELG
HQMNED	ELTADG
HNVK	EVSPQGE
HNVK	EVSPQGEP
LVA	VAL
GVLPL	DAGAE
DAAE	GVLPL
YRFM	LSFEAMQ
YFIM	LFEAMQ
YRFMQ	LFEAMQ
YFM	LFEAM
YRFM	LFEAMQ
IT	FQNL
REASE	ATHGE
GQK	KGQ
PVG	EGR
LAAALM	PVFSLV
LAAALM	PVFLV
LAALFM	PVFSLV
SLTNS	SLTNS
LNKVDS	PDLGT
GTA	KRE
KRE	GTA
KRE	GTFA
HE	HEE
EHGAG	RERRV
LPS	NGN
NDL	SNSL
RAAAKD	DAKAR
RAAKD	DAKAAR
NE	DYNGR
KDVAT	ERALN
MGEVPD	QGK
TPED	GK
LTANLHELIKDIKLNEELAA	TLEALENLHIKDEILKENLAV
NSSWKAVRELAALNHELIDIKKLNEELAAVVMH	NSSWKVARALALENLHIKDEILKENLAVAHVMA
SKNWAVRELAANLHELIEKDIELRNELAVAV	ENPSQWKVAERALEALENLHEIKDILRENLVAHV
NPSWKAVRELAALNHELIDIKRELNLAVAV	QWKVAERALALENLHIKDEILRENLVAHV
KDSKE	DKDE
RPGYQK	EEVR
ANIA	LGVANY
APNIA	LGVANY
APNIA	LGVIANY
KRY	LDEI
KSQG	QEL
RVAVRGE	EGVNDL
EGVND	RVVRGAE
EGVNDL	RVVRGAE
SLKN	NKLS
SLKGN	NKLSG
TNVLG	NVLT
TNVL	NVLT
TNVLG	VLT
EQQF	QQEK
QVNK	NKQ
VSTN	NTVS
STN	NTVSG
LRDDI	IRLDD
HD	PPEG
KSWWRGK	TVGVDPAEF
WKSWRGK	TVGVDPEAEF
WKSWRGK	TVGVDPAEF
TATIE	RH
GGGE	HDK
EGDT	TGV
NDSS	NDSDK
ADGC	AAK
ADG	AAK
DG	DDSN
KNDTNHVT	TNHNKDT
VAKK	AKV
NSNNYE	ENYNSN
KRD	ED
DGE	EDG
EKGGP	VVQL
ITKT	WSEK
IHHT	IHHT
AHNMH	MHHNA
IAL	IAL
VYYN	VYYN
HYD	TKYIR
GLSG	SGSGPS
GLSG	SGSGPT
GLGS	SGSGPT
GLGSA	SGGGF
PDLN	KLKG
GLGSA	SGGF
GLGS	SGGGF
PDLNL	KLKG
GLSC	TGGC
GLGSI	PGAGY
GLGS	TGGCM
SGL	TGAGCM
GLS	TGGCM
SGL	TGAGC
GGL	TGGAC
GGL	TGGACV
GLAG	SGGSA
SR	RGGS
GLRA	SGAGPTL
GLRA	SGAGPT
GGAM	GPT
GMAG	SGSGPT
LDKN	NLDK
GQEG	NWS
ETLYLKLASEVKLMNVLSLELQIELQNREL	GPVEYLKALSEKVLMVNLSELLQEILQENL
SKR	KCHS
NAEILMNE	IVTEILNLKK
PGAYD	WDIK
WDIYK	PGYD
PGYD	WDIK
WDIK	PGYD
PGYD	WDYIK
GPYSL	WEI
EIW	PGAYSL
GPAYSL	WEI
PGAYD	WDYIK
TTK	HEWQ
HEWQ	TTK
HEWQ	TTKH
FPGG	GFPG
FPGGG	GFPG
YFLEEGKETKELVAAAYE	VAAAKYLEETEGKFLEY
PSFGPG	SGFPG
SPFGPG	PSNGFPG
SFGPG	SGFPG
SPFGPG	PSGFPG
KGPYPA	PKGYPA
KPYGPA	PKGYPA
KPYPGA	PKGYPA
RQP	KRQP
PKYGPA	KGYPA
KYGPA	PKGYPA
EFGPA	EGFPA
EPFGPA	EGGFPA
IGGWWY	TWWPIGGY
IGWWGY	TWWPIGGY
IGWWGY	WWIGGY
TEDVK	SSSFDR
NRL	VLGDVA
TEDVK	SSFDR
TDEVK	SSSFDR
VTD	TDV
TDKIE	SSSFDRR
TDKI	SSSFDR
TDEKI	SSSFR
ERNV	KH
KKDEM	DEKMK
SAYSR	KG
RTS	GKKS
DSHG	LK
DTEIK	SSSFDR
REDI	VKH
TDEIK	SSSFDR
TDEKI	SSSFDR
KQ	GKSDQE
REDV	VKH
AASS	YSDR
LH	DSHG
AMSS	AAY
HPF	GKVN
RENV	VKH
RGDI	VKQ
RDII	VKQ
DY	AQKA
DYS	AQKA
VCTD	TDV
KQ	GKSDQ
RTES	GKKSF
SFGK	TESR
RTES	GKSF
KSSGAQ	SGAKSQ
REDII	VKQ
SAAK	TEL
SRSD	DTEK
EDKT	SSDR
VDT	TDCV
VGVRDM	RVAD
SLFDHD	NDFQAR
LFDD	AFQAR
LDLDH	AQAR
SFKGTIL	TIFK
DE	SWIR
RANY	TSSEDAR
TR	HPR
AQLD	QRQ
RQE	DNQR
DR	GNRT
YFKQSLFLRN	FLRSLYFKQ
YFKQHSLFLRTA	FLRSLYFKQ
YYKEADRF	DRFAYYKE
YYGR	YGYR
SGKQ	QSGK
IEF	IEF
APAVTHGP	PTHGPAAV
NKGYHYR	PTH
RSEA	SERA
RESA	SERA
HGEA	EHA
LEIGVIGAVTIII	ELIFGVAGVITII
EIIE	LIGR
YLLAIGFTLP	PETLFAIGLLY
LY	EILI
LEIFGVIGAVTII	ELIGVIGVTII
LEIGVGVTII	PELIFGVAGVTII
LEIFGVAGVTIIII	ELIGVAGVITIII
PNWAR	NPWAR
RQDFQV	THVDGTSSF
WEE	WEE
RFS	AWVGYR
LRVV	RVLV
LRVTL	RVLTL
HV	RIPR
SVE	WR
RSD	SRD
IGLLFIFAV	IGLLIFFAV
IGLLFIFAVL	IGLLIFFAV
IGLLFIFAV	IGLLIFFAVL
IGLLFIFAVL	IGLLIFFAVL
HKY	KYH
YHK	KYH
NDKA	NKD
PTA	AD
PNAIGD	DNAIP
KN	ETAMG
VLPEQR	PLVREQ
RKH	AED
SANR	DGN
NDN	NFT
HYN	HNY
SFEDISL	DSFEISL
YDTGN	KSGS
LDT	NGKK
WSDTG	KR
WSDTG	KQR
WSDTG	YKR
WSDTGS	YKR
NGCPDYR	CPNRGDY
NGCPDR	CPNRGDY
PSN	ISP
NPT	ATT
DNDR	NDDR
DNDR	NDD
DND	NDD
DDNR	NDDR
DNRDS	NDDR
DND	NDDR
DNDRS	NDDR
NDDR	DDR
DNDR	NDDS
DNRD	NDDR
DDNR	NDDSR
DDNRS	NDDR
DNDR	NDDSR
AVQS	TAGKP
GRRRLR	RLRQR
LSL	LSL
LSL	VLSL
LPRTTATT	TATTTPR
NAL	ETA
LAN	ETA
LA	ETA
NLA	ETA
DDG	DP
QDG	DGQ
LREH	LKYG
QLKP	MA
TFAS	VDKK
HWIE	IRPY
KVEE	ED
YNSG	AQALQVR
KPAKY	DTEV
DSPKY	KSSG
DREAP	DRPE
KDHE	WSKN
VGL	GLV
QE	GRQE
NLYGYV	SLMENESMNVL
VER	RDH
AEVAK	QNGPQN
STLGT	GSTLT
QAEAE	QNGPQ
AEQAK	QNGPQN
AEVA	QNMGPQ
RKEII	DND
HST	TQNT
PDEH	QDPV
YGLHI	YHIGL
QGWPLLQ	QQLLGWP
QGWQPLL	QQLLGWP
LLPFE	LLPFE
LPFLE	LLPFE
KFKVSK	SKVFKK
KFKVK	SKVFKK
HFTEEE	ERVAD
EKH	EKH
QHA	DAT
EWD	WED
RP	KAGV
EWQ	WEQ
HSK	SHK
ESWQ	SWEQ
EWQ	SWEQ
ESWQ	WEQ
EEGFS	KQN
RPWEP	APEWP
RPWEPCA	YPEWPR
KLPEMVL	EMVLKLP
VFDN	PWG
NQL	NQL
PWG	VFDN
TGT	GTT
TKPGT	PGTT
TGT	PGT
TGT	TTK
TGSGFK	KGST
LPQ	LPQ
EAAA	REVE
APG	NDY
QIRGK	RIQ
GIQ	KNG
QGI	TKN
KEQFGN	R
RLD	TPCVT
CNTST	PG
PG	CNTST
QATIV	VITQA
ALDL	RKR
LDDA	RCK
DLDA	RCKR
LDDAL	RCKR
ALQ	RCKR
LDA	RCK
LDA	TRCK
LDAQ	RCKR
QHM	HACV
QLDE	ACKR
QLDE	ACKRR
QLEL	ACKRR
QELLD	ACKRR
LDA	RCKRR
QLALE	TRCKRR
QALLE	TRCKRR
QALLED	TRCKRR
LAD	TRCK
LAD	TRC
LDA	TRC
LAQL	TRCKRR
LA	TRCK
LAL	TRCKRR
QALDE	TRCKRR
QALLDE	TRCKRR
QALLD	TRCKRR
LAKD	AKRV
KAL	TGAK
HL	NVTH
ALL	RCKR
FNELTSIA	AEIGGDHY
YDHGIGAE	ATSIELFN
FNELTSA	AEIGGDHY
YGDHIGAE	ATSIELFN
FNELTSA	AEIGGDY
YGDHIGA	ATSELFN
FNELSTA	AIGGDY
YGDHIGAE	ATSELFN
FNELSTIA	AIGGDY
WFIVVLRF	YIIVGVRIA
YIIVGVIRA	WFIVLVRF
WFIVLVR	IIVGVRI
SSNNYRE	NNSHSEE
LTWGLAHQNRAQLGQLIQLQLAATA	WEIYTLILESQQQNELELWAW
ASNNWLWLDNEQQEESQILI	WDEIYTIHISQQEELLLDA
LVQILLIQQLVTLQIIEVL	LLGIQQLAIQLLTGLIRIVYL
ALLIGQQLAIQLLTGLIIRVYL	LIVQLLIQQLTVLIQILVELQL
LVQILLIQQLVTLQIIEVLQ	LLGIQQLAIQLLTGLIRIVYL
VEGNKGTILVKGNVTIIVEGNADITVKGDATTLVEGNQTNTVNGNLSWKVAGTVDWDVGGDWTEKMA	GDETKTVEGNGTILVKGNVTIIVEGNADITVKGDATTLVEGNQTNTVNGNLSWKVAGTVDWDVGGDW
EGNVKGTILVKGNVTIIVEGNADITVKGDATTLVEGNQTNTVNGNLSWKVAGTVDWDVGGDWTEKMA	GDETKTVEGNGTILVKGNVTIIVEGNADITVKGDATTLVEGNQTNTVNGNLSWKVAGTVDWDVGGDW
EGNVGKTILVKGNVTIIVEGNADITVKGDATTLVEGNQTNTVNGNLSWKVAGTVDWDVGGDWTEKMA	GDETKTVEGNGTILVKGNVTIIVEGNADITVKGDATTLVEGNQTNTVNGNLSWKVAGTVDWDVGGDW
GNL	VN
VKGDATTLVEGNQTNTVNGNLSWKVAGTVDWDVGGDWTEKMA	GNADITVKGDATTLVEGNQTNTVNGNLSWKVAGTVDWDVGGDW
VKGDATTLVEGNQTNTVNGNLSKWVAGTVDWDVGGDWTEKMA	GNADITVKGDATTLVEGNQTNTVNGNLSWKVAGTVDWDVGGDW
EGNKVGTILVKGNVTIIVEGNADITVKGDATTLVEGNQTNTVNGNLSWKVAGTVDWDVGGDWTEKMA	GDETKTVEGNGTILVKGNVTIIVEGNADITVKGDATTLVEGNQTNTVNGNLSWKVAGTVDWDVGGDW
EGNVGTILVKGNVTIIVEGNADITVKGDATTLVEGNQTNTVNGNLSWKVAGTVDWDVGGDWTEKMA	GDETKTVEGNGTILVKGNVTIIVEGNADITVKGDATTLVEGNQTNTVNGNLSWKVAGTVDWDVGGDW
EGNGTILVKGNVTIIVEGNADITVKGDATTLVEGNQTNTVNGNLSWKVAGTVDWDVGGDWTEKMA	GDETKTVEGNGTILVKGVNTIIVEGNADITVKGDATTLVEGNQTNTVNGNLSWKVAGTVDWDVGGDW
GNEGTILVKGNVTIIVEGNADITVKGDATTLVEGNQTNTVNGNLSWKVAGTVDWDVGGDWTEKMA	GDETKTVEGNGTILVKGNVTIIVEGNADITVKGDATTLVEGNQTNTVNGNLSWKVAGTVDWDVGGDW
NGGTILVKGNVTIIVEGNADITVKGDATTLVEGNQTNTVNGNLSWKVAGTVDWDVGGDWTEKMA	GDETKTVEGNGTILVKGNVTIIVEGNADITVKGDATTLVEGNQTNTVNGNLSWKVAGTVDWDVGGD
EGNKVGTILKVGNVTIIVEGNADITVKGDATTLVEGNQTNTVNGNLSWKVAGTVDWDVGGDWTEKMA	GDETKTVEGNGTILVKGNVTIIVEGNADITVKGDATTLVEGNQTNTVNGNLSWKVAGTVDWDVGGDW
SNRFSTKIVIIA	SGETWNLLKIQ
QLLFEKLLQLKIETLKSREE	GKLINMVDEIVEQILKKQLEAAP
KGDTKR	ERDDAV
KDTNR	DRDDAHV
DRDDVAH	KDTRN
DRDDVAH	KDTNR
DDMDY	NHIL
NIHL	DDDMY
MDY	HNL
NIHL	DMY
DDMDY	NHL
NIHL	DDMY
NIHNL	DDMDY
DMDY	NHNL
MDY	HNINL
NIHNL	DDMY
NIHNL	DMY
DMDY	NHINL
NHL	DDDMY
NHL	DDMY
NIHNL	DDDMY
NWGL	TLK
DEDK	KGFE
EGFK	KDE
DEDK	KGE
NNYQTN	RAGSKKT
RTGSDK	SKDNVVR
NNYQTN	RAGSTKK
RGSDK	SKDNVVR
RGHSDK	SKDNVVR
NNYQTN	RAGSKT
KEG	EGK
DRDDVAL	KGDTRN
KGDTNR	DRDDAV
KKGDTNR	DREDDAVL
DRDDVAE	KGDTRNK
DRDDVALE	KGDTRNK
TDL	WGL
TDQE	LEK
DTELKL	NWGF
WFAH	VFIGP
WVGPNFIH	WAEHLF
DRDDVALK	KDTKN
DTLKL	NWGF
NWGF	TLKL
NWGF	DTLKL
DKL	SDL
SLD	DKL
NFGL	DTLK
DTLK	NFGL
TDLI	EDWGF
DRDDVAL	KDTRN
DDDVAL	KGDTRN
KGDTNR	DRDDAVL
DRDDVA	KGDTRN
KGDTNR	DRDADV
KGDTNR	DRDADVL
DRDDVA	KDTRN
KDTNR	DRDADV
KDTNR	DRDDAV
KGDTNR	DRDDALV
KDTNR	DRDADVL
KGDTNR	DDDAVL
DRDDVAE	KDTRN
DDDVA	KGDTRN
KDTNR	DDDAV
KDTNR	DDADVL
DDDVA	KDTRN
DEKL	KIGL
IGLK	EKLD
GLK	EKLD
IGLK	ELKD
SIGLK	EKLD
SED	RRTV
TRVR	DSE
TRVR	DDSE
DTELL	NWGF
KDTNR	DRDDAVL
DRDDVALH	KDTRN
DRDDVAH	KGDTNR
DRDDVALH	KGDTRN
DRDDVAL	KDTNR
DRDDVAL	KGDTNR
KGDTNR	DRDDAHVL
KDTNR	DRDDAHVL
KDTNR	DRDAHDV
KGDTNR	DRDDAHV
KDTNR	DRDAHDVL
DRDDVALH	KDTNR
DSED	RRTV
TELKL	NWGF
NWGF	TELKL
NWGF	DTELKL
TELKL	WGNF
TELKL	WGF
KGDTNK	DRDDAVL
DRDDVAL	KGDTNK
KGDTNK	DRDDAKVL
DRDDVAL	KGDTKN
TQSD	HIK
HKI	TQSD
HKI	LTQSD
LTQSD	HIK
DRDDVA	KGDTNR
DRDDVAH	KGDTRN
LM	MEALA
HQHLDL	TLNFSQP
PVSA	HQ
SPSAE	QNR
HKE	HEHEED
LDT	RD
EKR	RADGD
YYK	YYFK
QGVNHA	NHVAGQ
AAPVT	TNR
AAPT	TNR
PACD	ACDP
EKFT	FEKT
NGKK	NED
KEDPKR	EKEA
QLV	LQV
RDG	NTGNSSGD
RQEN	ATPN
CRT	KGYN
CRT	KNGY
WNCPSGMLIVFRIKLL	CADGTILYQVDLEYLL
WPFCWNTKCPSRL	DADGCLVHALLTPKCPD
GCLQLEIRILRV	PICTFLYVNSDLLIL
WNCPSGMLIVFRIL	CADTTILYQVDLEL
WNCPSGMLIVFRIKLSL	CADGTILYQVDLEYLL
GCLQLEIRILRV	PTITFLYVNSDLLIL
KHILNVQDLIKICGS	IDIQLYINNKILVELCPCQE
LLNVQDMLIKIGS	QLYNNKILVLEPCCQE
KHILNVQDMLIKICGSC	IIQLYNNKILVLECPCQEQ
LNVQDMLIKICGSC	LQYINNKILVELCPCQEQ
ELRYEVELR	RVELEYRLE
LKILNVQDLIKICGS	EDILQYNNKILVELCPCQE
LKHLNVQDMLIKICGSC	ADIQLYINNILVELCPCQE
HLNVQDMLIKICGS	IQLYNNKILVELCPCQE
KHILNVQDLIKICGSC	DIQLYNNKILVLECPCQEQ
KHILNVQDLIKICGSC	IDIQLYINNKILVLECPCQEQ
HILNVQDMLIKICGS	QILYNNKILVLECPCQQE
KHILNVQDLIKICGSC	IDIQLYINNKILVLCPCQEQ
ILNVQDMLIICGS	ILQYNNKILVLCPCQE
KHILNVQDLIKICGS	IHDIQLYINNKILVLCPCQE
ILNVQDMLIKICGS	ILQYINNKILVLCPCQE
WNCPSGMLIVFR	TCADGILQVDLQE
GCLQLLQERIVLNV	CPITFYVLL
QLLE	ILDFYR
WNCPSGMLIVFRIL	CADGTILQVDLEL
GLQLLERIRLNV	PTIFYVL
KHILNVQDLIKICGS	IDIQLYNNKILVELCPCQE
LNVQDLIKICGS	LQYNNKILVELCPCQE
KHILNVQDMLIKICGS	DIQYNNKILVELCPCQE
HILNVQDLIKIGS	DIQLYINNKILVLEPCCQE
EKHILNVQDLIKICGS	RTDIQLYNNKILVELCPCQE
NVQDMLIKICGS	YNNKILVLECPCQE
VILNVAQDMLIKSCGSC	LILQYNNNKILVLEQCEPC
LKHILNVQDMLIKICGSC	AHDILQYNNNKILVELCPCQEQ
ILKILNVAQDMLIKISCGSC	EEADIYNINKILVLECQEPC
RLKHILNVQDMLIKICGSC	KALDILYINNKILVLECPCQEQ
VHILNVAQDMLIKISGSC	LILQYNNKILVLEQCEPCQ
LKHILNVQDLIKIGSC	EAHDIQLYINNNKILVEQLPCCEQ
RLKHILNVQDLIKIGSC	KEADIQLYINNNKILVELPCCQEQ
KHILNQDLIKICGSC	IIQLYINNKILVLECPCQE
ILLNVQDMLIKICGS	QYLNNKILVLECPCQE
KHILNVQDLIKICGSC	IDIQLYINNKILVLECPCQE
ILNVAQDMLIKICGSC	LQYINNKILVLECPCQEQ
KHILNVQDLIKICGS	DIQLYINNKILVELCPCQE
NVQDMLIKIGS	YNNKILVELPCCQE
LKHILNVQDLIKIGS	IYDILQYNNKILVLEPCCQE
LKVKILNVQDMLIKIGS	YEIDILQYINNKILVLEPCCQE
VKHILNVQDLIKIGS	IDILQYNNNKLVELPCCQE
LVKHILNVQDMLIKICGS	IYIDILQYNNIKLVELCPCQE
LNVQDLIKICGS	YYINNKILVLECPCQE
KHILNVQDLIKICGS	HDIQLYINNKILVELCPCQE
LQNVRQDMLIKICGSC	YNNKILVELCPCQE
KHILNVQDLIKICGSC	IQLYINNKILVLECPCQEQ
HILNVQDLIKICGS	IQLYINNKILVELCPCQE
QNVQDLIKICGS	YYNNKILVLECPCQE
RFGSYCPTGF	FTGIDPYCFSR
ILNVQDMLIKICGS	IQYNNKILVELCEPCQ
HILNVQDLIKISCGS	QILYNNKILVLEQCPCE
ILNVQDLIKIGS	ILQYNNKILVELPCCQE
DRLKVKHILNVQDLIKICGSC	LMYEIDIQYINNKLVLECPCQE
INVQDMLIKICGS	IYNNKILVLECPCQE
DLRRILKVKHILNQDLIKIGS	LMKEIEYIDILYNKILVELPCCQE
VLKVKHLNVQDLIKIGS	ALEDQILYNNKILVLEPCCQE
VLKVKHILNVQDMLIKIGS	ALEDIQLYINNIKLVLEPCCQE
LVKHILNVQDLIKICGS	EIDIQLYINNKILVELCPCQE
KHILNVQLIKGS	DIQLYNNILVLEPCCQE
LNVQDMLIKICGSC	YNNKILVLECPCQEQ
KHILNVQDLIKICGS	DIQLYNNILKVLECPCQE
LNVRQDMLIKIGS	YNNKILVELPCCQE
HAD	YIR
YQRESEWAGY	QYREEWAGYS
RGYVDPV	RGDPVAYV
RGYVDPR	PGYVDRE
RGYVP	PGYVR
ERGYVPAR	RPGYVDRE
ERGYVPR	RPGYVDRE
WSQSEK	SSWQEVK
KTNNSS	YLIHQ
PFCH	DAWQ
RGNAPA	GPNAR
RGNAP	PVANGA
ETLD	TLDE
RR	SQAL
LCIRAAEKQAL	LKICPARAEKQLAL
LKCIRAAEKQAL	LKICRAAEKQAL
LCIRAAEKQAL	LKICPARAEKQAL
ERLAILRLRELFRVRLEVLQILKH	RELDILRKLEQTLFDVNALRVLKEILLH
LDILKLEQATLFVALKVLEILLH	LAIRLLERLFRVRLEVQLIKLH
LILRLRELFRVRLEVELQILKH	LILNDLEQATLFVNAALKVLEILLH
IIIILRVLELQLLKLESLERYLIQILQLIRETQNEYLLKLEIYL	HSVSEILILIEVILISREAGELAALLELAAKQLLYDLMLDIEYRL
EMLRQVLTDKVEERLADILRKLEMQREAETLFDVNAARLEKVLIL	RLVQLTKDVERELAIRDLLKMREAQLTFRVRALEVQKLIL
RVDTNARVNED	RSEEKDLLNDR
MLRQVLTDKVEERLADILRKLEMQRAETLFRDVNAARLEKVLEILK	MLRVQLTKDVERELAIRDLLKMREQALTFRVRADNLEVKLILE
EMLRQVLTDKVERLADILRKLEMRAETLFRDVNASARLEKVLQEIL	MLRVQLTKDVEERLAIRDLLKMREAQLTFRVRALEVKLQIL
MLRQVLTDKVEERLADILRKLEMLQREAETLFDVNAARLEKVLQEILK	LMRVQLTKQDVERELAIRDLLKMREALTFRVRALEVKLQIKEL
LAYQELLRRLLTSLEERLADLVRKLETRAENLYREAATRLEKILEILRHVL	ALYQLRELLRLTSLERELALRDVLKTRELAELNYRAEATERLEIKLIRLEHLV
HMLAYQELLRRLLTSLEERLADLVRKLETLRAENLYREADATRLEKILEEILRIHEVL	MLAYQLRELLRLTSLERELALRDVLKTRELAELNYRAEATRLEIELIRLEHLV
AYQELLRRLLTNSLEERLADLVRKLETNRAENLYREAATRLEKILEILRIHEVL	LYAQLRELLRLTSELRELALRDVLKTREALNYRAEATERLIKLIRLEHV
LAYQELLRRLLTNSLEERLADLVRKLETRAENLYREAATRLEKILEILRIHEVL	MLYAQLRELLRLTSELNRELALRDVLKTREALNYAEATERLEIKLIRLEHV
LLKRQLQDLH	LQDLRKLLE
LFLIKVFLEQNLLELL	LFLIVELNQLLLEL
YLNNALAKESYRVLTVL	YLNNLAAKSYRVLTVLK
ESACRILELLEKNSMLKEEMIRQMQLDYLLKLEIYRLL	SACEIERLLLKSELMEKMRIMQQLYDLLLKDIREYLL
YEELRVLTDKRVEERLADILRKLEQRAETLFRDVNAARLEKVLQEILKLHEILQI	DLYEERLVEELTKDEVRELAIDLRLKREEQALTFRVRANLEVKLIKLEHIELI
RDTNARVND	SEERKLDLNRD
HLGYEELRVLTKVEERLADILRKLEQRAETLFRDVAARLEVLQIKHEE	HLGYRLVEQLTDKVERELAIDLRLKLREQALTFRVARNLEVLQIELKHI
CDAGTSLRQENENYR	LYTEALNMVDRREE
LEMMEFAYQTILQEIMKEMHEYLLKLEIYRLL	NLEMQMEFYAQITLQRIKMEMEHLYELLLKIRYLL
SERR	REHDL
ERMREEFAVAANQD	YLKMADIKAT
VDALTN	NMER
TLQEMF	MLYQLM
LMMEFAYQTILEIMKEMHEYLLLEIYRL	NLEQMMEFAYQITLIKMMEHLYELLLDIRYLEL
YEMLRQVLTDKVEERLADILRL	YEEMRLVLTQKDVERELAIRDLLK
ESACRILELLEKNSMLKEEMIRQMQLDYLLKLEIYRLL	SACEIERLLLKSELMEKMREIMQQLYDLLLKDIREYLL
GYEELRQVLTDKRVEERLADILRKLEEQRAETLFRDVNAARLEKVLQEILKLHEILI	LRGYRLVEQLTKDEVRELAIDLRLKREQALTFRVRANLEVKLIKEHLEILQ
SDCI	SDIC
WIVTLLLIQIITLVRVIQLEIPV	IQVKLLAIIQILVTVEILTRL
IQVKLALIIIQLVTVIELIT	DIVTLDLLIIIQTLVRVILIQ
LLIQIITLVRVILIVL	LLIIQILVTVEILILV
WIVTLLLIQIITLVRVIQLIV	IQVLKLAINIQILVTVEILHTIL
IQVKLLIIIQLVTVIELILR	DITVDLLLIIIQTLVRVILIVLE
LLLIQIITLVRVILI	LLIIQILVTVEILTL
FVVLLAVQTSLEITLELVMLM	MSFVTLLVVQLIRLLGVMILM
MSFVTLLVVQLRIL	FVLVLAVQTLEITELL
RSLNGLPVDMTISLVEMKYLLH	HLLKYMVELTSMIPVDNGLLRS
FVVLLAVQTSLEITLELYAKSNCAVYDLEH	MSFVTLLVVQLRILEGLVPMTLVCMYKL
SNGVDMTISLVEMKYLH	HLKMYVELTSMIDGVSN
ETNKD	QASTQ
ELKVYMAILNMVY	HHLYLVCANAISYD
FVVLLAVQTSLEITLEL	MSFVTLLVVQSLRIL
MSFVTLLVVQSLRILEGLPVMTLVCMKYLL	FVVLLAVQQTSLEITELLYAKSNCAVDLEYH
QSQ	ETKD
TQQISS	LEAKR
FVVLLAVQQTSLEITLELVMILM	MSFVTLLVVQLIRLLGVMILM
FVVLLAVQTSLEITLELVMILM	SFVTLLVVQLIRLLGVMILM
SFVTLLVVQLRIL	FVVLLAVQTSLEITELL
YDAKISNCAVYLLHH	YMLNIMAVLYEK
FVVLLAVQTSLEITLELYAKSNCAVYDLEH	SFVTLLVVQLRILEGLVPMTLVCMYKLL
SNGVDMTISLVEMKYLH	HLKMYVELTSIDMGVSN
ELVYMAILNMYL	HLHYLVCANAISYDK
VVLLAVQTSLEITLEL	VTLLVVQLRIL
MSFVTLLVVQLRILEGLPVMTLVCMKYL	FVVLLAVVQQTSLEITELLYAKSNCAVDLEYH
FVVLLAVQTSLEITLELVMLM	SFVTLLVVQLIRLLGVMILM
FVVLLAVQTSLEITLELVMLM	MFVTLLVVQLRILLGVMILM
SFVTLLVVQLRIL	FVVLLAVVQTSLEITEL
RSLNGLPVDMTISLRVEMKYLLH	HLLKYMVELSTIPVDMNGLLRS
FVVLLAVQTSLEITLELYAISNAVYDLEH	MSFVTLLVVQSLRILEGLVMILVCMYKL
SNGVDMTISLVEMKYLH	HLKYVEMLTSMIDGVSN
TNKD	QASTQ
ELVYMAILNMVY	HLHYLVCANAISYD
FVVLLAVQTSLEITLEL	MSFVTLLVVQLRIL
MSFVTLLVVQSLRILEGLVMTVMKYL	FVVLLAVQTSLEITELLYAINVLDEH
QASTQ	ETNKPD
TQQIS	LEAKR
FVVLLAVQTSLEITLELVMILM	MSFVTLLVVQLIRLLGVMILM
FVLLAVQTSLEITLELVMLM	MSFVTLLVVQSLRILLGVMILM
SFVTLLVVQLRIL	FVLLAVVQTLEITELL
YDAISNVYLLHH	YMLNMAVLYEK
RSLNGLPVDMTISLVEMKYLLH	HLLKYVEMLTSMIPVDNGLLRS
LVYMAILCMVYLHH	LYMVLCNIVYDMAL
SNGVDMTISLVEMKYLH	HLKYVEMRLTSMIDVSNG
FVTLLVVQSLRILEGLVMTVMKYL	FVVLALVQTSLEITELLYAINVYDLEH
FVVLLAVQTSLEITLELVMILM	MFVTLLVVQLRILLGVMILM
VELLVATQNILELSLELIQMGILNCVYDE	VTLLQAAILRLLLITSMVILSMKYDL
LQLLLIMILMVYLE	LQLLLIMILMVYDLE
KVTLMLATRQAILRLTLSLIMVISLSEMKYL	ELVLTVLTNSQILELSELLQIMGISNLCAVYDM
VELTLVTQNILELSLELIQMGISLNCAMVKYD	VKTLLMATQRAILRLLTLISSMVILSSMYEKL
VLLVTQNILELSLELIQMGILNVD	VTLLMAQAILRLLLISMVILMK
ELTLVTQNILELSLELIQMISLNSCAMVKYD	TLLMATQNRAILRLLTSLIMVILSSMYEKLLH
VTLMLAQAILRLLSLIMVILM	LVLTSQNILELSELLQIGMILNVYD
LLVTQNILELSLELIQMGISLNVYD	VTLLMATQAILRLLLITSMILVSMK
ELTLVTQNILELSLESLIQGISLNCAMVKYD	TLLMAQAILRLLTSLIMVILSSMYEKL
VLLVTQNILELSLELIQMGISLNVD	VTLLMATQAILRLLLISMVILMKY
LQLLLIMILMVAYD	LQLLLIMLMVYDLE
KVTLMLATRQNAILRLTLSLIMVISLSEMKYL	EDTLVLVLTNQILELSELLKQIISNLAVDEYL
VELTLVTSQNILELSLELIQMGISLNCAMVYDLE	VTLLMTRQAAILRLLTSLIMVILSSMEKYLH
VLLVTQNILELSLELIQGISLNVYDE	VLLMQRAILRLLLISMVILMYK
RK	RPVKL
NQRQ	QEE
GATS	STAG
KNGS	SK
YPETI	APVVVQN
TKSP	NQVG
AYRG	RAYGP
AYRG	RAYG
AIPG	EV
TDG	SSE
TDG	SS
LNPQLL	AMSTIQAA
VIDAIIDQRLVQFDTILKI	RSLLTQLSEQAAIQAGTNLA
LIDALVVRLIQFDIL	RSVLVNQLITAEQAGISN
LIDALVVRLIQFDIL	RSVLVNQLITAEQAGISNA
TKILAGAMQ	LVFGLQLQW
QQK	GDQ
KQML	QKML
QMKLKGTSNR	NRTSKGTLQMK
KMLK	QML
QMKLKGTSN	NTGSKLQMK
QMKLKGTTSNR	NRTSKTLQMK
PGSV	VGSP
PAK	KTPV
QH	IAPE
QHPIEEF	IAPEFE
AGVTGQKH	IARGVK
TGQKHIE	AQGRGVKRV
QKHIE	GRVKRV
DGVK	DGVK
PPHTR	KLE
AETLT	WGLFG
KIAETLT	WLFG
KIPAETLTE	WLFG
KIAETTE	WCGLF
TDSV	LF
RTDSV	WGLF
KNPADV	WCFG
KEAETTVR	WLFGK
LEKE	HFG
TQH	QTHG
TQH	QHG
RGDTWE	GNSPR
EEAEQTGVSHN	SVHNGQTEEAE
KQDDSFS	R
TGN	KNG
QS	QTMP
APNMK	EEE
RNTLH	NYDFD
LDASL	LDASL
WYYACD	YWACY
PLRFLE	FERPLL
YEPLRFLE	KFERPLL
SEDDID	RRKAL
EDDID	RRKL
ESEKDLD	KDQ
KFN	NTLP
KFNL	NTLP
GHTPAR	ANP
RKKDPAN	DEQA
LATKI	KTALI
EIQ	PFN
DHRV	HNLDQRV
NLDHRQV	HDRV
EMPPSK	APERD
ERQAV	QQQVGI
QVGQI	ERQAV
LIALAQQNMDIANL	VNAYSVQQEMELNVA
KLELI	TLKAL
SPEV	DFQY
SPEV	DFSQY
PEV	DSFQY
PEVK	DFQY
ENELK	EDIS
LVSIE	NLEE
VDVERQ	VEVDQR
NISSCSQDR	LSSCSQRD
RFVQ	VQRF
MFLLLHAWIGN	LFSFSHFWQR
SSHFW	LLHLAW
LLLHAGN	SFSHFWQH
FLSLLHAWIG	FSFSHFWHQ
KIEVLYEMVLNVLHIAIIGL	GPTEIHSKETMVEDNVHEDISI
SSDLVAAILHLWD	SSDVIIVSLGHWIR
SSVVSIGIHLWR	SSDVLAIHLLWD
SSDLVAAILHLWD	SSVIIVSLGHWIR
PVAI	LWI
SSDLVAILHLWD	SSVIIVSGLHWIR
SSDLVAAIHLWD	SSVIIVSLGHWIR
SSDLVVAAILHLWD	SSVIIVSLGHWIR
SSDLVAIHLWD	SSVIIVSGLHWIR
LVAAILHLWD	VIVSIGLHWIR
SVVSIGIHLWIR	DVLAIHALLWD
WIL	IPVA
LVAILHLWD	VSIIVGLHWIR
LVAAILHLWD	VSIIVGLHWIR
LLD	LPA
DLVAAILHLWD	DVSIIVGLHWIR
VVSIGIHLWIR	VLAIHLLWD
DLVAAILHLWD	SVSIIVGLHWR
LVAAILHLWD	VSIIVGLHWR
LVAILHLWD	VSIIVGLHWR
SDLVAAILHLWD	SVSIIVGLHWR
VVSIGIHLWR	VLAIHLLWD
SDLVAAILHLWD	SSVSIIVGLHWIR
VVSIGIHLWIR	VLAIHALLWD
DLVAAILHLWD	SVSIIVGLHWIR
SSDLVAAI	SSVIIVSGL
SSVVSIIL	SSDVLAAI
SSDLVVAAI	SSVIIVSGL
IHLIWIR	AASGHIWLD
AASIGHLWD	ILIIHWR
IHLIWIR	ASGHIWLD
ASIGHAD	ILIIHWR
IHLIWIR	ASGHIAD
SVVSGIHLWR	DVLAIHLWD
DLVAIHLWD	SVSIVGLHWR
LAILHLWDIFGLK	AVSAGILHWRLIYF
DAVSGIHLWRLKIY	DLIHLWDIFHG
LAILHWDSFGK	AVSAGILHWRLIY
LILHWDSIFFGL	AVSGILWRLIKY
LVAILHAW	VVSGIFW
LVAILHAWLN	VVSGIHFWQN
LVIHAWIGL	VVGIWQ
LVAILHAWIGLNK	VVASGHFWQGR
VVSIHFWHNQR	LVAIHLAWINLQIKR
LVAILHAWIGLN	VVSIHFWQN
LVAILHAWILN	VVSGHFWHQ
LVAIHLWDK	VNVILHWIRK
VVNIHLWIRK	VLAIHLWDK
LVAIHLWDK	NVILHWIRK
PLVAIHLWLD	NVILHWR
VVNIHLWR	VLPAIHLWDL
PLVAIHLWD	NVVILHWR
PLVAIHLWLD	NVVILHWR
LIHLWD	VSGILHWIR
VSGIHLWIR	LIHLWD
LIHLWD	VGILHWIR
LVVANIHLWDYF	VVNIHLWRF
NIILWIR	VNAGHWD
VANGHWD	NIILWIR
LVAILHLWDFFFFHGL	VVSGILHWIRFIFY
SSDLVA	SSVSIIV
SSVVSII	SSDVLAA
PVAI	LRI
SSDLVAAGLHLD	SSVIIVSLIWR
SSDLVAA	SSVIIVS
SSVVSII	SSDVLA
SSDLVAAI	SSDVIVSIAL
SSDVVSIAIL	SSDVLAIA
SSDLVAAI	SSDVIIVSAL
SSDLVAAI	SSVIVSIAL
LVAAILHLWD	VSIIVALHWIR
VVSIAIHLWIR	VLAIHALLWD
LVAAIALHLWD	VSIIVALHWIR
NL	MDSM
MDSM	NL
RQK	DNT
MDSN	KRD
NGL	LQTV
NL	MDS
ADNGDAL	ALRDP
QTE	KNLE
LEANK	LANKE
LEAN	LANKE
LEANKE	LANKEHI
CNTGV	QFRAS
EEARKTFQ	RIEHYLYANKE
EEARTFR	RQFTTE
NED	KRT
NRTK	EK
RNS	RNSK
KRNS	NRS
DNQS	NQDS
KDLSE	ELSDK
DRRD	RDDR
SVLPKS	PKSSVL
SVLPKS	KSPVLS
QD	VKAGGAP
SEVAL	ESVAL
SQS	SQ
RYANPKQ	PQKNRYA
SQSFNN	QSSFNN
EFSR	DNK
GEAE	EAEG
ARHSLVY	RHASLVY
QTG	QDEQ
ALTQT	AQT
ESMI	KHS
ESMID	KHQS
WMM	NQRTS
QW	DNRN
EPKDSM	RTY
ESMI	KHQS
TLERT	ITKN
EQWMMV	RRNQTS
WM	NQRTS
KFD	DLSA
KF	DLSA
YV	LYV
VLVVHK	HKVVVL
MKMS	SMKM
NVSE	EVLVN
KVE	TNVK
ENS	NES
ENS	NEGS
PN	NGK
PY	NGQ
GSN	SA
KPY	RDNGP
YTEKDC	NEKDCL
VTS	TSV
TPPH	HPTP
YTA	YTA
SVTK	TKS
NVV	VVN
SNV	TAAGY
SNVN	TAAGY
KPN	SNGK
KG	NGM
APSQE	TLK
KLTHAVKL	LNLLMML
YVTVKVISSQPP	DDLSQLSLQL
YVTVKVISSQPAP	DDLSQMLSLQL
KLTHAVL	LNLLMML
ESNED	HK
ELDENM	TKKGH
GKKCRRC	CAPV
TNEH	IEET
SSG	GLV
AERLLIQ	LIREALQ
ESF	HFDNV
SF	FDNV
ENSF	HFDNV
LDETTERE	DLGTLKT
LDETTYERE	GDLGKGTV
SEAHDVE	EAHPDPD
ESEAPDVELH	FGTAPIV
EPIPDVELSH	FGTAPLEYVI
PKSGPK	LGRD
EDDE	KTK
YDGVELAATKKKL	KTKTNCLE
YDGVSELAAETKAKKL	KTDKTCLPPE
YDGVELAATKKKL	KTKTNCLPE
DGVELAATKKTKL	TKKTDCLE
SPLS	KV
LEKAHEDH	KVLPP
AEDDHD	LPPVK
ADH	PPVL
LEKAEH	KVPP
AHDDH	PVKLP
AHEH	VKP
KAHEDH	VPP
EDH	PVLP
AHE	PV
AHEDD	PVL
LEKADHD	VPSLP
AHEDHD	VKPLPS
KADH	LPPV
LEKADH	VPPKS
EHD	VKLP
AHED	PPV
KAEDDH	VKPP
EDDHD	VPPL
LEKADDH	VKPLP
EEDDHD	VPLP
EEEAH	VPKPL
DEESE	VKLP
DEEEAHP	VKPPSL
DDLDEEE	KVPLL
DDHDEESEAH	KVLLPPS
DEEEAP	KVPPL
DEEEA	VPKPL
DEESEAHP	PVKLPSHL
LDEELSEAH	KPVPL
DEEEA	VKPLP
DDLDSEESEI	KVPLP
DEEE	HLP
EEEAHP	VKPLP
LDSEEEA	VPKKLPS
DDEEEAHPI	KPVLHPSL
EEEA	VPPL
DDEEE	KPVKL
DEESEAH	VKPPLS
DEEEAH	KVPLP
DLDSEEE	KVPPLS
DEEE	VKPL
DEESEA	PVLHSP
DEELEA	KVPPL
AMMRQ	SGKM
KSQ	TIVR
KEPET	PEK
KEPE	EKKPE
DSQMTT	SDTMTQ
QVDSD	K
SDSEK	DSQ
EKR	KRE
EVEAR	ARREVL
QWN	LWNV
EVARLR	VREA
GPEE	EPGGP
PIE	RPSS
SAQR	NRYAE
YNAEE	ARSQR
YNARE	RRSQ
KKE	EQT
SRKG	ELD
TLSLVQADASQDVMIFGSVI	KYVYGFLKRWAVLVV
LYQADASQDVNMIFGS	YGFLKRRAWKGVIVLV
LQADAQDVNMIFGSV	YGRAWKVGVLV
DDSLG	MQL
SPN	EGKV
PN	MEGKV
PELQD	LNSKAEK
MAK	LTGAD
MLG	LTGN
ATVYAEAK	IS
MAK	LTGAE
MAK	LTGAPD
TNYAA	IMPSCG
KR	TSSV
QSNG	NGSQ
RISL	LRSHV
RISL	LHS
NQESR	NSARQ
NQS	SAQ
IYSI	AVTKV
VVKR	VTE
VTVK	IIYS
TDTK	ITIK
ILKITNVLQATLL	NLITAVLTTVLL
LSITAVLTTVLL	ILKINTVQLATL
ILKITNVLQATLL	ILITAVLTTVLL
ILKITNVLQATLL	ILITSAVLTTVLL
AAMNSIATRAVEVEGRLAAI	VQLSNYIETSLNVEKLI
LANAIMITNVVKTLAVIQIM	VSQANAIMITSAVVGTLAVIHIM
SSQANAIMSITAVVGTLAVIHIMQ	SLANAIINTVVKTLAVIQINL
SLVNLQTVISNLQVI	QAVTQKVFNQKIA
AAMNSIATRAVEVGRLIAAI	VQLSSNYIETSLNVEKLI
SLQANAIMKITNVVKTLAVIQIL	GSAVSNQAAIMITSAVVGTLAVIHIL
QTAAMNSIATRAVEVGRLIAAI	VISVQLSNYIETSLNVEKLI
EKISALSTKAVSLGVLKL	VNNLLSFIKSKIVSIEF
EKISALSTKAVSLNGVLKLYQLI	VNNLLSFISKQIVSIEFFLVP
LEVIKLTNVLSVLTVLKILLV	LEVIALTAVLVLVLYILIV
KLLNVVSVSTVLKIDLVN	LDHISLINIVFDSFLP
LVIALTAVLVLVLYILIV	LEVIKLTNVLSVLTVLKILLV
KISALSTKAVSLNGVLKLYQLI	NLLSFISKIQVSIEFFVL
LEVNIKLTNVLSVLTVLKILLV	LEVIALTAVLVLVLYILIV
KLLNVVSVSTVLKIDKLV	LHISDLIVIFSDFLV
NENLAR	EPFSDA
KISALSTKAVSLGVLKLYQLI	LLNSFIKSKIQVSEFFVL
EKISALSTKAVSLGVLKLYQLI	VLNLSFISKIQVSEFFVL
LEVNIKLTNVLSVLTVLKILLV	LVIEALTAVLVLVLYILIV
KLLNVVSVSTVLKIDKLVN	LHISDLIVIFSDFLVP
LEVIALTAVLVLVLYILIV	VNIKLTNVLSVLTVLKILLV
NLAR	FPSDEA
KISALSTKAVSLNGVLKLYQI	LLNSFISKIQVSIFFLV
VIKLTNVLSVLTVLKILLV	EVIALTAVLVLVLYILIV
VKLLNVVSVSTVLKNIDLVN	VLDHISLIVIFSDFLVP
EKISALSTKASLGVLKLYQLI	VELNLSFIKSKIQVSEFFVL
VN	ASSQ
QEKQ	QKQE
FPSDEA	NLARI
EKISALSTKAVSLNGVLKLYQLI	VLNLSFIKSKIQVSEFFLV
LEVIKLTNVLSVLTVLKILL	LHEVIALTAVLVLVLYIL
VKLLNVVSVSTVLKIDL	VLDHISLIVIFSDFLV
LVIALTAVLVLKVLYILI	LEVIKLTNVLSVLTVLKILLVN
NLAR	FPSDE
EKISALSTKAVSLGVLKLYQLI	VNLLSFIKSKIQVSIEFFLV
LEVIKLTNVLSVLTVLKILLV	LEVIALTAVLVLKVLYILIV
KLLNVVSVSTVLKIDLV	LHISDLIVIFSDFLV
EKISALSTKAVSLGVLKLYQLI	VLLNSFIKSKIQVSIEFFVL
FPSDE	NLAR
HEKISALSTKAVSLGVLKLYQLI	VNLNLSFIKSKIVSIEFFVL
LEVIKLTNVLSVLTVLKILLV	LVIALTAVLVLVLYILIV
EKLLNVVSVSTVLKIDLV	NLVHISDLIVIFDSFLV
LVIALTAVLVLVLYILIV	LEVIKLTNVLSVLTVLKILLVN
EKISALSTKAVSLGVLKLYQLI	VNNLKLSFISKIQVSIEFFLV
LEVIKLTNVLSVLTVLKILLV	LVIALTAVLVLKVLYILIV
EVKLLNVVSVSTVLKIDLVN	NLHISDLIVINFSDFLV
EKISALSTKAVSLSGVLKLYQLI	VNLNLSFIKSKIQVSEFFVL
NNILSITAVLTTVLL	NAILKITNVQLAVTL
NAILKITNVLQATVLLQ	NNILSITAVLTVLL
NNILSITAVLTTVLL	ANAILKITNVQLAVL
KNR	AKDT
TDAK	RNK
TKL	AALS
PKYGE	WPL
HSP	ANL
GFAWE	FAGK
TEKINI	NIIKE
GFQ	AVG
HNL	EHHQ
ANEK	NK
YRGFTYDD	DYDFTRGY
FYLKVDG	FLYVDGK
KQEH	EQHKS
KW	DFSF
QN	QAEPR
RDTNF	QRV
EIISKG	KSGII
RKVEEA	EAVEKRK
LLSETVVE	EVVTESL
LLSETVVE	EVVTESLL
VVMA	VAVM
TKPGM	NEQ
TKPGMF	NEQ
TKKPGMF	NEQ
YRLSLQ	LLYRSQ
RSLQ	LRSQ
FLQNM	FALQM
YRSLQ	YLRLLQSQ
YLRLSLQ	YLRSQ
LQVW	VWGV
SSN	NRN
DSS	NRN
DSS	NRND
LVWV	LWQV
YPMQIQVA	ITTQAIRAQ
YPQIQVA	TIQTAIRAQ
YPMIQVSAE	ITTFAQIQN
YPMQIQVAE	TITFAQIQN
QTNAP	LQTW
TNAP	TLWQ
QTNA	TLGQRW
QTNA	LGQTRW
QTNAP	LQTRW
TNAP	QTLRW
QTNAP	TLGQRW
HNPP	NH
VG	IAQT
VG	QIAT
QIA	GV
EPA	LPD
VG	IAQ
QIA	GNV
VG	QAT
VG	IATQ
VDYK	AQ
EVAA	RLD
HNPP	NHPP
KTKP	VGTQGE
TKAP	IALEETAT
KAG	VGVL
DIAL	KA
TKA	QGV
HAG	HV
IALETQV	TKAKQ
TKA	QGT
IALE	TKAP
RL	VGP
QGHAR	LGKA
TKA	GVQ
TIKAL	IALAEETAT
PKTK	PGGV
KALG	DTIA
TCQ	TKAK
KTIK	GHGP
ALEQ	TALKK
IALEETQ	TAKK
GVG	KPKT
PKTK	VRA
TIALAE	TKKAP
ETVQKK	LA
TIALETQGV	TKKAP
TKA	TIALE
ALE	TKAP
NVK	LRV
HKR	QNVAK
TAQGP	KATP
TQ	KATI
TACQ	KTPK
TKA	TALET
TKA	VQG
TIKA	GVQ
IAL	TIAK
EAEVW	WEVSM
TACQ	TA
IAL	KGALP
TIA	KALGP
TKAG	GQT
ALETA	AKGP
TKA	QGVT
DTIA	KALGP
IALEETQ	TAKP
TKA	GQ
TKA	GVGGPQ
TACQ	KAT
TKA	TIDA
QGVGH	KALT
ALEET	TAK
PDTIKA	PGGVGQ
EVW	WT
ILETACQ	DTIALKPK
PKTK	QT
TIAL	ITAL
PKTKA	QPTAC
TIA	IAL
QGPHKA	KAPKT
AAKM	KAM
AKM	KAAM
AKAM	KAAM
ACKM	KACM
AAKM	KAAM
SVE	ESV
AKM	KAM
AM	KAM
AGM	KAA
AGAK	KAA
AGAM	KAAA
KTD	KTD
KATD	KTD
AAK	KAA
AKA	KAA
AAKA	KAAA
AAKAM	KAAAM
TNRK	FTLE
SVENT	ESVNT
AGM	AA
GAM	KAA
AM	KAA
DYG	GYDS
KNN	ELDASQ
ADSL	PAQ
LSGAG	GLSG
LSGAG	AGLSG
LSGG	AGLSG
ELE	KKRR
KNTV	NT
RPC	TERKT
RP	TERKT
HTH	EEQ
WNEAMVYIKE	YARPPPRRQ
WNEAMVYIKE	YRARPPPRR
WNEAMVYIKEF	YRARPPPRR
VHASI	VIHA
FVA	VSF
VHASM	VIHA
HASMV	VIHA
YWHEM	VIAPRV
MYWE	IVIAPR
YWE	VIAPR
VSQSDYLFA	FADYLSVSQC
RSA	VEAQ
PAGKKT	SSGK
RKKS	GAALEDQR
GAEADQR	RKKS
RPA	DEA
DNDLDE	FKNK
KNDLD	EFKN
RLLVP	VWHH
KSE	EVDK
TGH	QPE
DMD	AQRR
DMD	AQR
Y	HTPRH
FRYQT	RVPYV
VGSD	IKTPR
VGS	IKTPR
GSV	KTPR
GGEFV	DSGP
SDEHLL	SPSRDHL
SDEL	SPSRDHL
DMH	MDII
DIM	MDH
DMH	MDI
DIMI	MDH
DM	MDII
ITP	LQ
WVWISL	KIRVCK
ITD	HFS
LK	HMEG
EEY	KQVT
QAEN	EVIK
AEN	EVIK
IADNYYQL	VQQSL
IYSAKYLL	YSVQAL
YFIFHKA	HFKIFAY
NDF	RN
NDF	RNF
DFG	RNF
DFGN	RN
KKRKDS	FSHATNEN
KKRMKDS	FSHATNEN
KKRKDS	AFSHATNEN
KMKRKDS	FSHATNEN
KMKRFKDS	FSHATNEN
LEQQ	MIK
ELAR	VGIQR
ELAR	VGQR
ALRNVE	TTR
FLHEQVLVKLKE	FLHEVLQKVLKR
LCHLKFW	FLWKLCHE
KHWTF	FWTLKH
DKTKR	KDTKEDQ
FLHEQVLVKLKR	FLHEVLQKVLKE
KHWTLF	FWTLKH
LCHLKFW	FLWKLCH
FLHEVLQVKLKRI	FLHEVLQKVLKEIL
CRYH	HCR
CRH	HCR
RHC	HCR
LYVIA	YLVIA
LYIVA	YLVIA
NVQHK	HELAD
HELA	NSVQH
LES	SLE
YKG	RGYK
KRA	YED
KSAQ	KT
SSDRDA	RKGDR
VHSFDN	VY
DSS	SSD
GKGRPP	MEKGDQ
DRAG	KGD
ADG	KGD
GTGR	DM
GTTR	DM
GDK	RADG
KGD	ADG
RGDA	EPGRW
EPRWG	RADG
NRT	TNR
MNLIELIH	LHIILEMN
LMNIEILH	LHIILEMN
PNED	NPE
RILR	CLWDD
IVSR	SQD
NW	NAGA
PQKG	KPGQK
DSNTM	RQE
NKEE	FRRP
RRF	EKN
NKE	FRR
RRF	EKEN
ELHS	LD
VNWI	VNWI
NVPP	PPNV
NHSHVP	PVHSHNI
RPG	RPG
RPE	DHGDYP
KLRDG	PGGE
GFDVQE	NGTK
KKAE	DEAQ
VSQ	VSQ
TVH	PVT
LLILI	GNILL
GLT	SAFG
MYPGE	DGVRD
MYPGE	GVRD
MYPGE	GVRGD
DGSPR	RGER
EYGTGWRK	YERWGTGK
EYGTGRWK	YERWGTGK
EYGTWGRK	YERWGTGK
ERYGTWGK	YERWGTGK
EYGTGWR	YERWGTG
ERYGTWG	YERWGTG
EYGTWGRK	YERWGTG
ERYGTWG	YERWGTGK
EYGTWGR	YERWGTGK
FLNDIKTSVQQRKTAECAAELSL	TCLSELAAECKTRAQQFVSTKINLD
FLNDKITSVQQRKTAECAAAELSL	TCLSELAAECKTRAQQFVSTKINLD
KNRDR	AAARE
GLHLL	DVVF
RSPT	KYRQ
YFI	KYY
IYF	LKYY
YFIQ	KYYN
HTD	ADK
NKNG	NDT
FGN	IYFKM
KEYPR	NPYRE
KEYRPN	NPYREK
YKERPN	NPYREK
EYPRN	PYREK
KEYPRN	NPYREK
QEFPRT	TPFREQ
QEYPRT	TPYREQ
QEYPQT	TPYQEQ
QEYQPT	TPYQEQ
QKEYPT	TPYKEQ
QEYPT	TPYEQ
QEYPT	TPYKEQ
HLR	DPIA
HLR	DPI
AEGE	PD
RDYP	SFQQK
RHD	SQF
SQFGQK	QH
MYWELEEER	DRQALKKQ
QVISQLFI	VISILQTLGF
VISQFG	QVIESIQF
QTYF	KYFT
LKIKSNE	NENSIL
ILSNEN	ENSILK
TAE	NYQ
TAPA	PATA
QSVER	SQVER
YAHQ	YK
DNCPN	NNFDK
TNKN	PNN
TNNN	NNTK
PQTTT	RDFGENKH
DMN	KTQ
TPYFTTQVPAVLGGQ	QHGGALVPVYQTTFT
YFTTTQVPHGAVPLGQ	HGGALVPPVYQTTFT
TYFTTQVPHGAVLGQ	QHGGALVPPVYQTTFT
TYFFTTQVPHGAVPLGPQ	PQHGGALVPPVYQTTFT
TPYFTTQVPHGAVLGPQ	PQHGGALVPVYQTTFT
STDHGVED	EDVGHSTDR
PGG	NSK
KIALL	PRFM
IKLL	PKRIMI
KIALL	PDRFM
AGYF	FGYA
RIVVL	VNI
RLVV	VNI
KW	FVDI
KWF	PFVDI
QFGL	KTMGR
MQE	MGER
NPKQSLGR	TNAMPGFNR
TGNRPNAM	NGLSPKQ
NSPKQLG	TNAMPGNR
GNSPQRL	TNGKNAMPGFNR
TGNRPAMN	NGRLSPK
VVSLG	ILFG
YLTTF	TLF
LIRIPG	AITSIW
LVIP	ITW
LVIPV	ITW
LIRI	ITSIW
NYWAIAPVV	RVIITALA
WNAIAPVV	VISITALA
YWAIAPVV	RVIITALA
NYWAIAAPVV	RVIITALA
YWNAIAPVV	RVIITALA
WNAIAPVVL	VIITALA
YWANIAAPVV	RVIITALA
YWANIAPVV	RVIITALA
AELT	PDSYAQ
AELT	DSYYAQ
DAKIN	PDYYAQEQR
DAKIN	PDYYAQEQ
DAKIN	PDYYQEQR
DAKIN	PDYYQER
DAKI	PDYYQE
DAKIN	PDYYQEQ
DAKINV	PDYYAQEQ
DAKINV	PDYYAQEQR
DAKIN	PDYYAQER
SQD	PNYF
SQDIR	PNEYFTE
DAKIN	PDYYQQ
DSQIR	PNEYFEQ
DSQRI	PNYFTEQ
IAINVK	PDYYER
IDANINK	PDYYQR
IDAKNIV	PDYYQR
DAKIN	PDSYYQ
DAKINV	PDSYYAQER
DAINVK	PDYYAQEQR
DAKIN	PDSYYQER
DSQIR	PNYFQ
DAKIN	PDSYYAQEQR
DAKINV	PDYYQEQR
DAKINGV	PDYYQEQR
NSTI	RF
NSSL	RF
DHHLEN	HDHLNE
DHLKN	HHLNK
HHLN	DHLK
DHHLN	HDHLK
DIVGHK	HDIGQDD
PDKR	DN
DDEE	KK
DHHLEN	HDHLE
QNARRH	RNAHQR
HDPDHGIQD	LKEQTK
DHLEH	HDHLE
QKATN	KTNAQK
AKQTN	TNAQK
NQADK	NAQKD
EPD	KPED
DHHLEN	HDHLNEK
DHHLEKN	HDHLNE
DHHLEKN	HDHLNEK
DHHLEN	HDHLEK
KEGN	DNAAQ
ANAQD	NEGK
KEGN	DNAQ
KEN	DNAAQ
ANQD	NEK
KSDSP	KDNQ
NQAK	NEG
SDKP	PD
DP	KSPD
KAT	KAT
DHI	NE
ENHH	HHNE
KSD	EDKK
DHHL	HDHL
ADG	TAY
WQI	WQI
RVFPFVYGTFKESEW	PQCWAVALTWEHPYI
RVFPFVYGTKEFSW	PQCWVALTWEHPYI
RVFPFVYGTEFSW	PQCWVALTWHPYI
RVFPFVYGTKESQFW	PQCWAVALTWEHYI
RCVFPFVYGTKESF	MRPQCWAVALTWEHYI
RVFPFVYGTKEFSW	MRPQCWVALTWEHPYI
RQVFFIYGTSFW	MQSWLAALIWYPFI
RQVFFIYGTFW	PQSLWLAALIWSFI
RVFPFYGKTFV	MRPQCWVALTWEYI
RVFPFVYGTKESFW	PQCWAVALTWEHYI
RVFPFVYGTKESWF	MRPQCWAVALTWEHPYI
RCVFPFVYGTKESWF	MRPQCWAVALTWEHPYI
RVFPFVYGTKEFS	RPQCWVALTWEHPYI
RVFPFLYGTWEF	PTWLVALIWHPFI
RVFPFVYGTKEFSW	MPQCWVALTWEHPYI
RVFPFVYGTKEFSW	MRPQCWAVALTWEHPYI
RVFPFVYGTKEFSW	MPQCWAVALTWEHPYI
RVFPFVYGTKESFW	MRPQCWVALTWEHYI
RVFPFVYGTKESFW	PQCWVALTWEHYI
RCVFPFVYGTFKESW	PQCWAVALTWQEHPYI
RCVFPFVYGTKESFW	MPQCWVALTWEHYI
RVFPFVYGTEFSW	MRPQCWAVALTWHPYI
RVFPFVYGTEFSW	MPQCWAVALTWHPYI
KQVFPALYGTEFLW	TQTWLVAIWHPFI
QKVFPALYGTEFLW	QTWLVALIWHPFI
KQVFPALYGTEFLW	TQTWLVALIWHPFI
KQVFPALYGTEFLW	PQTWLVALIWHPFI
RVFPFVYGTEFSW	MRPQCWVALTWHPYI
RVFPFVYGTFESW	MRPQCWVALTWEHPYI
RVFPFVYGTWEF	MMRPQCWAVALTWHPYI
RVFPFVYGTFESW	MRPQCWAVALTWEHPYI
YAIL	YAIL
YALI	YAIL
FSYKG	GFSYK
QAGQR	AGQRQ
GQAGQR	AGQQ
ATIP	QAA
AQAKAA	NKERSGQ
AA	SLLS
AAQ	NKERS
KSYYGSQ	SQGYSYK
MTQPAI	IPQTM
SNVVDDA	ETKVKD
ETQ	KDKD
DKKN	KTYGKGGSS
SDAVVNN	GVWGQI
KSND	DKN
PQPYQAV	WKFAG
IAPPFQLS	YYRHSV
PLPYQAV	WKFAG
FYAPPFQLS	YARHSV
FYAPFQSLS	YARHSV
PLPYQV	WKFAG
PLQPYQAV	WKFAG
FYAPFQRLS	YARHSV
YAPPFQSLS	YTRHSV
YAPPFQL	YTRHSV
FYAPFQLS	YARHSV
FAPFQLS	YARHSV
FYAPPFQSL	YARHSV
FYAPPFQL	YARHSV
PLGPYQAV	WKFAG
PLPYQAV	WFKAG
FYAPFQRLSS	YARHSVL
FPPPFQLS	YRHSVL
FAPFQLSS	YARHSVL
FYAPFQLSS	YARHSVL
FYAPFQSLS	YARHSVL
FYAPFQRSLS	YARHSVL
FRPPFQLS	YRHSV
FPPFQLS	YRHSVL
IAPFQLS	YYRHSV
PLIGPYQAV	WKFAG
IAPPFQLS	YYRHSVL
IAPPFQLSS	YYRHSVL
AVAAGLATYRR	FLLLLTRL
AVAGLATYRR	FLLLLTRL
VVATGATY	MLLLMLTL
VAAAGLATYRR	FVLLLLTRL
VAAAGLATYR	FVLLLLTRL
VAAAGLATYRR	FLLLLTRL
VAAAGLATYR	FLLLLTRL
VAAAGLATYRR	FLLLLTR
VAAATGLAYRR	FVLLLLTRL
VAAAGLATY	FVLLLLTRL
VAAATGLAY	FVLLLLTL
AVAGLAT	FLLLLT
YGTVVTS	KMLLVAMH
HGKE	SG
NFVVG	QAVG
YQGAK	KDS
TGADAK	GTKKE
VLGLATGVLA	LVGGALGVLA
VGLAGVLA	LVGGALGVLA
VLGGATGVL	LVGGATLGVLA
LVGGAGLVLA	LVGGALGVLA
STDL	PSGL
LSTD	HVR
TSD	PSG
STD	SGL
KPN	NGG
DGAPNF	FNPGDA
LYVAN	VALNY
NQD	QNI
YLA	ALY
IVLLILAVIRAIMSIA	ITLLVLIVVIYHESAMGAAIAVITIL
VVLLILAIVIRYSADSLMSAI	VLLVLNIVVIEHLSRALGAAIIDITIL
VVLLILAIVIRYSADSLMMSIA	VTLLVLNIVVIEHLSRALGAAIAIDITIL
VVLLILAIVIRYSADSLMSIA	VTLLVLNIVVIEHLSRALGAAIIDITIL
IVLLILAVIRAIMSIA	ITLLVLIVVIYHESRAMGAAIVITIL
VVLLILAIVRIADSLMMSA	VLLVLNIVVIGEHLSRALGAAIADTIL
VVLLILAIVIRYSADSLMMSIA	VTLLVLIVVIEHLSRALGAAIAIDITIL
GYF	FGY
GYFI	FGYI
GYFI	FGY
HTVA	THVAA
HTVAA	THVAA
HTVA	THVA
HTV	THVAA
HTVAA	THV
HTAV	THVA
FTR	RTF
GYF	FGYN
GYFN	FGY
GYFN	FGYN
GKFG	GHGY
FGY	FGY
YTE	TYK
FTRT	RTFT
GIDEA	QARM
RDALS	MSHKD
VNI	VLAS
VNI	VLA
KAES	HK
VSW	LRE
LFMIIT	TIILFM
LFMITI	TIILFM
DSHYD	GDP
PGIEGIAR	DRRNSAI
FVLQ	FFA
HEQLINVLKAVMTLINIQNVFM	EEITLQDFAHVLVYGSRVWTWKF
LEYLLSMALLDASILLLTFLV	FRLIIFHVNILLVFSVLW
FAFLAEDNLFHMLSFRFSF	IIAFLINNRLEVIGNFSVEWSFE
NGLSF	NVI
AMLGHL	LIVW
TDVHLYNNLQM	RLVFLLSI
RQHSQQHNTLMQMLAWH	LSIIVENEIMMNLNNMIEVAFQ
IMAMNTVTVLLWM	FVLMFHLFFLL
LYEVT	CVFP
HLLISILFPPTIFNLLSL	FEFALAVALEMMFQHSESASY
WGLGSAR	LTNQIL
LRHV	INPEW
LISIDSFPINSTL	KIVTRNMTVTNL
DCSSFLSSTVFGDL	LQLLLTEMRAAERA
CLE	CYL
CYLE	LE
SENV	KSTKRQN
GYDR	TD
TGA	EQP
GKH	HGK
ERND	KRDN
YPAETS	TGK
KTGT	EYTSP
KRDNI	ENRDP
HFY	GHTAA
QGAC	CGAQ
QGVC	CGVQ
QGACR	CGAQ
QGRC	CGRQ
QGKC	CGKQ
QGRCR	CGRQ
QGRCR	CGRRQ
TISPRL	RLPSTI
DGVRRTH	HRTRGDV
LDN	FSDA
FDAS	LND
LAEKF	FKEAL
QVKNG	NGKVQ
DGVRKRTH	HRTRGDV
KEQ	EKQ
ADRSS	RSFD
GKV	DRRD
GQQ	PQGQ
QGQ	PQGQ
DRM	RDM
DKQ	DKQ
LPAAP	PAAPL
LLRC	LRL
LPAAAP	PAAAPL
FEHL	NT
QRE	QKER
KEDT	TNRAQ
KEDT	TRAQ
ELD	QRR
HRKLLFLTTYVWQFLSS	ASFLWQYTVTLLFKLHR
QRR	VEVD
HA	KAHPH
DHER	HRD
IILLA	LLAII
QAE	AEQ
NDKEA	QLHGKKEA
QAE	AEKQ
KEHGKAQL	EADN
QAE	CAEQT
QLR	SLFNV
KLQSKC	GEQ
SNKAQIK	QEKRE
QEH	TNITLED
QEH	NITLED
ITLGR	TIGRL
ATCARG	TCAGRA
RAG	YIAGE
VL	VEL
LEGRV	GRLSGVLAL
RLG	ESGRL
GRESVL	GRL
RCAEVLG	RCATEVL
LRG	VESGRL
RCAEVLG	RCAVL
LRG	VCESGRL
TER	RTE
LGRES	RCATRE
GIM	HRY
YR	IPACIA
SGR	YRAT
REST	YRATE
YNSS	RG
GL	DVT
GLP	DVT
KVDT	DVTK
ETDR	EA
EA	ETDR
MVIYW	YWIVM
WSATKM	ATKMWS
YYNPNY	PNYYNK
NLEDA	LEND
AISL	IAASL
YKLID	DNLMY
WLVKV	EIAF
WLVKV	WENIAF
WLKVKV	ENIAF
DDL	KAA
WVKL	ENAFQ
WVKLEM	WENIAFQ
LHAREDL	LHAREDL
LITGL	SVIF
SSAFVIR	TGLINL
NLIVGL	RVIF
TISTH	ITSTH
RK	MQDEEIGK
EAK	ARNR
FYLN	FYN
GQER	QPD
SGW	ALPF
AEFNY	AEGSQY
AEFNY	AEGQY
RQGWDNNGQ	QWDNNQGR
QGWDNNGQ	WDNNQGR
EDVSGMYCEGTIKV	KTIGYCESGMDVE
NPSS	SNPS
PNTK	KPNT
NER	SEHE
RLVQ	YMD
RLQ	TYM
HY	DYF
SENARFD	GNS
ESNARFD	LGNSS
ESNARD	LGNSS
SENARFD	GNSS
SENARD	GNSS
ESNARD	TGNSS
RGESN	VTDITANSI
RGESNQ	VTDITANSI
RQLLLEQALAKQILLHMVVLAQYKFDRERHLVKLKQLQLQFE	QLLRQLAALKQLILAHVMVLKQAYKDFAERARLVKLQQLLQEF
MIQTLDTLMYCFDRREAIHKELALQLL	MTIQDLMLRMYCDFERARIHEKLAQLL
VKLRESRAALVERLIQYKFDRREEDAIERLVKLLQ	VKELSRRALRVLEQIYKDFERDRAQRILEKVLLV
TLQMLMYCFDRREAIHKELALQL	QDLRMYCDFERARIHEKLAQLLL
TLQEMDLLMYCFDERRAIHKELALQLN	LQDLTLRMYCDFERARIHEKLAQLLLN
ERLLLQALAKQILLKHAMVVLKADYKFDRRHEEALVLKQLQLQFEL	RQLLRQLAALKQLILKAHVMVLKQAYKDFAERRLVKLQQLLQEFL
LLRLQALAKQILLKAKHQMVVTLKAQYKFDRREAALVLKQLQLQFELK	LLRQLAALKQLILEAHVMVLKQAYKDFERHARLVKLQQLLQEFL
SLLRLQALAKQILLKAKHQMVVTKLAYKFDRREAALVLKQLKQLQFELK	LLRQLAALKQLILEAHVMTVLKQAYKDFERARLVKLQQLLQEFLK
RQLALAQIKLLHAMVVTLKAQYKFDRREALVQLKLQLQFEL	RQLAEALKQLILKQHVMTVLKQAYKDFERRLVKKLQQLLQEFL
QLALAKQIVLKHAMVVLAQYKFDRREALAKLQL	LAALKVILKAHVMVLKQAYKDFERARLAKL
LLQALAKVQILLHAMVQVTLAYKFDRREALVKLQLLQFKEL	LQLAALKQLILKAHVMTVLKAYKDFERARLVKLQLLEF
LQLLQALAKQIVLKAHVMVLKAQYKFDRRELALKQLQQLYELK	QLLKQLAALKQVILKAHNVMVLQAYKDFERRLAKLQQLLQEYL
HRLLR	EVEVYSDAE
LR	KFR
DWRNEADSFG	GSFADENRDW
HRR	NIAD
FNM	RRAS
FLNM	ARRAS
FGDN	FDS
IHR	TD
KEPI	PIK
KKR	EAY
YYGGSQ	LKF
YGYGS	KF
YYGGS	LKF
RNN	NRNT
DKNN	KQ
NEYP	SSEEK
MLIKDEYVEK	VQLTRWHPRFN
QQFGG	NSKT
TED	TDE
KESM	EKSM
LENGLEKWNRG	WGNKREKLENGL
ANSV	SSTSD
KEDRKLG	KWLRKWDKE
KDRKK	KLGRKDK
YRAAVHT	ALDKAMQ
YRAVTAHGE	ALDKAMQK
RGKK	RRN
RGK	RRN
RDEDA	QKQ
LPQ	LRQN
PQL	LRQN
LRDD	QFK
LPQL	LRN
LPL	REN
PQLLD	LRQNK
DLQ	QRKAH
RDEDA	QK
PLQD	LRQN
VLLKQG	VLKRQG
DISFIR	KY
ISFDVR	Y
ISFDIR	Y
NDISFIR	KY
DISFVR	KY
ISFVV	Y
NDGISF	KY
ISFVDVR	Y
DISFV	KY
MEAAAY	SLVY
DGISFIR	KY
ISFDI	Y
ISFVDIR	Y
DISFVIR	KY
SDIFIR	KY
RTVA	GRTLY
RTVLI	GRTLY
DEE	RSG
DEE	RSGL
LDF	VKK
ERDDQ	R
KEPLL	EKLPL
LPLF	LPLL
EDAL	LR
KLEPLL	EKLPL
LPL	PQL
ELL	EKLPL
KLPL	EPLL
EKLPL	EKLPL
KELPL	EPLL
LPL	PLL
DKH	QAEDK
KDFMEIDDF	NGYRRRF
RKGN	DSGD
ASSTIST	QLLDSDFY
RKGK	DSGD
HPD	DQNDT
GHG	GGH
QYN	EVGG
SSGSQ	DTIEP
SGSSQ	DTIEP
VDKSEVFGTTCTGSDGTTT	QLSNSKCEKSTLTNCDKSEVF
VDKSEVFGTTCTGSDGTTTS	QLSNSKCEKSTLTNCVDKSEVF
KSEVYGTTCFTGSRDGTT	SNSKCEKSTLTNCYVDKSEV
KVSEYGTCTGSRFDGTT	LSNSKCEKSLTNCYVDKSEV
YDMP	HRQ
KARG	RGTQ
DSKDS	DRESK
TPGK	AVT
ESDK	DKSE
RGR	HRD
RMEK	KEHMTQ
VPE	ETHL
AEVNFSG	GFSVNAE
SSTH	HF
DLE	LFRRQ
LED	FRRQ
LEA	FRRQ
EDALE	FRRQ
DEA	LFR
KEALE	NHQLSR
RGEVQ	DYSGL
ERGKVQ	DYSGL
REVHQ	IDSGL
KEKGRV	DYSNMQ
RRGVDF	EQNN
HPN	CYR
HPMN	CYR
PHMN	YR
LLYAFTIMIA	LLIGIGANAAIMI
FLLYATIMI	LLIGIGANAAIMI
LLASSA	IIASATL
LLLASSQA	IIASATLI
SYAS	GRGLSP
EK	PERQR
IVG	SEAN
QE	PEQR
IVGE	SEAN
IVPFL	FPL
RLNTDE	DTAGLSAD
KTNLED	TAGLAD
WQKNDG	RPAYL
DP	SDPE
ENETRT	DQNLAKN
ENTR	DQNLAN
KAHW	TES
RG	FDPL
QVMVYLK	QLF
FTQ	WFE
YGVI	NPSY
YEIL	NTPS
LSDD	FI
IYL	TPS
LDSD	FI
YLI	NTPS
LSDD	IY
RFFIY	PLGLENWF
RFFVANR	PLGLEDENF
FRFSRV	LLEDENF
RFFANRI	PLGLEDENF
RPFIVANRE	PLGLDENY
RD	AGE
RDL	GLSDSN
RD	GLDS
MRK	GLSDES
MR	GLDES
LLFVFF	FLAFH
LLFVFE	VFLAFHK
LLT	LMIY
DEE	KDEK
KDE	DEN
NVGFKR	KRFVNG
K	YYSEC
DL	DCELA
ASLNE	ELEAS
CDLEA	DCEL
KVARM	EQN
AESDEQ	LSNNY
SEQ	SNNY
SADEQ	LSNNY
RAESEQ	HLSNNY
RDGE	VRDK
SFGDS	KW
NDPD	RSLSK
AKL	AKLPD
SSKRL	PDND
AKLD	AKLD
RGGGQA	VLQNPDL
FKRQIQNER	IIDNYTYNINIFTTIYKINAQNL
FKRQIQNEELR	IIDNYTYNINIFTTIYKINAQNL
RHEPA	QEWD
RHEPA	QWD
QH	EKTEN
QH	EKTENI
QH	NEKTEN
QHK	NEKTEN
QHK	VEKTEN
DDYTPME	KP
KP	DDYTPM
DDYTPM	KP
DDTPME	KP
EAVKLR	YIETKV
DK	RLFK
DSS	PI
QKQKDQS	AKIQKQQKD
EAQQ	KDH
QQIQKKK	QKQQKD
GDYK	NI
HSR	QLLG
AGVDKD	DAGVKD
KRN	DPD
RSG	GER
EER	QRREE
IQAF	IAQAF
QAFIA	IAQAF
FAI	IAAF
AFI	IAAF
REEL	GQSEQ
EAEN	QR
LGKVMVLSRFIYQEMLRLV	LEVTMEVLQFLAYEQLKLTVE
LEVTEMVQLFLYEQLKLTEV	LKVMVLFILYMQLRLV
LKVMVLSRFLYMQLRLV	LEVTEVLQFYEQLKLTVE
LEVELGLQLFLLYQLKSEL	LKVLSLLRFLEYTQMRLL
LVLSLLRFLYTQMRLL	LEVLGLLQFLLYQMKLSLE
LEVLGLQLFLLYQMKLEL	LKVLSLLRFLYTQMRLL
LYQVHSE	LYQESVH
LYQVHSDD	LYQDDSVH
LYQVHSD	LYQDSVH
AKLAFSGLE	ELGFSLAAK
YDLRPGL	RRIFKI
GSIGVV	VVGGSI
LAVFRN	NRFNLAV
LAVFNR	NRFLAV
GFPAAVY	AVYAGFP
GFPAAVY	VYAGFP
RDFFD	DRFFVR
YRSEGLL	LERY
LLR	ALEHS
YLAVEA	EAAVLY
VELSNQERDKVASIGCF	SIGCAFVDKREQNLVE
VELSNQERDKVASIGCF	SIGCAFVDKREQNLVES
AKGLADA	DAAGLAKA
AKAGLADA	DAAGLAK
AKGLADA	DAAGLAK
AYKAAEFD	DEAFAYA
AEFVRVSFE	EVSFFRAV
DIAK	KAID
DEIAK	KAID
DDIAK	KADID
TVIKLDL	DLIKLTV
IRNSVNTTTE	TETTVINRNS
IRNSVNTTTE	TETTVIRNS
TGD	PDLH
TNAQ	TNAQ
TNAQS	TNASQ
TASQ	TNAQ
YENQL	QPLNEY
HAQGDPF	DPFGAQH
QHWAAI	QHWIAEI
EGAPF	PFGA
QHWAAI	QHWTAEI
WQHAETI	AQHWAI
GAQPF	PFGAQ
R	GEGGS
RDI	IRDF
IRD	IRD
NSR	KTE
PGLE	EGK
RANYNI	NIRAN
ADLR	RLSAD
ADYLD	DLADY
ALD	DLA
QANLN	NLQAN
RYRN	QDRR
QTKQRDG	QWRG
EEG	SAS
ISQAARKIE	IEARKAQIS
VYVL	VYVL
ITG	GER
WTTGGA	LYQK
WTTGGA	LYQ
EGKD	DQKT
DST	SDTV
SSGQ	TSYGP
SRPLK	TDL
SDVG	GSDV
KSNG	DPQ
AEDN	RH
VAEKKEVQ	VQKEEKVA
VGTDHP	GKP
GKAAN	NRDSEGK
VAAEKKEVQ	VQKEEKVA
SGPPGPPGPPGPPGARGEPGNIGFPGPPGPPGPPGRDA	SGPPGPPGPPGPPGARGQAGVMGFPGPPGPPGPPGRA
SGPPGPPGPPGPPGARGQAGVFMGPGPPGPPGPPGK	SGPPGPPGPPGPPGARGQAGVMGFPGPPGPPGPPGRAP
SGPPGPPGPPGPPGARGQAGVMGFPGPPGPPGPPGKE	GPPGPPGPPGPPGARGEPGNIGFPGPPGPPGPPGRDAT
SGPPGPPGPPGPPGARGQAGVMGFPGPPGPPGPPGRDA	GPPGPPGPPGPPGARGEPGNIGFPGPPGPPGPPGRA
SGPPGPPGPPGPPGARGQAGVMGFPGPPGPPGPPGK	GPPGPPGPPGPPGARGEPGNIGFPGPPGPPGPPGRAP
SGPPGPPGPPGPPGARGQAGVMGFPGPPGPPGPPGKE	GPPGPPGPPGPPGARGQAGVMGFPGPPGPPGPPGRDAT
GSGPPGPPGPPGPPGARGQAGVMGFPGPPGPPGPPGKE	SGPPGPPGPPGPPGARGQAGVMGFPGPPGPPGPPGRDAT
APLQMLNRLVLRVQITKMLVCA	LQMELETNAALDVLLQEIFLTVCDA
LMQLETREALVADLLQEILTVDACC	APMLLQTNLVRLRQVITLKVMAC
APLQMLNTLRRVLVTQIKMLVGCA	LQMRELETAALDVLLQQEIFLTVECDAC
LMQLETREALVADLLQEILTDAC	APMLLQTNLQVRLRQVITLKVMACG
APLQLNTLRRVLVQITKMLVCAG	LQMELETAALDVLLQQEIFLTVCDA
LMQLEETALVADLLQEILFTVDACCE	APMLLQNLVRLRQVITLKVMACG
LMQLEETALVADLLQEILTVDAC	APMLLQNLQVRLRQVITFLKVMACG
APLQMLNRLVLRVQITKMLVCA	LQMRELETNAALDVLLQEIFLTVCDA
LMQLETREAVADLLQEILTVDAC	APMLLQTNLVRLRQVITLKVMAC
APLQMLNRLRVLVQITKMLVCA	LQMRELETNAALDVLLQEIFLTVCDA
LMQLETREAVADLLQEILTVDACC	APMLLQTNLVRLRQVITLKVMAC
DLMQLETEALVADLLQEILTVDAC	APMLLQTNLQVRLRQVITLKVMAC
APLQMLNQRTLRVLVTQIKMLVCA	LQMRELETNAALDVLLQQEIFLTVCDAC
APLQMLNQRTLRVLVTQIKMLVCA	LQMELETNAALDVLLQQEIFLTVCDAC
LMQLETEALVADLLQEILTVDAC	APMLLQTNLVRLRQVITLKVMAC
GGALHPR	K
GGALGHPR	AKT
ALGHPR	KT
ALGPK	RAK
AGLGPK	AK
AGGLGPK	AK
AGPK	RNKE
YNAFVH	RLVGR
YPAETT	REW
FYECG	LFQ
NQTPL	EDSW
GAMA	PLPP
DKKE	KEDK
DLGK	GLDK
AEAIPDKG	GKDEP
KEDTPEH	DAKETEH
DGA	DGA
ITGAGMY	PFGGMN
TAGYMLEW	FGIGMNFE
AGGYMELY	GIGMNFEY
GIMNGEY	AGYGEY
KK	DKDP
WVLTLIINQTVQLLSANLEKILELNTQIYVEQLVG	QQKAFNMIVFTNITTSQLQVALNIQVNGNLNTLRFISIQY
QTNKD	QTNKD
LLLQLNALVNIQVIIN	IVIQILNVALNLLQLGK
QIAFIITLLQVALLV	NQIQFAITALLVVNALL
NQIQFAISTALLVVNALLL	QIAFIILTLLQVLLVL
ILSLLAKNLNVIIVNQVASNI	ANFNIIQLTTSTLGQVNALNV
IESLNLVRLEIVNSVAIN	IQFKAQIESTTAKLVQNATL
QIAFIILTLLQVLLVL	QIQFAISTALLVVNALL
LVNANQVLSGLTTTQIIFNAKN	INASVVNIQILNVAKLNSLIDL
KRENE	QDR
IESLLVNRLEIVNSVNAIISGD	IQFKAQIESTTAKLVQNATLQLS
QIAFIILTLLQVLLVL	NQIQFAISTALLVVNALLL
LILSLDLAKNLNVIDIVNQVASNI	QKANFNIIQLTTSLGQVNALNV
VLSNALNQVLSGLTTQIIFNAKN	ISINASVVNIQIDLNVAKLNSLIL
QIAFIITLLQVLLVL	NQIQFAITALLVVNALLL
VNALNQVLSGLTTQIIFNAKN	INASVVNIQIDLNVAKLNSLIDL
EILESLLVNRLEIVNSVAINSG	NIQFKAQIESTTAKLVQNATLQ
LLVLFILLILDEVV	LLLNFIVLIRLKVV
LLNFIVLIRLVEV	LLVLFILILLDVEV
LLVLFILLILDEVV	LLLNFIVLIRLVEV
ITLLQVLLVL	ITALLVVNALLL
ITALLVVNALLL	ITLLQVLLVL
ELLAKNVLIDIVNQVASNISI	SIQLTTSLGQVNALNVLS
ILTLLQVLLVL	ISTALLVVNALLL
LLAKNVLIDIVNQVASNISIL	IQLTTSLGQVNALNVLS
LLAKNLNVIIVNQVASNISIG	IQLTTSLGQVNALNVLS
LESIDLEKYY	SLIDLQLG
LDQLINSE	ESLIDLQEL
IESLLREVNLEIVNSVAINIGDLVS	IQFKAQIESTTAKLVQNATLQLNAIVR
SHTSVIIIEILVLSLLLDEI	GHTSVLIINVIQILNALNLLQLGKQIK
GHTSVLIINVIQILNALNLLQLGKQIK	SHTSVIIIEILVLSLDLLEI
ALEMRLLSKRESSLIKQLNLLLEGRELERLLKTLLNRKELELERTRKDLELKA	MRLLESLEKRLIQKLNLLLERERLLEKLTLNLLEKARLERLTERLEKLAI
LQKQ	LQR
SGMDI	PSGG
GSMDI	PSGG
GSMDI	PSGGG
QNN	GMDVR
QNN	GMDV
QNN	TGMDVR
QNN	GMDR
QNN	TGMDR
QNN	GMVR
QNQ	IVGLDR
QNQ	IGLDAR
QNN	VGMDVR
LLSFA	LAMVE
LLSA	LAMVE
IIARG	TLVE
MSEPI	GRL
MSPEI	GRL
MPSI	GRL
MSPI	GRI
TGGE	NSD
TGG	NSD
PSN	PM
HVSG	PE
HGAS	YIL
LFLGLYL	FFLWYV
LFLGLY	FFLWYV
LFLGYLL	FFLWYV
RPGS	DWEK
RPGSC	DWEK
RPCGS	DWEK
NVQQ	QATG
NQQ	QATG
NVAQQ	QATG
NAQQ	QATG
GTFPE	IPYH
GTFPE	IPYHH
GTFPRE	IPYHH
RW	RKAGI
RW	KAGI
SFA	HK
SFA	HQK
TPTEIGVTSFAVLPWLYK	KWLTGFFFVRLL
TPTEIGVTSFAVLPWLYKS	KWLTFGFFFVRLLK
TPTEIGVTSFAVLPWLYK	KWLTFGFFFVRLL
TPTEIGVTSFAVLPWYLKNS	KWLTFGFFFRLLK
TPTEIGVTSFAVLPWYLKS	KWLTFGFFFRLL
TPTEIGVTSFAVLPWLYS	KWLTGFFFVRLLK
TPTEIGVTSFAVLWYLS	KWLTGFFFRLL
TPTEIGVTSFAVLPWYLKS	KWLTGFFFRLLK
TPTEIGVTSFAVLWLYKS	KWLTGFFFVRLL
TPTEIGVTSFAVLPWYL	KWLTGFFFRLL
TPTEIGVTSFAVLWYLKK	KWLTGFFFRLL
TPTEIGVTSFAVLPWLY	KWLTGFFFVRLL
TPTEIGVTSFAVLPWLYKS	KWLTFGFFFVRLL
TPTEIGVTSFAVLPWLYKS	KWLTGFFFVRLLK
TPTEIGVTSFAVLPWLYKK	KWLTGFFFVRLL
TPTEIGVTSFAVLPWLYKKS	KWLTGFFFVRLLK
TPTEIGVTSFAVLPWYLK	KWLTGFFFRLL
TPTEIGVTFSAVLPWYLKS	KWLTFGFFFRLL
TPTEIGVTSFAVLPWYLK	KWLTFGFFFRLL
TPTEIGVTFSAVLPWYLK	KWLTFGFFFRLL
TPTEIGVTFSAVLPWLYKS	KWLTFGFFFVRLL
TPTEIGVTFSAVLPWYLKNS	KWLTFGFFFRLL
TPTEIGVTSFAVLPWLYKS	KWLTGFFFVRLL
TPTEIGVTSFAVLPWYLKS	KWLTGFFFRLL
TPTEIGVTSFAVLPWYLKS	KWLTFGFFFRLLK
TPTEIGVTFSAVLPWLYK	KWLTFGFFFVRLL
TPTEIGVTFSAVLPWLYKS	KWLTFGFFFVRLLK
GGRASM	ASMGGRV
KTDSSQ	TDSSQK
QFE	KIVG
EIGMEL	S
GIME	GSA
GKNF	DT
GFKN	PDTK
GFKN	DT
GFKN	PDT
GFKN	PDK
GKNEELF	PDTK
GKNF	PDT
GKNF	PDTK
KSEI	EEKISKG
KSEIE	EEKISKG
KSEIEK	EEKISKG
KSEIE	EEKISK
KSGEIEK	EEKISK
AAM	AAAM
SNN	NSVNE
SNVNE	NSVN
SNVN	NSVN
SNNV	NSVNE
TAK	KTA
AVE	AVK
AVKE	AVEK
TAKN	KTA
AVK	AVE
RPDV	PRVD
QYVVSNS	HIESIDSK
DSKISEI	SNSVYV
MVT	VMT
LT	VTID
RTADV	TRV
STE	TES
QDYL	QKFQN
QDYL	KFQ
QDLY	QKFQN
RNSSLP	DQNLSSCK
DELER	RELDE
DCDPS	HNL
NSNY	RAKTR
EPD	LKGLR
EEW	WEE
NFSY	AKETR
DT	GVQEN
QENGV	TD
NGPVRY	LPAEAR
RQARMEE	REDTLKE
LKG	KGL
LPVERT	RTLPVE
YLAF	YLAF
QSVN	QVSN
SLAG	NL
GHFG	GHGF
GFG	GGF
GFTG	GHGF
GHFG	GGF
EELMLHIVR	RVHILLME
LAFL	FLFL
QQY	RKK
KRK	YAQQ
RPL	EKAL
RRNDEV	RNDERV
RDE	SRNDERV
SRNDERV	R
R	SRNDERV
GRDA	DAGR
TII	ITI
VRRAGD	VDGARR
PPPTLQQ	QQTLPPP
NLLLVG	ERVAGFIF
EQD	RQHK
QEDG	GRQK
HEA	HAE
TR	KNAE
TRK	KNAE
TR	NAE
TR	FNAE
TRKH	KNAE
TRH	NAE
TRK	NAE
ISVFQVLILKLVRILAKI	CIVQVILQLVAILEI
QCIVVILQLVAIILE	SIVFQVLILKLVRIALKI
ATIPR	QQ
SEEG	PAKRQ
RE	IERT
VSRID	R
EQS	LG
LAATM	LAMAT
NARMGETEAAR	AMARTEMGEARN
ENARMGETEAAMR	FSAARTEMGARN
LAAT	LAAT
RSEIVGIEFKH	HFKIEVGSEIR
EFFI	EFFI
RSEIVGIEFK	HFKIEVGSEIR
PADRM	YLGNT
PADRM	YGNT
KSGLA	SGLSA
KSGLA	SGLA
SGALK	RYLGN
RSGLA	SGLSA
RSGLAS	SGLSA
LSGAK	FRYLGN
GVC	EKTG
VGC	EKTG
KTG	VCG
HII	IIH
RAWE	WERA
IIAL	IIAL
IKAIALT	IKIATL
IAIKL	IKIAL
PRLQ	GITTV
LGRP	AGII
GST	GN
QPE	GITTV
LGQ	AGIV
QLG	AGI
GRLP	KAGI
RNSDN	ELR
QLNNP	EELQR
ELI	YALDD
KR	ISTGS
SSHH	RNLV
SSHH	NLV
ECGLR	LECGR
VVRG	IAR
ARI	RGVV
MPHPI	IMPHP
KR	VDSRVS
FS	ISMA
FTL	IMA
QF	QMDPA
FQ	ISMA
FSQ	ISMA
QFW	HISMWA
NLYLLMYLTVEP	HHAKGFLWWFWT
EET	GSKY
EFIS	SFEI
QFNALDD	QDEQ
IL	LLRLA
RTFIGESQQ	TCSQSQFIGER
FIGESQQTCS	QSQTFIGER
RTFGESQQ	ETCSQSQTFGE
RTFIGESQQTCS	ETCSQSQTFIGER
TFIFGESQQTCS	QSQTFIGER
RTFIGESQQ	ETSQSQTFGE
NGER	RGNE
KRLFS	FEVFY
SNETVN	KNETCLQS
EQEL	KYD
LNQ	TTR
STVN	KNETCLQS
LNP	TTRK
SNETVN	KNETCLS
STVN	KNETCLS
SETVN	KNTCLQ
LNQ	TTRK
STVN	KNTCL
SNETVN	KNETCLQ
LLNQ	TTR
SNTV	KNETCL
STVN	KNETCL
QLN	DTTRK
FSNETVN	QLKNETCLQ
FSNETVN	QLKNETCLQS
QIN	LLP
AIETG	MR
PYRHNR	TNVNCALSMAKL
HGLM	HG
FLIG	PH
ESYIM	KQGYIE
NPALV	EVRNQL
SLSTS	NSK
SLST	NSK
RDQ	IPAA
KYDIMMI	EEKLAIFG
VLIGS	ITRN
LVLIGS	ITRN
LKNELRS	LERTSV
ETREL	RSEKLLN
TSVREEL	RSEKLLN
LKNEL	LERT
LKNELSR	LERTE
RTEL	EKLLN
LKEL	LERT
KLNELRS	ELERTS
LKRLQINTNTTSELQ	QSELATTVNNTIQLRKLQ
LKNELRS	LERTE
YTATLTQFLTY	YTAPEYECVEQLD
YTATLTQFLTY	YTAPVYECVEQLD
PSC	RFE
EPEE	QHKY
IQWR	SQSE
SPS	LQWK
KRNQ	ADDR
SLELVLLKLRQ	RLKLLLEVLSN
YSPS	FTQS
HPT	AKAP
IRIKLLLLIT	ILLTLIIK
RRKM	RPEL
ELF	IMLL
RLFL	DRKDLILL
RELFL	RKDLILL
GFVQ	QVGF
ERGLHN	RELG
VSASN	NSVSA
VSASN	NSESA
VSASN	NSSA
SEGN	SGEN
SFE	GFSE
LFFS	VLHLLK
KT	GKPV
PEYNKI	IKYPEN
SEKQK	KED
NTE	KRRYN
KR	QDLRG
KR	QVDLG
KAR	QDLYG
KVPGKLK	DASALRD
QSNMI	SNMIQ
SNMIQ	NMIQ
SNMIQ	NMQ
RVFEA	EP
TASALYENSQI	QQISYENALTAS
LTASALYENSQQI	QQISYENALLTAS
LTAALYENSQQI	QQISKYENALLTAS
LTASALYENSQQI	QQISKYENALLTAS
EQT	RRAA
LELTYLKK	FRLLALINR
LKQKKIKVS	IGIIESILE
LKQKKIK	IGIIESILE
ALIQVYAL	VTRFI
ALQVYIAEL	VTRFI
VQAI	QVAI
QNRILI	QNRLI
RE	EVRPY
LKAEK	EKALK
VYLD	KDAR
TVRR	CAN
ERD	DEAR
AQRLLTGA	ADEMAQRQ
QRALLTGA	DEMAQRQ
YQGCV	KELLD
VPAA	PGR
RPG	AAVP
RPGLE	AAVPG
HEYWGHQP	PGWEYH
EERGT	RDGAV
SR	EMAP
AQR	QDARE
TPIVP	EWA
KCIE	QRHG
LKFE	LEKFR
TLDG	EI
EE	ETLDG
RGPIEH	DF
RGPIDEH	DRFE
EKG	KEG
GER	EKK
EEGVDY	KKR
GQRVL	NQD
RLR	ADIDD
GVQRL	NQDE
HAQ	AHQ
VNTKTDLL	LLKTDRTVN
KKSEV	KN
NK	SEVK
KSEV	KN
KRSLY	DEAA
NGQ	QGDV
EEPDLP	PDLPEE
PEELPD	PDLPEE
RDVPRLG	TRDGLPVR
RRAGD	GDAR
RAGD	DASR
HRQK	QSHRK
GPQV	QQG
SAGGHNQ	NQSGGH
SGGHNQ	NQSGGH
LRQN	KEQR
LRN	KEQR
AQHEA	AHEQA
AADLKH	PE
AADL	PE
E	QSAGH
PE	AADLK
PE	AALK
AAMK	PE
AADMLK	PEWE
PE	AAMLH
SLRF	EK
AQG	EQAG
QAGE	QAG
QSGGHN	NQSAGG
SPR	ASP
RRN	EEQ
GH	ENE
ENE	GH
AGGHQSN	NQSAGGH
SGGHQN	NQSAGGH
QL	SPGD
AVA	AAV
KYET	ETKY
VAAAKD	AAVKAD
KEQVY	STAAT
ETVAR	AVTER
TEVAR	VTELR
TEVR	VTELR
ERTVA	RAVTELRE
ETVAR	AVTERE
TEVR	VTEL
EVTR	VTELR
ETVLR	AVTELRE
ETVAR	AVTELR
PTVA	AVTP
TEVLR	VTELR
ETLVAR	AVTELR
ETLVA	AVTE
ETVALR	AVTEL
TKL	LTK
ETLVAR	AVTER
NPWT	TPWN
NPWFT	TPWN
SEW	SWSE
SDNE	NSDE
TTGKY	HDHLWFIDV
TTGKY	HDHWFIDV
NLEMQNIMQTIEIQTNQDQAYEMYQEKARASE	DFQKTKLDQKAQNQKAQSSRTKQVQNLQQSRVITN
DFKQTKLQDQKANKQAQSSRTKVQNLQQSTVRIMN	NELMQNEIMQTQEIIQTQNDQYAEMYQKEARAN
NLEMQNIEMQTIEIQTNQDQAYEMYQEKARASE	DFQKTKLDQKANQKAQSSRTKQVQNLQQSRVIMT
NLEMQNIEMQTIEIQTNQDQAYEMYQEKARSAE	FQKTQLDQKAQNQKAQSSRTKQVQNLQQSTRVITSK
NLEMQNIEQMTIEIQTNQDQVAYEMYQEKARSAE	DFQKTQLDQKAQNQKAQSSRTKQVQNLQQSRVITS
NLEMQNIMQTIEIQTNQDQAYEMYQEKARASE	FQKTQLDQKAQNQKAQSSRTKQVQNLQQSTRVITNL
NLQEMQNIEMQTIEIQTNQDQAYMEYQEKARN	FQKTLDQKAENQKAQSSRTKQVQNLQQSRVIMN
NLQEMQNIEMQTIEIQTNQDQAYEMYQEKARSE	DFQKTKLDQKANQKAQSSRTKQVQNLQQSRVITN
NLEMQNIEMQTIEIQTNQDQAYEMYQEKARASE	DFQKTKQLDQKAQNQKAQSSRTKQVQNLQQSRVITN
NLQEMQNIEMQTIEIQTNQDQAYEMYQEKARAS	DFQKTQLDQKAQNQKAQSSRTKVQNLQQSRVIT
NLQQMNIEQMTIEIQTNQDQAYEMYQEKARSAENLNQSRQVMLMAQQAGQFTQDEMRKAELDQQN	DFQKTKQLDQKAQNQKAQSSRTQVQNLQQSRVINTSKQQEIQTQTQYNIKMTVSEVDVHTQR
GNLEQMNIEMQTQIEEIQTNQDQAYEMYQEKARSAENLNQQSRVMLMAQGAQFTQDEMKRAELDQQN	DFQKTLDQKAQNQKAQSSRTKQVQNLQQSTRVIMNTSKQQEIQTQTQYNIKMTVSEVVHQTQR
NLQEMQNIEQMTQIEQTNIAQDQAYEMYQEKARSAENLNQQSRVMLMAQGQAQFTQDEMRKAELD	FQKTKQLDQKANQKAQSSRTKQVQNLQQSTRVIMNTSKQQEIQTQTQYNIKMTVSEVDVHT
NLMQNQIEQMTQIEIQTNQDQAYEMYQEKARSAENLNQQSRVMLMAQAGQFTQDEMRKAELQQND	DFQKTLDQKAQNQKAQSSRTQVQNLQQSTRVIMNTSKQQEIQTQQTQYNIKMTVSEVDVHQTQR
RS	NKSTE
DEQS	ARK
DGES	GANR
GA	DGS
QLNS	KLPGSQ
QLN	LQPG
KLQN	PG
TTELA	LGSSVL
TTELA	LGSSQVL
PRLILLK	EQWDLVKS
PLVMYFQHL	RPILVIIKQL
PSLVMYFQLQ	RPILVIIKLH
PSDLVMYFQHLQ	RPILVIIKQLH
MIDHTKRGDI	LTYNLQSEK
FVET	VLV
EDRL	QDH
RELLK	VGKQDP
RNDS	QA
HKN	QAHR
NTDS	SIQ
DDPVQFRAFLHY	NDMYNSFL
DSTRYPQFIRLHVSAM	KYLNMVVYSRSALL
EEDD	KIQAI
STFQRIHCIVS	NDVYLLSALLI
EQYDSFIRANHLYSMPEKTEKN	DVNHDINNQLTTELIYNRSIADE
QYDSEFIRANHLYMSPEKEKN	DVNHDINSNQKLTTNELIYNRSIADDE
DTSPQFIRHCISA	KFYTNQMVYAIRVANL
RQTLHICLH	TQMVYASRSAL
TQYSRPFIHIS	TNMVYASLRVAL
TRQSFIHIS	TMVYSLRSVANL
RQYTFIHCIS	FKTQMVYASRSVANL
QFILHVMY	FVKFYTMVSRVANLN
QFILHVMY	VFYTMVSRVANLN
RQYTHFIHCISVMAPPYNELDS	ASLQEFVKFYTNQMVYSLRSALNL
RYTQHIHFCISMMAPPYESLD	SLQEFVKFYTNMVYSLRSVANN
RYTQFIRHCISVMAPPYESLDK	SLQFVKFYTNQMVYSLRSALNL
QDPFVDERIKFANLHEYL	NMVIYINLSIAFDLIE
DSEQYPFIRANHYLMS	TVTNDLMIYNLRSAFDL
SFEVRILHY	DLMVYILFLI
MTVITEHELKLLKSWLLN	LKLDIYKKNQIQLDVLLPEFAFK
LIEIIEHELHTLNVWLL	LKLVYKKELPNIKLDVLLNPDEI
LLVVLFKA	VISLVIIFDDIE
DYTAITMVLYKA	KNDQVVYLLIVLHI
YIATMVVLKA	NDVYLLIVHI
TATIMVVL	VLIVVHIN
KTYAATNV	YVDT
YTALVVLFA	DNINAVNDM
ATSALEQVQLK	LTKMVAEYSIEE
YTALLVVLKA	DNINLKAVNDM
TASALEQKVQLKE	NLTMVEYSKIEEK
DKEYELQKNSDNK	EKNKEEKMPAN
EAENVKS	LIVLLI
DELQKD	KNKKME
DEKEQNKYN	KNKAEEKEKN
ATNVK	LVLI
DEKEQNSKNY	KNKAEEKELKN
KTAATNMVK	MVLIVLI
DKEEQKNK	NKAEEKELIKN
KDEEQNKSDN	KLELKNNKEEDKPLA
KDEEQNKSDNK	KLELKNNKEEDKPLA
KEDEQNKSDN	KLELKNNKEEDKPL
DTYAMNVL	QEFKAYLDV
KTAETNQKVSKL	SCNEVKMLEAYNKVE
IVLK	VLNDVL
TTAMVVLKA	EVKAYLKNDVL
KTAEETNVKSLKA	SCNEVMLKYNKVEEED
TKAATEMNVKSLK	CKNEVKMLAYNVEEED
TALVLVNVL	VIVRIIFDIE
YTALVLVVLFK	DMVILVIFDIE
TAASLEQVLKQE	NLTKMVAEYSIEK
TLLVK	VVIIDE
TLLVLK	VVIIDIE
GMEVLENWLKVMIIIQR	LLKLQSLKVVLDVIIHLLQVFL
LMQV	VVA
MLQWV	LVVA
MLWV	LVVA
KIVA	LMFGF
LMKQ	LKQM
DQQ	QDQ
HPKRD	RHPLKQ
SMPG	DNATQL
WNN	DGFV
RDCL	RI
RCL	RIG
RDC	RIG
REK	EKKGIWG
SDK	QDEY
TQPNK	TEAV
DAITQR	ATRIQ
RAITQR	DATIQR
NAITLR	NATILE
VLVL	VVLL
EKP	EKP
TVTL	TVTL
E	AKGGVG
NRRWPLE	AHRSS
KHE	EKH
EGMGK	KTG
EMGGK	KTG
EAGA	REG
TRVD	GST
RKLFNG	FNFAVEEYL
NEL	EEG
DQI	DAD
KAGRVILTAVLLAIAAPN	RRGTIFVLFVWIMFIIAQTT
AGRVVNILTAVLLAPIALAN	RRGRGYTAIFVLFVWIMFIIAT
ARNIVVLAVTLLALAVAN	RRGYTIFVLFVWMFIAQQTT
TQIAFMVIFFLIVTGRGNGYRR	LAAPIALLTALIVNRQGGKAM
AGRVNIVLAVLTIALAPAV	RRGRGYTIFVLFVIMFIIAQTTNL
SCKTIK	SCKIAK
TVPVSSG	AAVA
KHLKYKTT	YDVFVPK
NTRSNWVPG	TNWGRSVPN
AERME	TQKDR
RTQKD	EAERM
AEMRE	TQKDR
ELATNQ	YT
NLENLI	NELILN
KLKNA	YYN
PRA	DNY
LLFAFLFDKLAYNGNL	LLNVFTIQNDKFALH
LDNLGNKA	HKLNSN
LLLFAFLFDKLAYNG	LLNTVFTIQFALH
DRL	RQLL
RLD	QLL
HIRKPY	KTKSAS
FRRVDY	IGIWFR
TVYL	RTLF
IGGARHD	RFMEVK
LIGARH	VRFVEVR
NQKRLQ	YNWAVTGQ
TVEMLAV	DTADYVSAK
TVEMLV	TADYIS
REQD	MTWFPI
REQD	TFPI
TAITG	RIY
KFYQDHAT	NALKK
VKE	GWR
VKE	GGWR
PQVHKNI	FRVLEM
PVQHKNI	FRVLEM
RAL	ARLR
ENHI	EEM
RREDETR	EDRRTER
AFDG	QGF
RE	GSDK
FLVFE	FAKLQ
FFEFYEE	VFAVLK
FALVV	LFEFF
FFFE	VFAVK
FFLEF	VFIAKVL
GGGII	IGIGG
IGIGG	IIGIGG
GIGGI	IIGIGG
IGGGI	IIGIGG
YNY	GFFR
MFFGKER	YVVYNKQD
MGFKER	YVYNKQD
LALQIQLIQLEQLQIKL	ALKILLQLLIQQQLKEIL
AKALLQIQLILQQLQEIKL	AQALKILLQLLIEQQQLKEEIL
AALKLIQLIQLEQLQKEIL	SALKILLQLLIQQQLKEEIL
ALKLIQLILQQLQKEI	QALKILQLLIEQQQLKEIL
YKLINCQL	QLQILDLQQ
PSSCWD	EQQAEK
YKELINCQL	QLQILDLQQQ
YKELINCQLKN	QLQILDLQQQ
YKECLINQLNK	QLQILDLQQQ
PSCSW	EQQAEK
YKELINCQLKN	QLQILDLQQQQ
NSRLTN	NLTR
RR	SFLDP
MLSFE	FEMRA
QLDDRTARQER	REERQTARQLDD
MLERSELNDF	DFNLSEMRA
LDDRQTRQER	REEQTARQLD
EQVKLL	EDQKLL
QVEDKLL	VEQKLL
KPIAIRLYIKIMELMLDLRVQ	YLVLQRLLDMMEIIKYKRILAI
FKLALREYKIVKEQLELELFIAF	FLLQRLLDMMEILRYKRILAMK
KIVKEQLELELFFS	EILRQYTKRILAK
FKLALREYKIVKEQLELELFIQAF	FLLQRLLMMEILRYTKRILAMK
LLARYFVKIKELELELFIQF	VLQRLLDMMEIIRYQKRILAIK
SVNIAIGLIIAN	SAVRIITLAARV
SVNIAIGLIIAVNAI	SAVRIITLAARV
SVNIAGILIIAVN	SAVRIITLAARV
SVNIAIGLIIAVN	SAVRIITLAARV
TYKE	AN
SAGD	ER
LKMN	NLKM
VIA	VAI
KEERKY	KSSAHLKLFE
WLIVLT	ISQLIIVLF
ISIQLIVILF	WLIVL
WIVLT	ILIIVLF
WIVLK	ISLIIVLFI
WIVLT	ISLIIVLF
WLIVL	ISQLIIVLF
WIVL	ISLIIVLF
WIVL	ISQLIIVLF
WQLIVLT	ISIQLIIVLF
LIQIAVLFKKISLDSGFAMKSD	IWLIVVLGTLGGSDLGASIKKKSDE
GQK	QEET
EIP	IPEK
TDMLQ	MPVKA
MTHD	VKQ
ATD	TRH
DTA	TTRH
RSLG	ERG
FNRLEISRA	SREAILFRHN
LAG	GTRGF
ELNA	RH
KQ	EKRQ
FFG	YPY
FFSG	YPYQ
FFDSG	YSYY
FFG	YPYQ
RFISGGE	HFGYHS
VDDVG	VQYQY
VDDGV	VQYY
DRTAKN	RHNH
TDNA	NH
AGSLQ	NTEI
VSSRQVS	SY
SVQV	SY
SVQVY	SYR
TTSG	TAAG
TSAKT	PMS
NLLKVKLASQSKLQ	LQKQSLASKLKVLN
ELEIR	REILE
LEIR	EILE
RRE	AEQR
EEK	AEQRT
EEE	EQR
EKD	AEQK
NASHLER	WGF
FKMELLASERELRKMLLKQELVQQELNAERLCIKENLVNMLRNEEMLTKLEKLCIEDLET	EFLKALSERRLEMLLEKLQQVEQNLAERCLINKLKVMNRLDEEMNALTKLEECLKILEL
REMEMKFKLLAERSLRMKLLKQELVQQELNAELCINLKVNMRLENEMLTLKEKLCIEDLE	REEMMKEFLKALSERLEKMLLEKLQQVEQNLARCLIKLEKVMNRLEEMNLTKLEECLKDILEL
PSLGWL	YRLQL
KLERLLSM	PMSLLELR
PFLP	PLPF
PFPL	PLPF
EFL	EFL
QLNYL	HR
LYLN	HR
LLYN	EHR
PY	LDCPT
Y	LDCPT
VVREW	FPGCE
ED	PTL
DEF	PTLV
EVSAIAAVLL	KNPLALMW
ESVAIAAVLL	KPLALMW
VASIAAVL	NLALMW
VVSVGAVLL	NLALMW
VVSVWAL	NLALMW
LVSVVWAL	KNPLALMW
LK	NAKQE
HDHYMK	VLGHFY
DYHYVMK	LGFY
HDYHMK	HFSYPDPW
KTLTILMFLYF	FLQQSFSMWWIRFE
KIPFSICLLFYF	FQQGELSMWWIRFDA
KIPFSICVLLMFYF	FQQGELSMWWIRFDA
DGGTT	KFYI
STGDT	KFYV
LHLTSFVYKY	TLSLWYLQH
LHLTFVYKY	TLSLWYLQH
LLTFVYKY	TLSLWYLQH
EPRGG	PEGGR
GVYD	GLKTIK
KGA	GEKGL
EDGPNG	SQHK
GWKF	FGWK
RLFAA	AALFR
RLFAA	ALFR
GWF	FGWK
LSR	LSR
KQ	DQKR
KQD	DQK
NAR	NRAS
EE	EVKEE
QE	RQE
SPD	PSD
TLNFA	ANKFL
KK	MDDLE
FAKL	AVSF
DRNP	RND
NQ	SHD
QNSHD	HDK
AV	FEF
EFF	VKRA
SSDSRY	PTPT
KA	GADA
RLD	HKD
EGE	EGEV
QEE	DNRSTN
RTSEAS	LERENL
ESQQ	QSE
ESQ	QSQE
TFNRI	VKQ
TFNIR	VKYQ
FTNIR	FVKYQ
FIRTN	FVYQH
LATM	VF
QTLMDL	REGEN
ERGLG	QQN
WYM	KDMFR
WLMY	KDVFR
LMFSHTN	WMIQAEQIAR
FLTHS	IQAEQPPSR
SISNMSN	FLAQAAR
SSISNMSN	FLAQPAAR
EGNN	KRE
LSYI	AKGAP
NLNTL	FNIS
NLNTL	RFNIS
QED	RLF
ELSPEQ	GKRLF
ELSPREQ	KRLF
QELSPD	KRLF
PLMW	DFL
KLMDQ	SGYEQR
EKMLEDV	GYKRR
EKLED	GYKRR
NW	YHKG
FDVK	LQ
LIMKT	IAIR
LIMK	IAIR
AMTMKT	MMLM
AMM	MML
IYHYN	INYHY
KNDT	DKN
NLMMLWTQKREFESKQALL	NLMMLWTQERFEQSAKRL
LTNRELIALLFQLKFAVLLG	TLCENQLRAILLFQLFALVL
ERVAEST	RQKR
QAER	RE
DDNAAYQ	QAYD
AHKG	YERGH
LILRENLTMYKEKEILKFNIERKAVKLIMK	ILRNELTMEYKEEILFKEIRNKEAVLKIM
NR	NLRD
NR	RRNFRD
NAR	RRFNLRD
NR	RNRD
NR	RNFRD
FHP	ESA
SAE	HFP
HSAE	HTF
FHPT	EHSA
HSAE	HPTF
FH	EHSA
SSAE	THF
SSAE	PTHF
FHT	ESAS
TISPFD	QNSILDSAN
EHPA	ATAN
TISPND	QNSILSAS
HTAA	AARL
HTAA	AGRLA
SSG	SPGA
SPGA	SSG
GNN	EDHG
TTGVE	R
SFKLTLA	AIFIE
FGYNT	YTNFG
EFTIREK	FETIREK
KQFQ	KNDQ
AG	DRAK
AIGP	GIA
IGP	IGPA
NGM	NGM
REGGT	GTAE
FAH	LKD
FH	LRDRF
QKD	RD
AQKD	RD
RGV	DFRD
HGFGLD	DGLDFG
AVAA	AVAA
EAR	AER
ARA	AKAAA
TVVAA	SVIS
TVVKAA	SVIS
YP	KSEV
ALETDYTF	VIIKELKVIS
ALIAA	SIVK
LAA	ISVK
DSISV	AAGVT
DSISV	AGAVT
LSVG	LSG
NW	AKRK
TVYA	EDAA
LLHR	LAD
MRR	MTAGADI
QKKR	LAVD
QKKR	AVLKD
TKR	TMGA
QRK	NTLC
LLHR	AEQD
LLHR	EAQ
HKR	FGSR
RDLH	HPLYS
HALRQALK	NLTPDTDE
RKR	TADMAGA
TKR	TAADMG
EK	TAAMG
TKR	TADMGA
MTKR	TAAMGA
SRE	LKDMAL
KEA	MGAT
QKR	MKAE
LHR	AQED
HKRG	FDSGR
MLAGGV	TAGD
DV	TVS
VAAAK	SQATL
KTPPVL	IPPL
KTPP	PIP
KTPPY	VPVEIM
KTPPY	VPVEIMDA
KTPPVLK	IPPLG
KTPPV	PIP
KTPPV	IPP
KTPPL	PIPL
VVPSASALIKP	AWITVRLDK
KTPPL	IPEPL
GIPPK	YVPQD
KTPPVLK	IPPLE
KTPPK	IPEVGN
KTPPFL	KPILM
KTPSYK	PVIIKDAD
KTPP	IIPVP
VVPL	QLKVV
KTPFLK	PLMIG
KFLK	PVIMG
KTPP	AMVIP
KTPP	MVAIP
KTPV	IPL
KTPY	MVPAG
KTPPYLKA	PIA
KTPYLK	PIA
KTPYLK	PIAD
KTPP	IPVP
KTPPF	PI
KTFK	PKMLD
KTPPY	PEIDA
KTPPY	VPEIA
KTPPY	VPAIGD
KTPPY	VPMAID
KTPPYK	VPEMAID
KTPPVK	IPEFVG
KTPPY	VPIDA
KTPPY	VPVEIDA
KTPPY	PIDA
KTP	IPP
KTPPVL	IPIPL
KTPPY	VPVEIA
TPPVL	IPPL
TPPL	IPPL
TPPASYR	PVIVAMD
KTPPL	IPPL
KTPPVKKSG	IPPLE
KTPPVK	IIPPLE
KTPPV	PIPL
GVQ	VPVD
KTPPV	IPVEIL
GVPPSQLKKGLE	TVPVDMKAGQF
KTPVL	IIL
KTVLK	PTLEK
KVLK	PLPKG
VVPSSITEPPR	FTVVKIKEG
KTPPL	PPL
VTSVASIRLKDKI	WVCQTKLDG
KTPPFL	KPLIM
KTPP	IPP
KTPP	PVIP
KTPPYR	VPAID
KTPP	VPVEI
KTPP	VPVI
KTPPY	VPVEIAD
KTPPY	VPVEAIM
KTPPY	VPVEAI
KTP	PVVP
KTPLK	PPLE
KTPPK	PVIPE
KTPPLK	IPPLE
KTPPLK	PPLEK
MTGADE	LRLGKE
NK	EVQG
AKPGRE	R
KPGRE	R
NK	VQG
TLEDLKDVIK	TEIE
IEKLTVSEL	VSETKLIEL
IEKLTVSL	VSETKLIEL
IEKLTVSL	VSTKLIEL
IEKLTVSL	VSTLIELK
VAMSV	MSVVA
KF	SVL
VAMSV	MSVAV
RGHR	QRGL
KHRPW	VRAA
KHRDW	RQAAR
KHRDWT	VAQRA
KHKAEYT	AAQRLW
KHRPDW	RAAV
KHKAY	AALW
KHKAEY	AAQRLW
KHRPDWT	AARQV
KHKAEYT	AQRL
KHRPDWT	VAAQR
KHKAEY	RARFRLW
KHKAEY	RAQRFRLW
KHKAY	AAQRL
KHKAE	ARQR
KHRPDWT	VAARL
KHRPDWT	AARLV
KHRPDWT	AAQRLV
KHRPDWT	AARV
YGY	RKG
YGYP	RKG
YSGYP	RKG
TGHI	KG
TGHI	KGF
GYQ	RKY
NTN	FPRVA
GYP	RWPG
NTN	FPRVAS
YSGY	RKG
YTGYQ	RKG
YTGYQ	RKGK
GHI	KGF
GHI	KKGF
YGYQ	RKGY
GY	RKY
SGRP	KGY
SGYP	KRG
HGYP	WRPG
GYP	RKG
TGHI	KKF
TGHI	KKFG
GHI	KKF
YTGYQG	RKYVG
YGYQ	RYKG
YGYQGG	RYVK
SGYP	KRGY
TAFNKT	WHVMS
TAFNK	WHVM
NTN	FRVAS
TAFN	WMHV
TAFN	WMPHS
SGY	KGRY
SGYPG	KRY
GHI	KKG
GHIG	KKF
GHIG	KF
TGHI	KKGF
HI	KKFG
TGHI	KF
HTGH	FKG
GH	FKGK
HGHI	FK
TGH	KFG
NVN	TRVST
NTN	FRVA
GHIG	KGF
TGHIG	KFGK
HTGHIG	FKG
GHI	KKFG
NKTR	MHVW
HI	KGF
FNK	MWVS
GHI	KF
GYP	KRG
TAFN	WMHS
AFN	MWHS
LSNP	MYRV
WNHN	FRIT
AFN	MWH
GYQ	RYK
LNG	GF
LNG	GFA
PIL	RIEL
PIL	RILE
PIL	RLE
MIK	YVR
PIL	RIL
VLN	YVR
MINQ	YVR
MVK	YRS
PIL	RILSE
HRQNRNQEF	KAMPTVTS
NRNQ	PMTS
QVTF	KWT
WVTF	WTW
WQVTF	WKTW
PDG	GVSRF
PDG	GVSR
PD	GVSRF
PDG	VRFGS
PDG	VSRG
PDG	EDGIT
PD	GVSR
PD	VSRFG
PD	VSR
PDG	SRG
PDG	DGVITE
RPDG	VEDGI
PD	RVSG
PD	RGVSF
PD	RVSFG
PDG	RVSFG
PDG	RVSG
PDG	EDGV
RRPDG	SDVG
PD	VRFGS
DG	RFGVS
RRPDG	RSVI
RPDG	SVRG
PDG	VS
RPDG	RVSG
RPDG	RSVIG
RPD	RVSG
RPDG	RGVS
PDG	VRS
PDG	GRTVS
RRPDGS	GDE
DG	RVSI
RPDG	VGSRF
PDG	VGSR
RPDGS	VDG
DG	RFTGVS
RDGS	VDGS
PD	VSRG
PD	RVSIF
PDG	RGVS
D	RFGVS
PDG	VSRFG
PDG	VRGS
HEL	RMKIR
KHEPL	RMKIR
ALTD	KF
GKYELQSDV	RVFLVRASPYLR
GKYEELKQSDV	RVFLVRASPRL
GKYELQSDV	RVFLVRASPRL
GKYEELQSDV	RVLVRASPRL
GKYEELQSDV	RVFLVRASPRL
GKYEELQSDV	RVFLVRASPYRG
GKYELQSDV	RVFLVRASPYRL
GKYEELQSDV	RVVRASPRL
GKYELQDV	RVFLVRASPRL
GKYELQSDV	RVLVRASPRL
GKYELQSDV	RVFLVRIASPYRL
GKYEELQDV	RVFLVRASPRL
GKYEELQSDV	RTVFVRASPRL
GKYEELQSDV	RVFLVRASPYRL
GKYEELKQSDV	RVLVRASPYRL
GKYELQDV	RVFLVRASPYRL
GKYELQSDV	RVFLVRASPGLR
GKYELQDV	RTVFLVRASPRL
GKYELQSDV	RTVFLVRASPYLR
GKYEELQSDV	RVLRVASPRL
KYELKQDV	VHFRIVEAPCFR
QSDVL	SPALG
KYELKQSDV	VHIRGAPCRV
YEIKQSDA	IVKVITESPGFK
KYELKQSDV	RTVLVRRGSPLAR
YELRQSDVR	MKVRSMSLR
KYELKQSDV	NNAEEKRVSFTA
RYELKQSDV	MFLVRVVAPYG
KYELQDV	HVMRIAPCFR
GKYEELQSDV	RVFLVRASPRGL
MYELKD	KLVIIKLVFER
GKYEELQSDV	RVFLVRIASPYGLR
PTGL	FGG
PTQGL	FGG
PTQGL	FG
PTQGEL	FGG
PTQGEL	FG
PTNQGEL	FGG
PTNQGL	FGG
PTNQGL	FG
PTQGEL	GGF
PTGL	GGF
PTQGEL	GF
PTGEL	FGG
PVHHG	YG
PVHHG	YGG
SKMMRI	IGN
SKRMMRI	IGN
SKMRI	IGN
SKQGRI	IGN
SKGRI	GNI
SKQGRI	IGNG
SKGRI	GNIG
SKQGRI	GNI
PTQG	FG
PTQGE	FGG
PKQGK	FG
PTQGE	FG
SKMI	IGN
SKRQGI	IGN
SKRQGRI	IGN
SKRQGRI	IGNG
SKGRI	IGNG
SKGR	GNIG
SKRRI	IGNSG
PKHQQ	YQS
PSK	KGY
PKSG	GGF
PVHHGVNQL	YGG
PKHQGQ	YQS
KPTG	SGFGKQ
PNTAGRK	GY
PTGL	GF
SKQGRI	IGNN
GA	NVAL
PEVRMG	KLGST
PLEVRMGK	KLGST
PLEVRKG	KLAGST
EVKG	KLGST
EVKG	KLST
LEVRGKGK	KLHGST
EVRGKG	KLGST
LEVRGKGK	KLGST
LEVRKG	KLHGST
EVRKG	KLGST
EVRGKG	KLST
LEVG	KHKLT
EVRKG	HKKGLAGT
PLEVRKGK	KLGST
PLEVRKGK	KLST
LEVRGKGK	KHLGST
LEVRGKG	KLHGST
LEVRGKG	KLGST
EVRGKGK	KKLGST
QGG	TGSS
PLEVRMG	KLGST
PLEVRMG	KLGT
LEVKG	KLST
LEVRKG	KLGST
AEKG	KAHGGSS
AETRKG	KAHGKVGSS
ETRSG	HKKGAGST
SGK	SSS
KTSG	SASS
PEVRMGK	KGLGST
PLEVRMGK	KGLGST
PEVRMG	KGLGST
PLEVRMGK	KGLGT
PEVRMG	KLST
PLEVRMGK	KLGT
VKGG	KGT
EVKGG	HKGT
EVRKGK	HKKGT
EMG	KKLGST
VMG	ALAST
LEVKGK	KLGST
LEVRKG	KLHKGST
LEVRKGK	KLGST
LEVRKGK	KHLGST
LEVRGKG	KHLGST
LEVRKGK	KGLGST
EVRKGK	KGLGST
EVRKGK	KLGST
LEVRKGK	KLHGST
LEVKGK	KGLGST
LEVRKG	KHGLGST
LEVRKGK	KHGLGST
LEVRKG	KGLGST
EMG	KGLGST
PLEVRMG	KKGLGST
KAVRKGK	GGHAST
AVRK	HKKAAGG
LAVRK	HKKAA
AVRK	KAAHGG
PLEVRKG	KLGST
EVMG	KGLGST
EMG	KGGST
LEVRMKGK	KHGLST
LEVKG	KLGST
LEVRKG	KHLAST
LEVK	KKLGS
LEVRK	KKGLGS
EVRKGK	HKAGLGST
EVRKG	HKGLATG
LEVRKG	KHKLGST
LEVRKG	KKLAGST
DVKR	LGDRK
ERRG	RGE
AERRG	YRN
AERRG	YRNTK
ERR	NRTK
NR	QSDK
AERRG	RYN
AERRGA	YRN
NSR	DKNK
KN	EAPQA
ERD	YTN
ERRD	YTN
ARRDG	YNY
ERRDG	NY
AERDG	YRN
AERG	YRN
FRAGDN	TKNK
ARRG	RYN
AERG	RYN
FRAGDN	YNKK
FAGN	YTKNK
FRADN	NK
FRAGDN	NKK
FGD	YNTKK
GPGDG	LP
FG	TYTNKV
FN	YTNKK
ARRGA	YN
AERGA	YRN
AERRG	YRNLTK
AERG	YTN
AERRRGA	YRNTK
AERRGA	YRNTK
AERR	YNRTK
AERRGA	YNRTK
AERRGA	YNRT
ARDG	YRTN
ARRDG	YNRTK
RLKLAE	AVYHTC
KQGE	SHRK
KQGE	SHR
LKQ	VHR
KLAE	PHT
RLKLA	AVYHTC
RMKLG	NVYRL
RLKLA	AVHTC
LKLA	VHT
QIP	HILQC
RLKLA	AVYHT
IYL	LMV
IYRL	LMV
PYRLK	LE
VYL	LL
GIDH	RQTR
QDIY	DRIP
DNY	RDPI
DNY	RD
SDNVY	RDPI
DNVY	RDPI
KNPY	RDQNPI
DNVY	RDIP
DDVY	RDRPL
DPNR	RDF
DVY	RDPI
TDPN	RDF
DDVY	RDPL
DNVY	DRPI
STNPY	RDI
TNVY	TDRPI
DNVY	DRIP
IVY	VFR
KLQL	RKKN
QL	KNRKF
KLQL	KFR
REL	HAGA
RQEL	HGAA
RQE	HAGAV
RE	FHAG
QEL	GAH
E	GANVG
LGIDH	LREE
LV	NVQ
LGIDH	LRE
LGID	LR
ELGIDH	RNLAE
ELGIDH	RLAE
ELIDH	RLE
IQLQEQ	TRIS
IQLQEQ	TRS
LDIE	LRK
LIIE	RL
FGST	TKR
YR	TRSK
TKSS	KAY
RYRK	GH
KVQYR	RGK
KVQYR	RK
KVQYR	RG
KVQYR	R
QRLL	RRGSL
GSA	YTH
MKIKGRAR	HCVKDWFI
IEQPT	KL
IKFT	RVV
DLQAP	KEFRQ
GKYPT	SIAL
IEQPT	KVKLS
IEQPIT	KLS
DVIKH	KRLVA
QKYPLT	KRIQKVAS
KLRAP	QR
QPIT	VKQ
IKFP	VVTK
DIKHPV	KLRAA
KLRA	FRM
KEQPT	KKLK
IKFPLT	RSVVTG
KYPT	GQRIV
EQPIT	KKAVL
KHGQR	RLRLAAATV
VRPNG	KAKK
VRPNG	KAKKKQ
VRPNG	KAKQ
VRPNG	KAKKK
VRPNG	KAK
VRPNG	KAKKQ
IRPDG	KAQK
IRPDGE	KAQK
IPRG	KLAL
VPNG	KAKK
IRPDGE	KAQKK
VPNG	QAKK
IRPDE	KAKKQ
IPD	QAKQR
PNG	AKKK
IPRG	LAL
IRPDG	KAKLKR
IRPDGE	KAK
PDG	AKRQ
PNGT	AQ
LD	KIRK
TTESME	GHRSEH
TTESE	GHRH
VTEE	KGRKSAHR
TTE	GHR
TTES	GHR
TSETE	RESH
YRR	DMRT
KQDR	GRAS
SDRS	KN
KQDR	GAS
RR	GKYRN
KQPRR	GRRM
SRR	DTM
SDRS	NK
SSDRR	RNRYK
SDRR	NK
NRR	RNM
SARR	NK
VFLVTH	LPSET
FIVNH	RLVSEYE
QPSQ	AVRK
IKIT	RDLNP
IKAGV	RD
APAK	LPETV
NQGQ	RPT
AGQQ	RRQGI
AAAGQL	RNK
RKARKYE	YRSS
GRVDR	TKAK
GRVDR	TAKK
HM	STK
YTTTK	RGK
TTK	NTGK
EYTTTK	NTGRK
EYTTTK	NTGKR
TEK	SGQK
TEK	GKSKQ
TEK	SQGKK
YYTK	RTG
TEK	WQK
TEK	WQ
EIRFL	LYSE
IRFL	LYSE
ERL	RLSE
EIRL	LSE
DKRL	LESY
EMRFL	IVYS
RKKER	DYYEKD
EVRL	LRSEY
KER	EDDYY
PREIRFL	RLTSE
VRL	IAEY
FMV	LMAVF
FMV	MALV
LMR	VWPAR
FDMEV	LKAV
IIL	LAWLT
FCG	PPLN
KAG	YLT
RGT	FNI
RTG	TS
MRKRR	QDS
KASR	AER
DK	REAR
ASR	EAR
KRKRA	KGTER
KRKR	KGTE
MVSQG	QKEIS
NGVG	VNSG
SGEG	KADKGI
GVG	IDGK
NGG	KIGD
GVEG	IDGK
NGVG	KIGD
KGG	KDGI
EGIQITLQAE	QAFELTIIQEGD
HSE	DKVAN
RFQM	LIFK
TVL	AMRG
ETVL	GAMRG
EM	GFN
YEM	NGF
HFELR	KARVG
RDSRE	YGK
RDSR	YGK
RDSR	YG
RDSREH	YG
RDSREH	YGK
RDSRH	YG
DSRH	YGK
DSRH	YG
DRQ	VGLR
DAQ	VGRK
DAQ	VGLR
KTWR	FGK
DAQ	VGLRK
RDSRE	YG
RDSEH	YGK
KTW	FGY
RKDSREH	YG
RKDREH	YGK
KDREH	GY
RKDSRH	YGK
KDARQ	GVR
RDSEH	YG
RDSH	YG
NTWR	FGK
ETY	FGR
RDSRH	YGK
RKDSE	YGK
TRDSREH	YGKK
KDSRE	GYK
RKDSREH	YGK
KDSR	GYK
DAR	VGLR
RDSRE	YGKK
DSRE	YKK
DSRE	YGKK
RSREH	Y
KDRQ	GVR
KDQ	GVLRK
RKDSRH	YG
RKDSRE	YG
DQ	VGLR
DARDQ	GLRV
DARDQ	GLV
DAR	GLV
IDARQ	VKGLRR
KDARDQ	VGR
KDRQ	GVLK
DARQ	VGR
KDAQ	GVLRK
KDARQ	GVLRK
KQE	GRKP
KDAQ	GVLR
DARQ	VGLR
RKDSR	YG
RKDSRE	YGK
RDSRH	Y
DSRE	YGK
RDSRH	YGKK
DAQ	VGR
DARQ	GVR
DAQ	GLVR
IPH	TVIPRKI
RNITITDT	EEPFDNRIK
RNITNI	DVPNEF
ER	DVAR
RR	SER
ARDS	RTR
YRYQ	RAN
YRYQ	NRA
YRY	RANE
KT	GGGR
YRYQ	AENR
FQ	EANK
RF	EANK
RFQ	ANE
YRY	NAR
YRTYQ	NRA
FRRF	ANEK
RF	ANK
RF	ANEK
FRF	EANK
FRT	EANK
YRY	NRA
FQ	AENK
EVIILRKEK	KREKRFNRV
RLIGCYRR	NHFERY
RLIGCYR	NHMFE
RLIGCYRLR	NHMFEPTRRY
RLIGCYRR	NHFEY
RLIGCY	NVHFER
LIGCYR	HNMFEY
RIGCYRR	NMHFETRY
RLIGCYRR	NVHMFEYR
RLIGCYRRL	NHMFEPRY
RLIGCYRRL	NMHFERRY
RIGCYR	NMHFER
RLIGCYRRL	NMHFERYR
RIGCYRR	NMHFERY
RLIGCYRR	NHMFERY
RIGCYRR	NMHFEYR
LGCYRR	EMHFEY
LLGCYRR	HMFEY
RLIGCYRR	NHMFEPRR
RIGCYR	NMHFERR
RLIGCYR	NHMFEPR
RIGCYRR	NMHFEPRYR
RLIGCYRR	NHMFERYR
RIGCYRRL	NMHFEGRRY
RLIGCYR	NHMFERR
RDICYRRGL	NVMEFRG
RIGCY	NMHFER
RLIGCYRR	NHMFERR
RIGCYRRL	NMHFERRY
RLIGCYR	NHMFER
RIGCYRR	NMHFERYR
LGCYRR	EMHFERY
LLGCYRR	HEMFEY
LLGCYRR	HMFERY
RLLGCYRR	EHMFERY
RLLGCYRR	EHMFEY
RLKIRAHRIRW	EHRMFEIYP
RKIRAHRRWL	ERMHFEIYP
RKIRAHRRW	ERMFHEIYP
RKIRAHRRW	ELRMFEIYP
RKIRAHRIRW	ERMFHEIYP
RKIRAHIRW	ERMHFEIYP
RLKIRAHRRW	ELHRMFEIYP
RKIRAHRIRW	ELRMHFEIYP
RLKIRAHRIRW	ELHRMFEIYP
RKIRAHRW	ERMFHEIYP
RLKIRAHRRW	EHRMFEIYP
RKIRAHRIRW	ERMHFEIYP
RKIRAHRIRW	ERMFEIYP
LKIRAHRIRW	HREMFEIYP
RKIRAHRRW	ERMHFEIYP
RLIGCYR	NHTMFE
LLGCYRR	HTMFEY
RLIGCYRR	NHFERYR
RLIGCYRR	NHMFEYR
RIGCYRRL	NMHFERYR
RLKIRAHLRW	HEMEFGSIYPV
RKIRSHRIR	ERMHFEGIY
RLIGCYRR	NHMFEY
RLIGCYRLR	NHMFEPY
RLIGCYRR	NHMFERTYR
RIGCYLR	ENMFERPYR
RLIGCYRR	NHMFPERY
RLIGCYRR	NHMFEPTRYR
LIGCYRR	HMFEPRY
RLIGCYRR	NHMFEPRYR
RLEIQCY	DRMVHFE
LGCYRR	TEMFEPRY
LGCYRR	TMFEPRY
RIGCYR	AVMHFERFK
RIGCYRR	NHFERY
RLIGCYR	NHFERY
RLIGCYR	NHFERYR
RLKMRLHRLRW	EYKMFEIYP
RMRMKL	EMHFDKV
RIGCYQR	AHFERF
RIGCYLR	AMHFEPRF
LIRAHRVRY	HEMFEMYL
RIGCYRR	NMHFEPRY
RIGCYQR	AVMHFERF
RLKKIRAHRIR	ELHRMFEIY
RLKIRAHRIRWR	ELHRMFEIYPV
RKIRAHLRW	EKMHFEIYPV
RAHR	FE
LKIRAHRLR	HKEMFEIY
KIHLRW	KEMFEITY
IGCYRR	MHFERR
RLDIGCYR	NHMFEY
RLDIGCYRR	NGHFEPTRR
RIGCYR	NMHFEYR
RIGCYRR	ENMHFEYR
RAHRRWLHTKT	EHGEFIYT
KIRAHRR	REHFEIY
KIRAHRIRW	REMFEIYP
KIRAHRIRW	REMFSEIYP
RIRAHRIRW	EMFEIYP
IGCYRR	NMHFERYR
RIGCYR	NMHFERY
IY	MEFAPT
RICYR	NMER
RLGCYRR	EMFAPEGY
RLGCYRR	EMHFERY
RLLGCYR	EHMFAER
RLLGCYR	EHMFER
RLLGCYRR	EHMFERYR
RLGCYRR	ETMHFAERY
RIGCYRR	NHFEY
RDIGCYRRL	NMFERR
RLDIGCYR	NHMFERR
RIKSHRLR	DKMFEMY
KRDLGCYRLRRR	ETDMFEGPTRYR
RLDIGCYRLR	NHMFEPTRRY
RLGCYR	EMHFERY
RLIGCYRLR	NHMFERRY
LGCYR	MHFERY
RLGCYRLRRG	EVFMFPERY
RLGCYRLRG	TEFMFPEY
RLGCYRLRRGL	EFMFEPY
RGCYRR	NMFETYR
LGCYRR	EHFERY
LLGCY	HFTMFPE
LDLGCYR	MHEF
DLGCR	VHMEFR
LLGCYRL	HFEY
KRLGYR	EVHMERY
RLDLGCYR	EHTFMFE
RLLCYRLRLP	DEMVGHFERY
LLGCYRR	HFERY
LLGCYR	HFERY
RLKIRSHRIRW	EHRMFEIY
RLDIGCYRRL	NHTMFERR
RLDIGCYR	NHMFEPRR
RLDIGCYRLR	NHMFEGAPTRRY
LGCYRR	MHFERY
RLGCYRR	EMFERY
RLGCYRR	EMFEPY
RLIGCYRLR	NHMFAEGPTRRY
RLIGCYRLR	NHMFEGPTRRY
LGCYRR	MFEY
RLDIGCYRR	NHMFERY
IGCYRR	FHEPRR
GCY	FEPR
RLIGCYRL	NHMFER
RLIGCYRL	NHTMFER
RLIGCYRL	NHYMFER
LIGCYR	HTNMFE
IGCYRLL	TNMHFERY
RIGCYRRL	HFETYR
IGCYRL	MFEY
GCYR	FER
IGCYRR	FHEPTRY
IGCYRR	FEPR
IGCYRL	MFERY
RDIGCYR	NMHFERR
RKIRAHVRY	EEHFSLGTYA
RIGCYR	NMHFE
RIGCYR	NMHFERYR
IGCYRR	MHFERY
RLKIRAHRIRW	HREMFSEIY
IGCYR	MFEPR
IGCYRR	MFEPRR
RLIGCY	NHMFER
IGCYR	MHFER
IGCYRR	MHFEYR
RIGCYR	NMFER
LIGCYRR	HNMFEY
RIGCYRR	NVMFERR
RLIGCYRR	NHTMFER
RLIGCYRLR	NHFERYR
RLIGCYR	NHMFAE
RLIGCYRR	NHMFER
RLIGCYRR	NHMFAEY
LIGCYRR	HNMFERY
RLDIGCYRRL	NHYTMFERR
RDIGCYRR	NHYTMFERR
GCYR	FAE
RIGCYRRGL	NVYITMFEPRRG
RIGCYRRGLG	NVYTMFEAPRRG
RDIGCYRLLG	NVMFERPRG
RDIGCYRL	NMFERG
RLIGCYRLR	NHTMFEPRRY
RLGCYRR	ETMHFERY
RLLGCYRR	EHTMFERY
RLLGCYRR	EHTMFERYR
RIGCYRR	NMHFER
YSNA	IVGKEE
YSRNA	IVGKEE
YRNAA	IVGKEE
YNA	IVGKE
YSNA	IVGKE
YRNA	IVGKE
YSRNAA	IVGKEE
WRK	IVGKEE
YSRN	IVGKEE
YSN	IVGKEE
YA	IVGKE
SALYR	RDDH
AIPYR	RDDH
SAIPYR	RHDD
SIYR	RDDH
IPYR	RHDD
IPYR	RDDH
SIPYR	RDDH
IPYSR	RHDD
SIPYR	RHDD
SAIPYR	RDDH
AIYSR	RDDH
AIPYR	RHDD
SAIYSR	RDDH
AIYR	RDH
AIPYSR	RHDD
IPYR	RHD
AIYR	RDDH
SIYSR	RDDH
SALPYR	RH
LPY	RDDH
SALPYR	RDDH
GSPT	RDG
LPYR	RHDD
IPY	RDDH
ALPYR	RDDH
FR	DDH
TCY	RDDH
LPY	RHDD
IPYSR	RDDH
ALPYR	RHDD
ALFR	RDH
GSKPPT	RDG
QSALPYR	RHD
ADV	FFVD
TLYR	RDDH
IPYR	RDH
IYR	RDDH
ALPFR	RDDH
SAIYR	RDDH
AQR	DVDH
KT	PFILH
KTR	PILHD
KLQS	VANH
KTL	ILD
KLL	FIDL
KT	PIDL
KQTR	PIDL
RKY	NET
KY	VSSGQPI
QRVS	KW
QQPG	REEQ
QQPG	GAEEQ
LYKV	RGR
LYKV	RPGR
LYGKV	RPGRY
LYGKV	RRGY
LYGK	RRG
LYGKV	RRG
LYGK	RGR
LYK	RPGR
KGKF	YLRG
YGKF	LRPGY
LYKV	RPG
LYKV	RGRY
LYK	RGR
KGKF	YLG
GKF	LRGY
KGKF	YLPGR
GKF	LPGRY
KYGKF	YLRPG
KGKF	YLRPG
YGKF	LRGY
GKF	LRPGY
YNRY	KFNS
LYGKV	RGRY
LYGK	RRPG
YKV	RGR
YGKV	RRG
LYGKV	RPGR
LYGKV	RRVGY
LYGKV	RRVPG
YGK	RRG
YGK	RRVG
KYGKF	RLGY
KYGKF	YLPG
YGKI	LRGY
KRR	LRGY
YGKI	LRPGY
YGKI	LG
LYGK	RPGR
HPLYGKVI	RRVPG
KGKF	RLGY
LYKV	RPGRY
LYGKV	RRY
LYGK	RPG
KKF	LRYG
HYGK	RKPGR
KYGKF	YLGR
KYGKF	YLG
YGKF	LGY
YKV	RPGR
LYGKV	RRPG
KYGKF	RYLG
KYGK	YLG
KGK	RLPG
LYGK	RG
GKF	LPGR
KRR	LRG
LYGKV	RRPGY
LYGK	RRVPG
KGKF	RYLG
KKF	RYPG
KYGKF	RYLPG
YGKF	LRIGY
KF	GIRY
KGKF	RYLPG
GKFI	LGRY
KGKF	RLPGY
YGKF	LGRY
YGKF	RLG
GK	LRPG
CHS	KEV
LYGKV	RGY
LYKV	RG
YGKF	LPGRY
LYKV	RPGY
YKV	RPGY
GKF	LGRY
YGKF	LRY
KMEAM	KRGH
DNQSVKG	TVEKKGKY
RLGLL	ALYR
RYLSLL	YRLA
GLL	LAY
RH	CLRD
KDVN	GRME
RDVA	GSPLK
RDVA	NGSPKL
RDVA	NGSPLK
RDVA	KNGSPL
RDVAA	NGSPKLE
KDVNQ	VNGRPMR
KDNQQ	GRMKPEER
KDVNQQ	NGRKPMR
KDNQ	NGRPMER
SRDPAQ	KNGPLQE
TKDVNQQ	GNRKPMIE
KD	RGCP
RE	NGTKP
KDVS	KNGVPQ
KDVNQ	NGRPKMR
KD	GRP
KDVNQ	KNGRPMR
KDVNQ	NGRPKMER
RDVAA	NGSPLE
KDVNQQ	RGPMEE
RDVA	NGSPL
KDVA	SPM
DVN	AFIL
TVKIQHA	QGRE
YDPGD	RPI
KDVN	AKFIL
KDVD	GKNLK
RDVPAQ	NGSLKPQ
RDVP	NGSPLK
KDVA	NGSPMK
KDVA	NGSPKM
PLSYE	FRVK
QKLTER	RRLT
RRR	VGSY
MEELYKI	NYLWGFL
MEELYVKNRIK	NYLWLGFGN
YIKSRL	YLWLGY
MEELYVKIK	NYLWGFLN
QYG	KNRLNK
QFGG	QIRK
QFGGG	QIK
QFGGG	QIRK
FGGG	QIRK
HFGGK	QVK
QYG	QRIN
FS	QIIG
FGG	QIT
QFG	QIR
QFGG	QRIK
QFGGG	QRIK
QFG	KQRI
QYGGK	KNRLNK
FS	QII
YFGS	QRI
YKRYIPE	KEERKIT
HFGGGK	QINR
QYGK	QRINK
QFGGGK	KQI
RD	SERE
DSR	RCEE
DSRQ	RCEE
PKY	DRS
PKY	DKRS
PY	DKRS
PKLY	DCS
PKY	DRSR
PKY	DCS
NVKGI	VDVSP
ENDI	DAVV
RVD	SDKVAG
PGT	PGT
HDMVR	RMVHD
NQSW	RHS
VEGE	DREDAH
LQE	ETQE
LPI	ILP
QKSDK	EQARS
PQ	RALGA
LQA	NLKQ
NLKQ	LQA
RASS	RSS
RSS	RSS
RSS	RASS
YGN	GKL
INY	VLHM
WSRP	SRWP
LHIRK	DTD
TDD	LHIRK
RDELSLNE	LNESELRD
RDELSLNE	LNESDELR
RDELSLNE	LSNEDELR
TTT	GEI
PDD	DGPD
EIQP	QSKEL
R	DDTWG
NK	KDEQ
QEK	KTMR
HAGE	PSE
KH	EEITE
HPVVTI	TIVVHP
LVI	RHL
LGF	GLRRD
GF	GLRRD
LYDIL	AKRK
LYDIL	AKRSK
NLVV	QTY
SYFVWLLGET	MSLVNLRYR
LTK	RSGK
YSGSVA	IFKKP
KDDVD	DRDL
NRR	PQLV
CDRVNFYEARVTI	IRVTAEYNRDVC
CDRVNYEARVTI	TIRVAEYNRDVC
DRVNFYEARVTI	RVTIAEYNRDVC
NFYT	RYAV
AVIDSDITEA	ATEKIDIDSAV
DCQN	QNDC
NFNVSQL	NVNFSQL
DQR	KDVQ
GDCN	CNGD
NEN	DVQR
AQVK	KAQV
DAKQVK	ADQKKV
ERRR	QDE
QNS	SNNN
NSF	NKKE
VDNSF	KRNKE
VDNS	KRNK
TTNS	NRK
DNS	RKSNK
DNSF	QRNKK
TTDNS	NR
TDN	NKRK
VDNSF	KRNK
FTTDN	NKRK
DNS	QRKNK
VDNSF	KRKQN
HLEE	EHRR
HLEE	EHRDR
NGDTP	DMV
NDQQ	QS
MGHL	PVD
RKG	GKR
NDR	EEKG
HLE	DDYS
FYSGDV	RLRSA
SARRL	SGDVYF
KDYS	AL
FAYSGDV	RLRSA
DAK	NDGA
LEGMDL	DLMLEG
LVDQFQILDR	LVMEDSHADVDD
RKG	GAK
KEKQG	KDN
HVVQNVRLVSARA	EHPFAVILNSELHGA
HVQLVRLVSARA	EHPFAVILHLGAQD
HVQLVLVARA	EHPFAVIELHLAQD
HVMQLVRLVSARA	EHPFAVISELHLAQD
HVMQLVRLVSARA	EHPFAVIELHLAQD
HVQLVRLVARA	EHPFAVISELHLAQDS
HVVQNVLVSARA	EHPFAIVSELLHGAQDS
DH	VGTI
REH	ENGH
LAVLVN	LNGAD
AVELVN	LKNGAD
LFGH	KQ
MANG	KH
ERILAN	GHQEFY
EILN	GEHQFY
KY	NQGA
GKYEI	KEYI
GKYEI	KEYKI
GYEI	KYEI
LQNN	RGHN
KH	RSGP
LPC	LPC
DDGKR	GKLLRE
KAMEGLGTDD	LEGGTDE
FQRE	TR
FRR	GPSFL
LQRIQNMER	LQIRQAANVMQ
QL	KEKI
DEFS	QQQ
MVD	MV
MVDD	MV
MV	MVD
KVLGLLIQL	KHFLIL
KLGLLIQL	KHFLIL
MV	MVDD
ATD	ERP
MV	SECN
PEP	TAD
ATD	EPP
REP	TAD
RPEP	TAD
ATD	ERPP
AQYTD	LTRFD
AQYTD	LTRFDH
PACSILTAQ	RFTHHSEK
PACSILTAQY	RFTHHSE
LNRA	IINT
NITI	RNAL
TNRA	IIN
TNRA	IINT
TLNRA	IINT
DQL	RWR
DNRME	QTPE
QEKR	NQR
QPKR	YQQ
QEKRM	HQRN
QEKR	HQR
QPKR	YCQQ
QPEKR	YQQ
EHPTW	FGVRL
QPEKR	YQHQ
IKNH	HLIKN
RNYFYH	RDSPGRP
RNYFYH	RDSGRKP
SERGLD	RNYKLR
ASYLLQVLKENLRELNSHLLEA	YASLLVKQLNRELLENLEHLM
KFD	EHP
VKDVL	VVLDK
LRK	NQL
LLLEEELVELVDNNAADLAQEALEHYDYLKQQLLQLVQLA	AQRLRVQQLELQQLLYKHEYLQEALAQDANANEVLDLREVLELE
LRELLEELVELVDNLAADLAQEALQEHYDYLKQQLLQLVEQLARQR	AQRQLRVLELQQQLLYKDHEYLEAALQADLAVNLDLEREVLELELE
SLLLAEERLIELVENRVANLVQEALEEYQEYFKQQLDELVQMAQQL	LAQMQVQLELQDFQYYEEQLVEALQVNRAVNLELEEILELALES
DGE	RPG
SFTDKMKELQ	MKEVLFSLKTI
QPA	CVSLK
GTQPA	PCVLAKE
AKEPC	AP
KFYFL	EFLY
ELGTQ	EPCVSKA
TQAT	EPCAKV
QPA	VESKE
AKE	TQPA
TQPA	PCA
QPA	AKE
QPA	AKECVE
ELGTQ	EPCAK
GTQAT	EKPA
LQPA	PESK
EVSFQVTYGKLMVPEEASYKSKQLPLKTEYF	PCEVSFQTVGMYLVKPELQKFAEAYSEKLQLIKALLF
EVSFQVTGKLMVPEEASYKSKQLPLKTEYF	PCEVSFQTVGMYLVKPELQKFAEAYSEKKLQLIKALLF
KLEFTLKEL	KLVWT
FLVAQMLLKKVV	VGATGVMLAFQNR
FLVAQMLLKKVV	VGATGVLAFMQNRR
FLVAML	VGATFV
FLVAML	VGAGTVLAF
FLVLAMLLKQVA	VGATGVLAFMRRNQV
FLVLAQMLLKQKVA	VGAGTVLAFMRNRDVP
FLVLAMLLKQKE	VGATGVLAFMRNRD
VMIIVMLQLMIKQ	VLVTLLGYAAQRK
VMIIMQLIKQEA	VTLLGYAQKPNL
VMIIVMQLIKQEA	VVTLLGYAQKPNEL
PILFVLQVVLKK	IVGIATMFLSWGRS
MLLL	LTIAVW
MLL	LTIAV
MLLL	LTAV
KNKN	QDK
HFGY	NE
RPTGR	ENATPL
PTGR	ATPL
ANGR	NATPLE
PTGR	NATPL
PTG	NATPL
PTGR	ATPLE
PTGR	APTL
PCGID	GIDKPC
PCGIDK	GIDPC
HD	VSDA
PGN	YRGC
KGRH	HKGR
DRWR	HERE
ERE	WRG
GRGV	VGRG
EMSVNS	SVNSMEG
KEGR	QP
RDRERSV	DRRESVR
ENGRSQ	QRSNGEE
EENGRSQ	QRSNGEE
ALPSPV	DLR
RNGRQIQDKPSP	ELDELRS
AKG	LNAER
VT	VGTV
VGTV	VGT
AVGT	VTV
VGT	VGTV
VTV	VGT
FSGEAVF	FSGAL
FM	GAAL
GAAL	FM
FSGAL	FSGEAVF
AWGGS	TLNM
YNAL	HSDA
RYTLQ	QTLRY
RYTLQ	QLRYT
AEHIRQ	RHWYIQ
TKPTI	PKTV
KER	EKR
QDLPNA	RD
KQDLPNA	RD
DHR	RERKE
KN	GERG
IDAP	HK
IDAPA	HPKS
QLAAH	VFTD
QLAAH	YIVFTD
KRSSLGCHLD	DNDLYRNVPK
VPKDDLYNNR	HLDSKRSLGC
RENS	NSRE
RENS	RNSRE
RDA	RQT
SQTV	TSQV
SQTV	TASQV
KHLVKVPTNGSY	GYPTNVKVHLK
KLVKVGY	GYPVVKK
TSN	NNG
QR	HALN
QR	AALN
NAGA	LGELLV
NEQQ	EQNQ
KVDAGE	TKSTD
EVK	TTQS
GNE	GEN
SEE	ENN
QLSSP	GQPA
VQS	QSS
QSS	PVQS
KGD	HKGD
TED	VRP
NEDQ	HKS
NNE	ESE
DAG	DAG
QS	PAVQ
LLSSP	QKE
HAH	EENS
HAH	ENS
SFYITHN	PEILHV
KMGS	QE
QWR	QMPQT
TR	QEK
YQQ	ANRQ
TQISGKHK	KHKSGITQ
KEE	KEK
NQKLEQSEKQKEQELE	QEAVAKGAKLLHNKEIQEAK
NKQKLEEQSEQKQLE	QEAVAGAKLLHNIQAQEAK
RVTD	QE
TLR	ADLS
WSQQCKQT	QQTCKQS
SQQCKQT	QTKCQQS
WSQQCKQT	QQTKCQS
TGMN	QK
ETQ	NTGM
NFL	NFL
PAHNDK	WAQND
PAHNDK	WAQNDSI
PAHNDK	WAQNDI
QEISD	SH
QISD	SSH
GGTN	RDQ
PRVTRFN	YTLGRQK
PRVTRFH	YTLGRQK
NPRVTRFH	YTLGRRQK
PRVTRF	YTLGRQ
PRVTRFH	YTLGRKQR
PRVTRFH	YTLGRK
PRVTRFH	YTLRGQK
KPRVTRFA	YTLGRRQK
PRVTRF	YTLQGRR
PRVTRFH	YTLGRQKR
PRVTRN	YTLPRK
NND	NND
HSSL	VWGEGY
HSSL	VGWEGY
QTH	ADTSD
QTH	ADSD
WNESY	YSNEW
HSL	GVY
ESSK	ESKDS
QNK	GPE
AKTEMKASDL	TEAKADSKM
SS	EAE
DKNR	KSE
VIY	IPP
NAVD	IKHG
NAVD	KHG
AV	NAV
FEAR	REV
KAGG	KGGA
LALD	ER
LAED	ER
SAALST	RSLDAEL
LFAESGR	AEQWLFSR
AAGT	YY
ERDY	ESSR
SSER	REDY
SERD	RESS
LGQYV	YQGLV
DRKVLE	KVLERD
NEKE	ENKE
TTNEKE	TTENKE
PREK	KQ
PRE	KGQ
TNEKE	TENKE
TLKS	HYI
TKSD	YHI
QTLKSD	YHPI
RDF	QDV
KGKD	ATPSK
KGD	NSA
RRAH	EDTD
ERRL	RADEE
LPAP	PEHDY
KESGA	ERAPRP
EIAL	GIPSAAGR
ESGA	REAPRP
EEIAL	VGIPSAAGR
EGNA	EAPRP
ESGAA	REAPPR
EEIGAL	VGIPSAGR
EAGA	REAPPR
EAGA	REAPPRR
QEAGA	ERAPRP
QEGA	ERAPPR
DGS	REAPP
DGSS	EAPRRP
DGS	EAPRP
KESGA	ERPPR
EGA	REAPRP
EIAL	VSAMG
ESGA	REAPP
EEIGAL	AVGIPSAGR
ESGAA	REAPPRR
EEIAL	AVGIPSAGR
EEIAL	AVGIPSGR
ESGAA	REAPRP
EEIGAL	VGPSAIAGR
IGAL	SAIPGR
ESGA	REAPR
EEIGA	AVGIPS
IGA	IPSA
DTGS	REAPP
DTG	REAP
EIGA	VIPSA
KESGAA	ERAPRP
EEIGAL	VGIPSAAGR
EEIGAL	AVGIPSGR
ELIIAL	EPGRAR
EEIAL	VGIPSAGR
ESGA	REAPPRR
EIAL	VIPSAAGR
KESGA	ERAPP
EEIGA	VGPSAI
KEGA	ERAPP
KESGAA	ERAPPRR
DTGS	REAPRP
EIGA	VPSAI
DGSS	REAPR
EIGA	VGIPS
EIA	AVGPSM
EIA	AVGMPS
EEIA	AVGPSM
EIA	AVGPM
ELIS	EAGRPR
DGS	REAPRP
DTG	REAYP
EIGA	AVPSIR
EIGA	AFGIPS
ELIIGA	EPGRAR
IGA	ISAP
DITGSS	GREAYPPRR
EGAA	REAPRP
EEIGAL	AVGPSIAGR
KESG	ERAP
EIGA	AVIPS
KTIVRK	RAFD
SWDY	PQR
GKFE	RNS
GKE	RNS
FLVTFKETGDAV	VKVIKITTSGS
FLVTFKEVPTFGD	KVVIKTIGTSS
FLVTFKETFGD	VKVIKIGTSS
FLVTFKEVGTFGDA	VVKKIITSGS
RSVT	TTF
RRKSNI	DASAVF
NKNEMK	EREG
NAKNEMK	EREGK
GTP	SILGAL
NIAG	LFM
GTP	SIL
AGTLLLI	FPILAFL
PAGTLLLIL	FPIMLALAFL
PAGTLLLI	FPIMLALFL
AGTLLLIL	FPILALAFL
PAGTLLL	FPIMLLAAF
FLIF	AESL
LIL	AEAI
SSKSLRGNYALIL	TFGDMGVLF
LPHSF	KYSEYVIT
ELGY	AQELK
AEMGY	RAQL
ELGY	RQEL
LGY	AQLEK
AKGIY	AQEKL
AKGIY	AQEL
FSKGF	RQSEL
ELGY	AQL
ELGY	AQEL
ELGIY	AQL
ELGY	AQLK
LGY	AQL
LGY	AQEL
ELGY	RAQEL
ELGY	RAQLK
SEL	LAQ
LGY	QAKL
QSLG	AQRET
ELG	ARLQ
AELY	KLARQ
AELGY	KARQL
PPGAR	MDA
PGA	MA
PPGA	MA
PPGA	MDA
PGA	MDA
PPGN	MA
PPGN	MG
PTIER	FGV
NDPE	GFEV
PTIE	EEF
PTIEL	FEV
PTIL	FEQ
PTIEL	FV
ER	KLE
RGIE	GRPSG
GIE	RGPS
EEG	STI
TG	RARS
TGA	ARS
QEFERTG	RS
QEVAFD	RQAEREA
EAFDDT	GRDAKQ
AAFQFLDT	KADFTRQ
AAFQFLDST	KADFTRQ
DLE	TVC
DL	PCTV
DLET	CTV
GET	KVVS
E	KMAAS
TVEF	KEI
TVEF	KIE
TVEF	KIEI
RILNTIRNSEELRGKAIEQLEKARARLKKVEMDADQFRGYIEEKMLITYLFEKNTIEAVRVFQALA	DRILSKQVKSGDTSSVEKQLEEQANAVMRAARIESLAMKKETEVELKRIGKELEQALLKIILQSASDIVV
AILAVA	GD
NRQFL	LQIE
LDIVLP	QE
AAGAVLASIGPGVGQTAAQAGIRQAEGKIRGTLLSAFMALTYGVAAL	IALGAVGLIASGPGVGQGTGAQEVAIQPEGKGARITLLAFEALTILVAL
AALAGPGQTAQGQAILL	IGLGLIGVSGTGAEVA
AAVLASGPGQTAQAGIAKTLSFMALTYGVAL	IGLGLISGVQGTGAVEAPEGRLLALMEAITLVAL
AAAVGLASIGPGVGQTAQAG	IALAVGLIGSGVGQGTGAQVEA
AAVGLASIGPGVGQTAAQAEGIRQA	IALAVGLISGPGVGGTGQAVEGAR
IGATVAGAGTGII	IGAAGGSGITVLS
GLAGMGAGVVN	LGVCAAMMGNAGA
GLAGMGAGVVN	GVCAAMMGNAGA
GLAGGAGVVN	GVCAAMMGNGA
GLAGGAGVVN	GVCAAMGNGA
GLAGGAGVVN	GVCAAMMGNAGA
GALAGTA	VGGLAGV
GAGQAGA	LGVARI
GALAGA	VGGLVAGVA
GLALAGARI	VGLGLAGVAA
GLALAGVARI	VGLGVALGVAAG
GLALAGTARI	VGLGLAGVAAG
GLALAGTVARI	VGLGVALGVAQGA
GVARI	GAQAG
GLALAGTARI	VGGLAVGAA
GLALAGTVARI	GLGVALGVAQAG
MALAGTAIG	VLGLLGVAAA
GAGVAGA	LGVARI
GLALAGTA	VGGVLAGVA
GLALAGTARI	VGLGALGVAAG
GLALAGTARI	VGLGVALGVQAAG
GMAVLAGAI	VGLGLVGA
GMLALAGTVARIA	VGLGVALGVAQGAV
GLALAGTARI	VGLGLAVGAA
LGVARI	GAQGA
GALAGTARIA	VGGLAVGAA
GLALAGTARI	GGVALGVAAG
ALAGTAI	GLLAGVRAA
AAITILTGIAAN	AIGIGGAGIVA
GIAGGAGIVAN	AIITTLGIAANS
AITILTGIAAN	IGIAGGAGIVA
ALGVVAWFSIG	GSSLAAAVIAG
GAAMLSGAGKSG	LGLGCLGYGDR
GSAFTGAYGKSICP	LGLGGLVGFGIDGRS
LGSLSAAA	IAILISAYA
GSAFTGAYGKSGT	LGLGLGGFGIDGVR
GSAAAIVAGG	IAILAYSAVCG
GSAFTGAYGKSGIT	LGLGGLVGFGIDGVR
GSLSAAAIVAGL	AILIAYSAVACC
GSAFTGAYGKSG	LGLGVGLGFGIDGR
GSLSAAAIVGG	IAILISAYAVGC
GSAFTGAYGKSG	LGLGGLVGFGIDGR
GSLSAAAVAG	ASILSAYAACV
GSAFTGAGKSG	LGLGVGLGFGDGR
GSLSAAAV	IAILISAA
GSAFTGAGKSG	LGLGVLGGFGDR
GSLSAAAIVG	IAILISAAVC
GAAMLSGAGKSG	LGLGCLVGYGDGR
GSAFTGAYGKSVICP	LGLGGLVGFGIDGVRS
LGSLSAAAV	IASILIAYSA
GSAFTGAYGKSGT	LGLGGLVGFGIDGVRS
GSLSAAAIAG	IAILSAYAVC
GSAFTGAYGKSGIT	LGLGVGLGFGIDGVR
GSLAAAIVAQ	IAILAYSAVAV
GSAFTGAGKSG	LGLGLVGGFIGDGR
GSLSAAAIVAGG	IAILISAYAVCG
GSAFTGAYGKSG	LGLGLGGFGID
GSLSAAAG	IAILSAYAACV
GSAFTGAGKSG	LGLGVGLGFIGDGR
GSLSAAAVG	IAILISAAC
GAALSGAGKSG	LGLGLCGYGDGR
GSAFTGAGKSVICA	LGLGLGGFGDGRVS
GSLSAAA	AILISAYA
GSAFTGAGKS	LGLGLGGFGD
GSLSAAAIVAG	IAILAYSAVAC
GSLSAAAIVAGL	IAILIAYSAVACVC
GSLSAAAIVAGG	AILISAYAVCAG
GSAFTGAGKSGR	LGLGLVGLGFGDRS
GSLAA	AILAYA
GSAFTGAGKSG	LGLGVLGGFIGDGR
GSAFTGAGKSG	LGLGVLGGFGDGR
GSLSAAAIVAGG	IAILIAYSAVCAGV
GALAGARI	VGGLAGVAA
VGLGALGVAGA	GMALLAGTARI
GLALAGTVARI	VGLGLAGVAAG
GMALAGTARI	VGLGLAGVAA
GLALAGTVARI	VGGLAGVAQAG
GALAGVARI	VGGLGVAAG
GLALAGTVARI	VGLGLAGVAQAG
GMALAGVARI	VGLGLAGVAAG
GALAGVARI	VGGLAGVAQAG
GALAGARI	VGGLAGVAAG
GLALAGARI	VGGALGVAAG
LAGAI	LGAGVA
GLALAGARI	VGLGLAGVAAG
GLALAGVARI	GGALGVAQ
GLALAGTVARIA	VGLGVALGVAQAG
LAGVARI	LGAGVAQAG
GMLALAGARI	VGLGLLAGVAAG
GLALAGTARI	VGLGLVAGVAA
LAGTVAI	GLAGVA
GMALAGARI	VGLGLAGVAAG
ALAGARIA	GGLAGVAA
GLGVA	ALGAI
GALAGTAI	VGLGLAGVA
GMLALAGARI	VGLGLGVAA
GARI	VGAAG
LAGARI	LGAGVAAG
GLALAGVARI	GLGVLAGVAQA
GLAGTVARI	GGLAGVAQA
GLALAGTARIA	GLGVLAGVAAG
IGATVAGAGTGIIA	IGAAGAGSGITVLSG
RN	AFG
RNPS	AHV
SRNPAL	VHTGLNA
SRNPA	HLGEN
SRNP	ELAG
SRN	VHLAN
RNP	MGVE
SRN	VLHAN
RNP	MGE
RQPDL	AHGP
ARQ	EEG
RQPD	LGE
ARQ	GEE
RQPD	AGHP
RQPD	GL
RNPS	NHVVLA
ARQPEA	AGNHTLP
RQ	APTNH
SRNPSI	VHLNA
SR	RISG
ARNPS	VLH
SRNP	VHTN
SRNP	HVNGL
SR	RAKSG
AEDR	TG
AGVG	LVR
GAE	RRGT
AGA	VQ
ED	GGRF
SGA	GVVG
SSGA	VGG
IGAG	QQT
DA	NGG
IGIG	TQQF
AGAE	ARV
VLR	VNY
AR	QDSS
RQ	NIGKY
VAVL	IYLHF
RGSQ	DQSSYH
RTIK	GDME
RK	PGDEE
ELVK	EGMEE
ELIVK	RRGVR
YERTIN	RRGGVR
RKV	MPGEE
YERTIN	RRGGVPR
ERTIK	DEGMEE
ELV	EGMEE
EVLIVK	RVR
YERT	RRGPGV
QRFKK	EAEMEE
QERRI	EGPSEM
DRYK	QADMPG
LERLV	RRPGV
LERK	DQGPAGGE
RYK	ADQMP
DEFLKQ	QGMPAGE
LERLV	RGRGV
ERLV	RRPGGV
EELERLKV	QGMPAG
RIK	PGEE
EVLIVK	RVRR
ERVIK	DEGMPGEE
ELV	EGME
YYERT	RRGGVP
QERTKK	EGMPEE
QRERR	EGPASEE
QREFRR	EGMPASEE
AEI	GFLA
KELKR	FDLQAFE
LAIA	QF
DYQA	FASQ
DQA	FASQ
DYQA	FASDQ
DYQA	FSDQ
RL	GYAL
TNAF	NAT
MNTFP	EVKRLVR
DKEYTKPVDAEYDLLLKMYGDMNTFNFTFED	VWVRMEHKQMMVYSNDRHVRVRT
NTF	LFD
NTFFFD	LFDKFLVK
FNFTD	EDTAK
FPNFTD	EVDKA
NTFFFD	KLFKFLVK
RFTIYFGVYMSASFDRN	QFPSLIIFLMTFFVPY
RFTPIYFGVYMSA	QFPSLIIFLMT
RFTPIYFGVYMSA	QFPSLIIFLTMF
RFTPIYFGVYMSA	QFPSLIIFLTFM
RFPTPIYFGVYMSA	QFPSLIIFLM
FPT	VEV
FPT	VEKV
LVII	IIVL
LVI	VIL
DVSSY	SSYDAP
KDENA	QR
ERAW	PFTR
KAWV	LT
TRWV	NGF
VHKL	TSYR
KLWLR	EFRTKA
MRRH	PRTS
PWEGDD	DQ
PWEG	DQT
LFD	VGPVR
QGSN	NSGQ
NRI	TSNEI
SNT	IN
NESTIKE	TTSNEI
WEK	KAE
RF	QDNGD
QPVKDY	QPVYDK
KPDFDKK	EPTLES
PSVPCC	SVVGPC
QEHY	GSDSVEI
QKDD	PNNEER
IHPLD	PDLIH
ICPLD	PLCIH
ELQGVTLRQ	LQRFYLHE
VAVFED	FTLRR
VAVFE	FTLR
YFTRLREARN	REARNKEQQN
RHL	SR
QTI	DNRET
GAPD	PDIN
LDIVQ	ANDQ
STHK	QRN
RNQI	KSTH
MLLSGTIKRNA	TLAAGRFEVEW
TLAAGEVEWF	MLSLKGTRIN
TLAGEVEWF	MLSLKGTRIN
MLLSKGTIRN	TLAAGFEVEW
TLAAGEVEWF	MLFSLKGTRIN
KEVEAK	EAEEAK
EAENQ	RRTGRNPI
EETNQEVSI	RRRPQMSVF
RRD	TRD
MALGSM	MTLFI
GMALS	MTLFI
MMGSA	MTFI
MALGS	TFI
PYQ	NCR
YEPYQ	RNC
YYERPYQ	RPN
REDAGED	ERRE
ERR	DDAGEE
RMHSEQR	SEQRHRM
AGEDD	RE
EAGEDD	RRE
RMHEQR	SEQRHRM
AEGEDD	RRE
ER	DDAGE
QAS	LKY
QSG	LKY
QSG	LK
NEFLV	NEVF
NEFV	NEVFL
NEFV	NEVF
KLVGYVLGD	GDYVLGLVK
LKVGYVLGD	YVLGLVK
KTKGG	TKKG
REAR	GFLL
RLR	SSKP
QRRT	NTLN
RQTR	LNTLN
RQRT	LNTLN
RQR	LNTLN
PVLFVT	FQVTVLP
HQSE	QSEH
LSDEVMKQLASSLTKQ	QKLRTSLSAQVMMKELSD
LSEVMKQLASSLTKQ	QKLRTSLSAQVMKELS
NKELLDLKLKETLKAVQMRSLTYELLH	LENLKDLLKELTKKLAEQVMRLTEYLLH
NKLELLDLKLKETLKAEVRQMLTYELLH	ENLKDLLKELTKKLAQVMRSLTEYLLH
DPLNGERSA	LDPANRSGE
DPLGERA	LDPANRSGE
RTG	PG
DGCN	ER
DNGC	ER
RLRRSD	LRRRSD
ING	GIN
GMKTAR	KTINQE
KGMTAR	KTINQE
INKTEK	TAGMRK
GMTAR	TINQE
KGMTAQR	KTINQE
KGMTAR	KKTINQE
INQTE	TAGMR
GMKTAR	KTINE
DRG	HETAF
DVG	WKQ
RRYDSET	DRRYDSET
NHAT	NHTA
YQENQRE	YQEQNER
KLD	DGVN
DGVH	NHETAF
RLRY	ELR
RRDRQD	RQDDFRY
RYFRDQD	RQDDRRY
RDSD	ERGWR
VGRD	VKQ
KQRV	VDGVR
QGR	TGSQR
YFIEWILPEAIQRGDN	RILNELMIVVRVDMSDNWGRAYF
FRILVPVEAMRGDN	VSLTFPNINISDNWGRLII
RE	QRNET
FIRWLIEAIQRNGD	MIINEFDIIDTDTGRSIF
RQDLAYE	SEKNLSY
KPA	KSN
SGDQEE	GEQEK
RRRQ	EPDSE
GQEKER	SVGDEQE
QDKP	RRQ
KNQN	NQNI
QLKL	EM
KNLLDD	DKLL
DLKLD	KLLD
LKLD	DKLLDN
YAK	RRREIE
KATKNF	MDDGTV
TNRLLCG	AENPTLNKREF
GS	DCGSK
FFLV	FAEDIIL
GSN	DCGS
HHQEKLVFFAEDVGSNKGAIIGLMVGGVVIA	HHQKLVFFAEDVGSNKGAIIGLMVGGVVIA
IVGG	GVI
IVG	GGVI
EGYVHHQKLVFFAEDSNKGAIIGLMVGGVV	GYEVHHQKLVFFAEDSNKGAIIGLMVGGV
MGIIG	IIGMG
GYEVHHQKLVFFAEDVGKGAIIGLMVGGVV	GYEVHHQKLVFFAEDVSGAIIGLMVGGVV
VILK	LFAED
GYEVHHQKLVFFAENKGSAIIGLMVGGVV	YEVHHQKLVFFAEDVKAIIGLMVGGV
VILKNG	LFDVSN
VILK	LFEDVGSN
MGIIGG	IIGMGV
GMGIIGGKSN	NIIGMGGVV
EVHHQKLVFFAEDVSNKGAIIGLMVGGVV	EVHHQKLVFFAEDGSNKGAIIGLMVGGV
LVKA	FDV
EVHHQKLVFFAEDVGSAKGIIGLMVGGV	EVHHQKLVFFAEDVGSNKGAIIGLMVGGV
VLVIK	QFADS
ILVK	FAD
EVHHQKLVFFAEDGSNKGAIIGLMVGV	EVHHQKLVFFAEDVNKGAIIGLMVGG
EDFL	KILV
MGLGII	IIGLMG
MGII	IIGLMG
GYEVHHKLVFFAEDVGSNKGAIIGLMVGGVV	GYVHHQKLVFFAEDVGSNKGAIIGLMVGGVV
EDVFL	KILV
MGLGII	IIGLMGV
YVHEHQKLVFFAEDGSVNKGAIIGLMVGGV	YEVHHQKLVFFAEDNKGAIIGLMVGGVV
MIIG	IIGMG
GYEVHHQKLVFFAEDVSAGIIGLMVGGV	YVHHQKLVFFAEDVKAIIGLMVGGVV
DVGFLH	KILVV
MGLIIG	IIGMG
GVEHHQKLVFFAEDVGNGASIKIGLMVGGVV	YEVHHQKLVFFAEDVGSNKAIIGLMVGGVV
MGGIIG	IIGMGG
MGGIIGG	IIGMVG
EVHHQKLVFFAEDGSNKGAIIGLMVGGVV	EVHHQKLVFFAEDVKGAIIGLMVGGV
DVFL	KAILV
YEVHHQKLVFFAEDVSGGAIIGLMVGGVV	YEVHHQKLVFFAEDVGKGAIIGLMVGGVV
VEHHQKLVFFAEDVGSNAKGIIGLMVGGV	EVHHQKLVFFAEDVGSNKGAIIGLMVGGVV
AEDVGNFL	NKILV
AEDF	NKI
HEVHQKLVFFAEDVNKGAIIGLMVGGVV	YEVHHQKLVFFAEDVKGAIIGLMVGGV
DFFL	KAILV
YEVHHQKLVFFAEDVAGGIIGLMVG	EVHHQKLVFFAEDSNKGAIIGLMVG
VVGIL	HQLF
VLV	HHQLF
GVVG	IIG
EVHHQKLVFFAEDVSNKGAIIGLMVGGVV	VHHQKLVFFADVGSNKGAIIGLMVGGVV
VGVIL	HHQLF
YVHHQKLVFFAEGDVSNGAIKIGLMVGVV	YEVHHQKLVFFAEDNKGAIIGLMVGGVV
VVGLI	HQLF
VMVGL	HQLF
VVVGIL	HQLF
VVG	KGI
IGK	GVV
VGVILKA	HHQLFAEVS
VGL	HHQF
VVLIA	HQLFA
VMGL	HQF
VVGIL	HHQLF
MGLV	QLF
VVVILGA	HQLFD
MVGL	QLF
VVVGLIG	HQLFD
VHHQKLVFFAEDGSNKGAIIGLMVGVV	VHHQKLVFFAEDVNKGAIIGLMVGGVV
AFQLHH	AILVGV
GYEVHHQKLVFFAEDVKGSNGAIIGLMVGGVV	GYEVHHQKLVFFAEDVGSNKGAIIGLMVGGVV
GYEVHHQKLVFFAEDVGSNKGAIIGLMVGGVV	GEVHHQKLVFFAEDVGSNKGAIIGLMVGGVV
FLQH	ILVGV
IGA	GVV
VHEHQKLVFFAEDVGSGAIIGLMVGVGV	EVHHQKLVFFAEDVGSNAIIGLMVGGVV
FLQHH	ILVGV
GEVHHQKLVFFAEDVNGAIIGLMVGVV	YVHHQKLVFFADVGSNKGAIIGLMVVV
YEVHHQKLVFFAEKDVSGAIIGLMVGGVV	GYEVHHQKLVFFAEDSNKGAIIGLMVGGVV
AEFQLH	GAIVGV
YEVHHKLVFFAEDVGSNKGAIIGLMVGGVV	GYEVHHQKLVFFAEDVGSNKGAIIGLMVGGVV
GYEVHHQKLVFFAEDVGSNKGAIIGLMVGVV	YEVHHQKLVFFAEDVGSNKAIIGLMVGGVV
GYEVHHQKLVFFAEDVGSGAIIGLMVGGVV	YEVHHQKLVFFAEDVGSNAIIGLMVGGVV
DFQLH	NAILVGV
IKGA	GVV
GEVHHQKLVFFAEDVKGAIIGLMVGGVV	YEVHHQKLVFFADVSNKGAIIGLMVGGVV
GYEVHHQKLVFFAEVGKSNGDAIIGLMVGGVV	GYEVHHQKLVFFAEDVSNKGAIIGLMVGGVV
GYEVHHQKLVFFAEDVGKSNGAIIGLMVGVV	GYEVHHQKLVFFAEDSNKGAIIGLMVGGVV
EVHHQKLVFFAEVGDSNKGAIIGLMVGVV	EVHHQKLVFFADVNGAIIGLMVGGVV
YVEHHQKLVFFAEVDGSGAIIGLMVGGVV	YEVHHQKLVFFAEDVSNKGAIIGLMVGGVV
FLQHH	ILVGVV
EVHHQKLVFFAEDAGKIIGLMVGGVV	GYEVHHQKLVFFAEDVGSNKGAIIGLMVGGVV
IMGVIA	IMGVIA
IMGVA	IMGVA
VGV	KGAI
QKLVFFAENAVGSNKGIIGLMVGGVV	QKLVFFAENVGSNKGAIIGLMVGGVV
VGV	KGI
EVHHQKLVFFAEDVGSNKGAIIGLMVVGGVIA	EVHHQKLVFFAEDVGSNKGAIIGLMVGGVVIA
QKYPT	PDE
PDE	QKYPT
PDE	QKPT
PDE	QKYPTD
TDAR	QWEAR
TDAR	QWAR
ER	RPEE
GGPGGLA	LGGPGGA
ERPFSVLIK	KILESFRPE
ADPGFA	AGFPAD
ADPAGF	AGFPAD
DPAGFA	KAGFPAD
GGGPGLA	LGGPGGA
TQKQ	EK
ETAR	IPGDPR
IDPRP	ETRA
QAQAQG	SYRAEE
RS	SGDT
ERPFSELIK	KILESFRPE
ERPFSELVK	KVLESFRPE
PADFA	AFPAD
ADPFA	AFPAD
IQPVQ	SDIRSI
ADPFAG	AGFPAD
ADPFA	AGFPAD
ADPGFA	AFPAD
PADAGF	AGFPAD
APFAG	AFPAD
NDE	NDE
KDL	SGI
KDLF	SGIP
KSLTVLVLENMDSLEALLVVM	ELVVYLKVLRNKLQRLEVVLM
ITGADWH	DHWAIT
ITGADWH	DHWAITG
MIAKD	DKAMI
MIADK	DKAMI
MMADK	DKAMM
AEAAV	AAVAE
KRNGWN	NRNGWK
KNGWR	NRNGWK
RNGWN	RNGWK
KSD	EPNG
SKKD	PNG
RDSVY	NRV
RYDSVY	ENRVL
IVDLRR	RVTDLIMG
IVDLRR	RRVTDLIG
EDE	QSRE
FTPGR	QRGY
TRFRGAT	SQRGYE
FTPGRRA	QRGY
RRYRDR	YSQRG
ELRER	QKG
ELRER	QKGY
RELYER	SQKG
QHTD	QRG
RLR	SQKY
RWMNSKKR	EGIPDSQDKNHPY
YKVLLKELADFRFYVLQLQAKELNLLAILKLERL	YEVLELLKAFLFRCYVQLQLAEEKLNLLAIKLTRLLE
EVTLKELLFDTFRCYQVLLQAKELLLAKLTRL	VLLLKFLRFYQVLNQLAEKLNLLAQKLTL
EIVTLKELFLFRCYVLLQAKELLLAKQLTRL	VTLRELLKFLRFYQVLNQLAEEKLNLLAQKLTL
QNKGN	GNQKN
DTD	KSGEI
TD	SGEI
LCQVNGIA	QLKAINVGC
LQVLCNGAIKLT	LKADINVGLCLQ
LQVLCNGAILK	LKAINVGLCLQ
LQCIGAINLKD	LKADINIGLCLQ
LSALLQDLVRPQV	PQVRLQLDLAHLS
PGLK	PGKL
GPLK	PGKL
SDE	LEK
ELK	KSDE
EGLKK	KPSD
ELKK	KPSE
KLEA	GEGK
KEGDG	ALEK
SLL	SL
AMHDCK	HFPNFL
IQEPAV	LEKKGLTDWEQKWY
IVLNRRE	MSSFVVSER
IVLNKAE	MSYSTFPER
LVYAL	Y
FEDLYD	HLHKK
FEDLY	HLHK
FEDLD	HLHKK
YSPDGR	ND
RFLFKW	EFEFL
YIFDQ	KLFYE
LFYKK	IFY
KYIF	EKLFY
ERVR	ERGEV
RVEVG	ERV
RQER	EQRER
LQGR	GAY
QAGRL	AY
GE	SVGA
YGNA	YNAN
YNNA	YGAN
AYG	GEL
YA	SQGEL
YAG	SQAGEL
LGE	GAY
FLHSAIGLIIYGRT	FLSHAILGIIGRRL
FLHSAIGLIIYGLRT	FLSHAILGIIGRLT
DKT	SSTG
PKV	VMPTA
KESE	EN
ENK	KESE
LRNK	NKDQT
EIN	KINEA
KVN	NE
DFITDCFQCPA	PQCRCSDMRLNS
FIDTCCVDFCQPA	PPQCRCSDMRLNS
TDFICVDFQCPP	PQCRCSDLRLNS
DITFYDCRQC	PQCQCTDVREKC
ITDCCVDFCQPA	QCRCSDMRLN
DFTNDRCQCGQP	PQCSCEDRINS
FGPSYDCIVRSRRRS	PPTCRCVDEVK
ITDFCCVDFCQPA	QCRCSDMRLN
DITFRYDCCQCP	PQCQCTDVRE
NFIADRC	PQCHC
DFIDDCVQCPA	PQCRCDLRLDS
QYIGNAY	QYIGN
KLGR	EKT
IYV	VIY
IYV	VIYF
IYFV	VIYF
IYFV	VIY
KQTTVGDEITFAGKKT	TITVETIAGKKTFSGDVS
HKTVVGDETIAFGKKTT	NVVETIAGKKTFTGNVE
KHTVVGDETIAFGKKTT	GNVVDETIAGKKTFTGNVE
HKTVVGDEITAFGKKTT	NVVETIAGKKTFTGNVE
ETD	NNN
KITDTRAIHLD	DLIHATRITDK
HHK	KHH
DRKR	DRKR
DKIKTF	PGDAVQS
ESPIASE	PESIAR
K	NARKSP
LK	NARS
LEKNFA	VKYEIRF
KCLKYNY	LKYNKY
RMTYN	TYR
LQHFQ	QLHFQ
QHR	QHR
QN	QDDSE
RDNKSE	RSLNDEK
QHRL	QLHR
HRLQ	QLHR
LKKYN	LKYNKY
YNTIPV	NTYIPV
KTSRY	QEWQD
KTKRSRY	QEWQD
LKCKYN	LKYNK
KLCKYN	CLKYNAK
RNRE	SVDNK
NSE	EMH
SHAGHD	KNRDR
LKKYN	LKYNK
KLKYN	LKYNKY
HQQ	QLHQ
ETKK	KAKDLE
DTRQ	RDTQ
FANTQK	LHQLEY
FQPDL	KTKSKE
RQLL	QLL
QD	FKNP
PELAESLL	ESLRS
FPSH	KLE
DKT	KDT
SRT	EWQD
TSR	EWQD
EAQGKR	PVSLKLK
YIYNP	RVKK
WQSK	VPYK
QAVCN	KIKN
QAVNC	DKIK
QAVCN	DKIK
AAG	FTPVY
RD	AGLKD
VTLLSKEVLIKELNLKAVE	CTVLSLEKVLEEILNKLASEV
DKL	ATC
TAAC	LD
VTLLSKEVLEIKELKLSV	CTVLSLEKVLEEILNLAV
TAC	LDK
DLK	AATC
FGVEAQVTLMLSKEVLINELLKAVE	GFVEQANTVLMSLEKVLEILNKLAV
FEQLAQTLTVCRLCGN	CRGLVCRTHLQLAQFVEA
QGDVEAELVLCAGVACSE	NACGAVCVTLLEEAGDVQ
FVEQLAQTLTRHVALAGR	ARGLVARTHLQLTAQFE
FEQLAQTLTRHVALAGR	ARGLVARTHLQLTAQFVE
HAEFQ	QEATH
RLNLQEEK	NHASAAQKE
FVEQQLAQTLTRVALAGR	ARGLVARTHLQLTAQFVE
QGFDVEAELLVLAAVEGAAE	EAAGAVEAVTLLELEAGVQ
RHQQQEAHALASDAAKQE	QTQQAATHAASAKKEEGTTK
QDKTQQEQHR	RHQQTQKQD
QGFVAEELVATAVEGAA	EAADGAVAVTLLELEAGVQ
FEQLAQTTLARHVLAGER	ARGLVARTHLQLTAQFVE
QTQQAATHAE	RTHQQTQKQDAH
FVEQLAQTLTRHVALAGR	ARGLVARTLQLTAQFVE
QGDVAEELLVATAVEGDAA	EAAGAVAVTLELEAGFDVQ
QGVEAELLVLATAVEGDAAE	EAAGAVAVTLLELEAGFDVQ
FVEQLAQTLTRHVALAGER	ARGLVARTHLQLTAQFVE
EFQLAQTLTRHVALG	RGLVARTHLQLTAQF
EFQQLAQTLTRHVALG	RGLVARTHLQLTAQF
EFQLAQTLTCRHVLCGSR	SCRGLVCRTHLQLTAQFE
QGATCTLQLQTQLSAEAQVCTLQLSVKQQALQIELVRELNLREL	AQTTLQQLTQSLAEQATVLQSLKVQAQQRILEEVLNELLR
QGDVAEELVLCAGVACSE	NACGAVCVTLLEEAGDVQ
SAT	TAS
QQL	QQL
LLNE	HTKFS
HTKF	LKCLN
LQV	LQV
ARTF	TQK
QRVCSS	EDH
EILVRKLKNQLAATLRVQLK	RILEKVLKQNLATALRQVL
ILVLKNQLAARTLVLV	ILVLKQNSLATALRVLV
ERILVKLKNQLAALRVLKV	RILEKVLKQNLATALRQVLKV
KIRLEVLNKKQLARTALVQLKV	CRRRLTLQETQLEEKLEILQEKL
AKIRLVKLNKQLAARTLVQLKV	ACRRRLTDLQETQLEEKLEEILQEKLE
RKACRIRLEVKLNKQLAARTLVKQLV	ACRRRLTLQETQLEEKLEEILQEKL
AKIRLEVKKLNQLAARTLVQLKV	ACRNRRLTLQETQLEEKLEEILQEKL
EAQDDRRAARN	NAARNRDQADQEE
AKIRLEVKLNKQLAARTLVQLKV	ACRRLTLQETQLEEKLEEILQEKLE
ARKACRILEVKLNKQLAARTLVQLKV	AACRRRLTLQETQLEEKLEILQEKLE
IRLEVKKLNQLAARTLVKQLV	RLTLQETLEEKLEILQEKL
IRLEVKKLNQLAARTLVKQLV	LTLQETLEEKLEILQEKLE
IRLEVKLNKQLAARTLVKQLV	LTLQETLEEKLEILQEKL
VYLEVERLNQLILELY	YVLERVLEQNLIELLY
IRLEVKKLNQLAARTLVQL	LTLQETLEEKLEILLEKK
EVLALSNQLVLRVLKLL	RILEVLKQNLATALRQVLKV
KVLVELNRQLILELLS	KYVLERVLEQNLIELLKYH
LYLEVERLKNLELRLQNRELLI	YLLERVLENLERLLQENLRIL
KIRLEVKKLNQLARTALVKQLVK	RRLTDLQETLEEKLQEILLEKLIL
RRRK	DQATDED
DQDDE	RRK
IRLEVKKLNQLARTALVKQLVK	LTLQETLEEKLEILLEKLEIL
ELEHLVKQLHLTTNRELVKLELEL	KHLLEQVLKLHTTENLRKVLEEL
LEHLVQLKHLTNRELVKLEL	HLLEVLKLHTTENLRKVLEEL
RTQLLTEELKELIELLE	KRILEKVLKQNLATANLRV
RRNTQVLTNKEELQVSLE	YQLTECLEKNLKRALAIK
LKEKLIVQLKVELAREYKS	TLQETLEEKLEILLEKLEL
NTQVKLTNEQLVKLS	NTQKVLTENRLQKVLS
NQTVKLTNELQVRKLS	NTQKVLTENLQKVL
NTQVLNTRDLVSRL	NTQKVELTDNDLRRVLS
LEVLLNKLEVKEL	LEKVLLKNLEEVLK
NTQVRKLTNLQVKLS	NTQKVLTENLQKVLS
NTQVRKLTNQELVRLS	NTQKVLTENERLQKVLS
QNTVKLNTELQVKLS	RNTQKVELTENRLQKVL
NTQVLTNELQVRLS	NTQKVLTENLQVLS
QNTVLTNQLVKLS	RNTQKVLTENRLQKVLS
KQLEKELIVKQLVELAREYKKSLA	QKLEEKLIQVLEVLAERYKSLA
KQLEKQLQVLANLLR	QKLEQKLQEVLAENELLR
KELIVKLVELAREYKK	EKLIQVLKEVLAERYKKS
KELIVKQLVELAREYKKS	EKLIQVLKEVLAERYKS
LEKLQVLKVELARYKYK	LEEKLQQVLKEVLARYKKY
ICP	VPCG
EPR	DRCPLP
NHTTKFSI	HTKTFSIC
KWM	KPD
RSTRESRGCAE	AECRSGERSTR
QIKK	ENE
MGE	GR
KYG	TGAR
KY	TGAR
KL	ALDMGG
PK	AMGGT
LSLIEE	Q
Q	LSLIE
LSLIE	Q
ADD	RE
EDD	RE
LDA	RE
EDS	RE
LDE	RE
TPVG	VGTP
PDS	RE
RDS	DETK
RDS	DET
ADE	RE
RSD	YEQI
QDE	RE
PDQ	RE
ADS	RE
DPTD	RE
RLVGIFLFQ	QFLFILVGR
ADDT	RE
TREGLP	HPDV
KRESD	DLDV
REE	GTQ
RREGSA	ADI
REA	SDI
KREGK	DPDVS
REKGRR	LDI
REQP	LDAG
RG	PDVT
DAK	TRPE
REQLSKET	ESQELK
EQLSKE	RESQELK
NYE	LSNN
MSIA	MAG
NYFR	NQETPRT
NFYR	NQETPRT
RYSYTDNAL	TDVIRPF
SEAP	ESAP
KGQ	TSQK
KGKN	EPVI
IIEIFSKFF	FFKIEFII
ALWNR	PQDR
MPD	DMP
IELKQRP	PRLKQEI
HKD	HKD
HDFK	HKD
QDK	QDK
HDK	HKD
HKDFE	HKDE
QGRT	GQ
DKEH	HKDE
DKEH	HKD
KQDT	QDKAD
DQK	QDK
DKH	HKDF
HDK	HKDF
DKH	HKDE
DKQ	QD
DDQ	QDK
HDK	HKDE
KQD	TQDKA
SEYSKKK	KKKYSSE
KNSE	PTQQR
HDR	HDR
KREE	NATDR
TQQRPE	SEKN
RRSGS	HEDR
NES	PTQQR
NESK	PTQQ
HRE	SRRD
REH	SSRR
TELE	PTRTSR
TRTRSP	EELT
TELE	PTRTR
TRTRP	EELT
SRKSC	EEER
SRKSC	EDEER
TELKE	PTRTR
QAE	TNPR
QKEK	YRDEDL
ADYQQR	RQAQDYR
ADYQQRR	RQAQDYR
ATLRDAR	STKGMMAE
ALTRDAR	TLSGNRD
ATLRDR	TLSGNRD
ELQN	NVLAK
SRDGNTL	RDRATL
TLRDAR	TLSNRD
DGNRSTL	RDRATL
SDNRGTL	RDRATL
RSDNLGT	TRDRATL
QNMKN	KNQNM
NGN	NGN
HWLT	LWLTH
LHWT	WLTHI
LHWTI	WLTHI
HWLTI	LWLTHI
HWTI	WLTHI
HLWTIL	LWLTHI
LLLE	VLQAQFR
DREEER	REERE
LLL	LQAQF
LAES	INNAF
SEVDY	KTINNAF
DKG	QL
KDRDL	TLRG
LLETL	TLLEL
TGR	TG
TG	TGR
YRRI	SI
KIE	NHR
HSFEYL	FDLDTKL
HSFGEY	FDLDKL
HSFGEL	FDLDKL
HSFE	FDLDKL
HSFEYL	FDLDKL
HSFGE	FDLDKL
EIE	NRR
AIE	NSR
NGIK	YK
RVLG	VLGR
IAVVF	LILAIS
IDGNDA	HN
FSGP	FGHGKES
DRT	RY
LIQEVIELDQMSDIIALLISNSLVILLICNEIAL	LIQVSILQKMKIILLGIKLEAIVLTINILLT
LIQEVIEDQMSDIIALLQISNSLVILLICNEIALE	LIQVSILQKMKIILLIKLAIVLTINILLK
LIQEVIEDQSMDIIALLQNISLVILLICNEIAL	LIQVSILQKIILLNILAIVLTINILL
LIEVIELDQMDIIALLQNITSLVILLICNEIAL	LIQVSILQMKIILLGQNIKLAIVLTINILLT
MVYWI	YWIVM
VIYW	IVM