EKMS	KEMS
EKMS	KGEMS
GID	VPG
RSRQ	QRS
DGVYRE	KKYWR
APSI	DLTT
PSI	DLTT
MPSVK	DLE
VIAMPR	SLLIE
IAMPR	LSLIE
VIAMPRR	SLLIE
MPS	LEAILS
IAMRKR	LSILE
PS	ILSL
IAPRR	LSILE
VIAMPRK	SLLIE
IAMPRR	LSILE
IAMPRKR	LSILE
IAMPRKR	LSLIE
NNS	SAV
QLALNWLDREYVLLKI	LQALDKNWLDRYEVLYLI
QLALKNWLDREYVKLLI	LQALNDKWLRYDEVLYLI
QQVYKGLAKE	QVYRQKW
NQLDE	EK
QLALKNWLDREYVLLI	LQALNDKWLDRYEVLYLI
QLALKNWLDREYVLLI	LQALNDKWLDRYEVLYLIK
QLALKNWLDREYVLLI	LQALNDKWLRYDEVLYLI
QVYKGLAKE	QVYRQWK
QLALKNWLDREYVLLI	LIQALNKWLDRYEVLYLI
QLALKNWLDREYVLLI	LQALNWLDRYEVLYLI
QLALKNWLDREYVLLI	LQALNDKWLDRYEVYLLI
QLALKNWLDREYVLLI	LQALNKWLDRYEVLYLI
YQRV	VQQ
QQV	QRVY
QLALKNWLREYVLLI	LQALNDKWLDYREVLYLI
QLALKNWLDREYVLLI	LQALNKWLDRYEVYLLI
LAHAGD	NKRTLL
PAVALMLAVV	VVALMLAPV
PAVALMLAVV	VVALMLAPVA
TEE	VQDTK
TSEE	VDKQ
ENE	NDPE
PVQRD	GEEND
RLE	ADIR
RDIA	ELR
NPQD	ENQ
YQNVS	QN
DHLGL	LGHLD
AAAQ	AAQQN
KAE	AEK
EK	RDGG
TEQ	TQE
SAE	QKA
VTAI	TAIA
TAIEA	VTIAA
TEALVLQ	TEAVLQ
HRATT	TDQQP
RKQ	SHR
TQDQ	HRT
EAN	ERE
DYSAQ	YDSASQ
DYSASQ	YDSAQ
DYSAQ	YDSAQ
DATIGK	PATIGGLLLSH
PDLEY	DLRRR
RNKL	PAYNH
LA	GVEA
SNEEFKV	KWKE
SRNDG	RNDGN
NL	ESL
FVI	LVL
FVV	LML
YVAL	LML
AKG	RDS
QRKDR	RKD
DRSGVIS	QKEQ
RSGVIS	KEQ
RT	EMGDT
RAG	RARF
RTEAE	E
ESLDK	LGHNVA
SLDKDG	HLEA
YLK	EKK
DDRDG	KER
SLAKD	HNV
TKLE	EKL
LLI	LILS
LLIS	LIL
TKTREALQ	IDREDGEQ
DFPEL	KLGE
ADAEEE	KSFAAD
DGDN	EAEDN
DDGNE	GGNY
RGNG	NGRG
TEAED	DGD
GQN	QT
SLDKD	NLKH
ESLDKD	KHNL
SLDK	NLKH
ESLDK	KNLH
SLGQ	VAEE
DLV	RLDV
ESLDK	LGEHNV
SLQNPTEEL	AMEEEVTEL
RTDRNS	NSRFD
NRTDNS	NDSGRNT
RTDNSG	DNSRNT
RTDNSG	DNSRT
FRTDRNS	NSRDR
SAR	KSAS
KSS	SSAR
NND	NDN
TEER	TEERE
ID	IDG
LGQN	ETE
KRS	RES
RYSTD	ERSL
SNKQ	KRGEFE
NNLKQ	KRFKND
NPT	SCA
NT	SCA
NTE	SCA
ARHTGEKL	QARW
KLTDE	WRQ
ARTGKD	HWR
KLTDE	WRH
RHTNGKD	AHEWR
QNGNG	QKHVQ
QNGNG	QHVQ
HN	QFEK
HN	QFE
NNLK	QEHFTH
GQPT	LLSS
EEEAV	HWKM
EEEAV	HWPKM
GVD	ANE
GDTR	DGT
NNVTTDG	TAVMSDR
GIDT	DGIT
VML	LMV
ML	MLV
RNPQ	EDG
KRGQNP	LRGQNP
GDTR	DGTD
ESGK	KGSE
KVE	SI
PSK	EGD
PGY	IN
FY	NEDYK
FY	NDYK
YGP	KQN
ETIN	QEEY
SSKE	NK
GSY	GKS
QKD	LS
DIQDPDTNLEGY	FQCEDECDI
YLDG	IDTN
IDTN	YLDG
RKR	RKR
DRATR	RATRD
RATR	ATRD
TLL	LTL
DLLK	KLTLD
LLSK	LSTLD
IPGLL	LAPLL
LAPLL	LGIPL
LAPLL	LGLIP
HPFYE	EYFEP
EQK	EKVEGK
EEEQ	KEVEG
ASRD	ASQAM
RKS	RKS
YFWLLYFNLL	HVSRLYSL
YFWLLYFENLL	HVSRLYNSL
FQFS	FQSGM
INGYY	NIYWVWK
INGYY	INYWVWK
DQG	GFGQRK
DQG	GFGQR
KEFGL	QRN
YASN	NYAS
EFLW	IFLDW
WYH	RMG
WEED	EGVR
WEED	AGEVR
WEDK	EAGVRY
WED	EAGVR
KAALK	REG
KAALK	RKEG
ENYEAE	RKEHEKAR
NKN	LADG
ADFIS	ASLG
TGI	TGIPD
TI	TGIPD
NYFAYRFT	NFYYAIRFTT
KRQSQEVDY	EYLTIRDKK
KRQSQEVY	EYLTIRDKK
ESKKRFQVIYRI	KTETLIDKERK
ESKKRFSQVIYRI	KTETLIDKERK
FYD	TILR
RQSGQSIDTH	YLTEIRRDKK
FYDR	TIRD
KRQSGQSIDTH	EYLTIRRDKK
RQSGQSIDTH	YLTEIRRDKKE
RRDRY	TEA
RQSGQSDDTHRI	YLTEIRRDTEK
FYINDE	TIDRRK
YDIHN	ILTERD
RDRYR	LEY
ESKKRFSQIYRI	KTETLIDKREK
KRQSQEVIY	EYLTIRDEKK
FTSIN	LSAMK
RKTLL	VLASM
KLMLSN	LKA
LSINN	LKIAE
NFTQ	STQ
ESTN	KEQ
KILYISLLWVVKTKMNETNFTQILVEALVRVLIRL	TMEFLFRLLIDSEYLRYMHYTID
IQLYISLKLWVVKTKMNFILVEALVRVLI	IDLVVSVVIVEFAKINNAE
QQYE	YYMR
TNFTQ	RDQATL
NFTQ	DRQATL
LQEGD	LR
KIQLYISLKLWVVKTKMFILVEALVRVLIRL	TSIINLLLLIIVETQATNNSID
YISLKLWVVKTKMTNFLVEALVRVLIRFL	INLLLLIIEVTTQATNNSDI
NFT	DQAT
NFTQ	DQATL
YISLKLWVVKTKMFILEALVRVLIRL	ILLLLIIVETAQTNNSI
KH	RLQ
AKHG	RLQ
KH	RLQK
PQSK	ND
QPQSK	MND
PN	RYQL
HLPVDS	DSLVHP
HLPVDS	DSLVPH
RKKF	DELL
IY	KGI
VDS	QLPV
HQLPV	VDS
STE	KN
KQEKVS	KVQ
QKVS	KVQ
HKN	SET
HKNQ	EST
KN	STE
HKNQ	SET
SSG	SG
SG	SSG
VTMAYQ	LTPINK
RIED	EDGW
EGEDW	GEWE
SNEE	YRE
AKTA	AKTAT
AK	AKA
RRK	AD
EVN	IFQ
LAN	YVQ
RRK	EEDE
EDEE	RKR
NAS	EHI
LAHG	IQ
KER	EKY
MQQ	NGDR
MQQ	NDGR
DHSFQ	QSFHD
NLW	LQG
ELMG	KYSPT
EPLMG	KSPYT
LMG	YST
LMGW	YST
EDLIG	NPKITYT
WNK	PSS
NRP	GRG
ERRYD	KYDRRKG
GKR	NMFET
NTNTNTNS	TNSTNNNT
KPSR	QE
RGVK	TQ
QAHKS	Q
LIM	IDLI
VIMLLFA	TIFFLVIMF
IVPL	LANLA
SDLGE	RRGV
ETF	SIR
NAEQ	ENKL
FQNS	KAD
QIK	GGIKCD
IRTIL	LDL
IRTIL	LL
KIRTIL	LL
IRTL	LDL
IRIL	LDL
IRTL	LD
IRTTL	LL
KK	YKIS
ELY	TAR
RWRRK	PKVRS
RWRRK	PKVRSE
SETREH	PNLRSL
SETREH	PNLRSLK
IGGLIYRRILY	MLYEE
MEL	YKL
NLL	YP
KANHF	KLF
KANH	KLI
KANH	KLFI
RETQ	TEQR
NAL	LDGAN
EKGH	KGHE
QDGKV	KGDQ
HFTG	GFH
HFTGQ	GQTFH
AESEFEDAA	ASEEFEDAA
NQEA	QARN
EQQH	KKTQ
QIL	WNG
PES	IEATR
RPRV	PRRV
MEG	RTK
QTD	KGE
PRHRT	REQD
DRLE	GKRR
HPQAL	LAEQPH
HPQAEL	LAEQEPH
HPQAEEL	LAEQEPH
HRDDE	RS
PLQNH	TR
PIKPE	ELVQDR
LQDRV	IKVPE
NRRSD	SELQMEY
NDKS	EEPR
DQLQQIRYK	YKIRQLQDQ
DQLQQIIRY	YIIRQLQDQ
LGLSD	R
YLGV	LGYV
DEVRGT	RGEVD
SEAKG	KAGES
HRCEP	EPRCH
HRC	HRCVL
SQL	EDK
KGG	GGS
ALAP	PLDAL
VFDV	WAQ
ACDS	QT
ARR	ISTQ
EIDA	EAR
NC	KNVKS
DTCACK	KNCQA
TRREL	ELRRT
EDL	LED
GTKHE	QSFLDDD
DLPYST	EYDLPST
VVGDCGSS	HQGLHS
VVGDCGSS	HLLQGS
VVGDCGSS	HQGSLH
DSKTK	KASS
NDRCI	EATVM
NDRCI	ETMV
TFML	RIYLL
TFMML	RIYLL
KES	CDRPG
KES	DGGR
VGR	GRGPD
EFLRVLVLVQIV	FLTVELLVVIVG
VSGFLTVLELVVIVG	VEFLVLRVLVQIV
VEFLRVLVLVQIV	VFLTVELLVVIVG
RLQT	LESVE
ETVEGVSQ	QVGVTESE
LEVS	RQLT
VEFLRVLVLVQIV	VSFLTVELLVVIDV
VSFLTVLELVVIDVG	VEFLRVLVLVQV
VEFLRVLVLVQI	VSGFLTVELLVVI
KET	CDGR
KET	CDGRP
KET	CDRPG
MAAAGTV	VFQD
KGTE	KGTE
KKK	ELVQ
YRK	HLLEL
SGSRY	KAGK
QREQK	KNKQD
SYR	NATD
DRDDVAL	KGDTRN
KGDTNR	DRDDAVL
KDTNR	DRDDAV
DRDDVA	KGDTRN
DRDDVAL	KDTRN
DRDDVA	KDTRN
DWGL	TLK
TLK	DWGL
DWGL	TLKV
TL	DWGL
DWGL	TL
FWGL	TLK
TLK	FWGL
FWGL	TLKV
TLKV	FWGL
TLKV	DWGL
NWGL	FTLK
FTLK	NWGL
DRDDVA	KDTNR
KDTNR	DRDADV
NWGL	DTLK
DTL	NWGL
NWGL	DTL
NWGL	TLK
DTLK	NWGL
TL	NWGL
DE	SAK
SAK	DE
DE	SAKK
DKL	SDL
HKF	APH
SLD	DKL
WGL	TLK
TLK	WGL
WGL	TL
DWGL	TLV
TLKV	WGL
KGDTN	DRDADV
DRDDVALK	KGDTN
KGD	DRDA
KGDTNK	DRDDAKVL
DRDDVAL	KGDTN
KGDTNK	DRDDAVL
DRDDVAL	KDTN
DRDDVALK	KGDTKN
KEGDTNK	DRKDDAVL
DRDDVAL	KGDTKN
DRDDVAL	KDTKN
DRDDVALK	KDTKN
DRDDVALK	KGDTKNE
WKGMFHH	WSAQLM
WMSQLA	WFHKGM
KGDTNK	DRDAKDVL
DRDDVALK	KGDTNK
DRDDVALK	KDTNK
KDTNK	DRDALKDV
DRDDVAL	KDTNK
KDTNK	DRDAKDVL
KDTNK	DRDDAKVL
KGDTNK	DRDADVL
KDTNK	DRDADVL
DRDDVAL	KGDTNK
DRDDVA	KDTNK
KDTNK	DRDAKDV
KDTNK	DRDADV
KGDTNK	DRDADV
DKEL	SDYL
SYSLD	KDELK
YSLD	DLK
DRDDVA	KDTKN
DRDDVA	KDTN
KDTN	DRDADV
HKGW	DTL
GADY	AGDY
FKLP	YSI
RRKDED	DEKRDR
NHLPVK	HNN
RRD	PLSQVAPQ
KSAANE	VQKKK
NSSLL	SNLSL
RNSSLL	TSNLSL
TNSSLL	RSNLSL
SGPR	SGR
ISG	GIS
SGD	DSG
ISG	LGIS
GRS	SGPR
NATD	EVRK
LLNLT	LLNL
YSVSE	VMRN
AQVLR	LRVAQM
VAREL	LRVA
QFLLVTKQSVIKIELSGSVELKTN	NLLVVTQVILESHVKFNMDIKVEMFF
QFLLVTKQSVIKIELSGSVELKTN	NLLVVTQVILESHVFMDIKVEMFF
QFLLVTKSVIKIELSGSVELKTN	NLLVVTQVILESHVFMDIKVEMFF
QFLLVTKSVIKIELSGSVEKLTN	NLLVVTQVILESHVFMDIKVMFFP
MGE	GINQNR
VQ	RQDN
VQS	RQDN
TESG	ES
LEVNLVLQLDELV	LDVNLIVLRLLTVK
LDVLIVLRLLTVK	LEVLNVLQLDLEVK
LEVNLVLQLDELV	LDVLIVLRLLTV
EPREN	PEERN
ERPNE	PEERN
EPRNEY	PEERN
MREQA	GREIIDYR
MREQA	GREIIPYR
MREQ	GREIIDY
MEQA	GRIIPDYR
MEQA	GRIIYR
MAREQ	GREIIDY
MEQA	GRIIPYR
MREQA	GEIIPYR
REE	REE
IRYN	VIANESL
RYIN	VIANESL
RYIN	IANESL
YIRNS	AVIANESL
IRYNS	VIANESL
LAAAFLFL	ALAFALFLT
LLSF	LF
EENS	NSYEE
SE	NKRYG
KRYG	SE
KRYG	SED
NKRYGE	SE
ES	NKRYG
LEDVS	RVRDD
LEDVSA	RRDDKK
LEDVSA	RVRDDK
EQYGLD	KGVE
DNSYE	EYSDN
GEKPTT	PKEEGEK
GEKPTT	PKEESGEK
KAL	AARG
QGDG	LIRR
QGDG	LIR
SGG	RS
SGAG	RS
RENG	ERNG
RENGD	ERNG
VLEYKLD	YKVEDLL
NESS	SEN
RLWR	RLED
NQQ	LNTIDP
RISGE	SRIGE
RISGYE	SRIGE
QRLG	QLRMG
GLLG	LGLG
QELG	QLEG
EGLG	GELG
NKM	NVGGL
IDQGT	IQ
IGKIL	KIIGL
IDQLTG	IQ
FLL	FLL
FLL	FL
QDRGG	QDGGR
QGR	QDRG
QG	QDRG
NNEE	KEGN
EGI	IT
CIGLELKEYQISLEALMTSI	CGILEELQKKISELALMTSI
VLLNKLEVKELLLAAREESECLLKEVTLNLEAYEYILSLKAERAEEAVSLISLLKEQYKIL	VLLKNLEEVLKLLAERAESEKLEELVTNLLEAYKEYEILSKLAERAEAESVLESILEELQKKYIL
AMHEI	IEHAM
MTLLDYS	YISLDLMT
MTLLDYIS	YSLDALMT
MTADHLEIK	KIELHADMT
LMEVKLLNKLEVKELLLAEAREESGSEKLLEVTLNLEYASEEYILSLKAERAEEAVSLILELKEQYKISEMLEVLL	MLEVLLNLEEVLKLLAERASEKSLEELVTNLLEAYSKEYILSKLAERAAESVLEILELQKKYISMLEVL
MLEVKLLNKLEVKELLLAERAEESGSEKLLEVTLNLEYASEEKYILSLKAERAEEAVSLEILELKEQYKISMLEVL	MLEKVLLNLEEVLKLLAERAESEKSLEELVTNLLEAYSKEYEILSKLAERAAESVLEILELQKKYISEMLEVLL
LVLLKNLEVKELLLAEARESGSELLKEVTLNLEYASEKYILLKAEAERAVSLILLKEQYKISMELEVKLL	MLEVLLNLEEVLKLLAERAESEKSLEELVTNLLEAYSKEYILSKLAERAAESVLILEELQKKYISEMLEVLL
LVKLLKNLEVKELLLAEARESGSELLKEVTLNLEYASEKYEILLKAEAERAVSLISLLKEQYKISMLEVLL	MLEVLLNLEEVLKLLAERAESEKSLEELVTNLLEAYSKEYEILSKLAERAAESVLILELQKKYISMLEVLL
VTKLE	DMTSI
VLISLELKYQLKKAISLEALMNDI	VLESILELQKLKYKAISELALNDMI
VLEISLELKYQLKKAISLEALMNDI	VLSILELQKLKYKAISELALNDMI
KNLEVKELVLLLQEYKISLEALM	NLEEVLKLVLEELQKKYISELALM
LDNSEL	LSKYHN
KYEDD	DEDYK
DYLK	KDHND
NKLEVKELVLLLKQEYKISLEALDM	KNLEEVLKLVLEELQKKYISELALMI
HDND	DYLK
EKNLVKELVLLELEQYKISLEALHDM	KNLEEVLKLVLEELQKKYISELALM
NKLEVKELVLLLKEQYKISLEALM	KNLEEVLKLVLEELQKKYISELALM
NEKLVKELVLLLEQYKISLEALDM	KNLEEVLKLVLEELQKKYISELALM
KIQAALEDY	DDEYAQLK
EKNLVKELVLLELEQKYKISLEALM	KNLEEVLKLVLEELQKKYISELALDM
LEALRALKAEAASEMIEAMEQLKQAAIAYKVALKIELDAEARESCELLVTLNLEAYSEEKYILSLK	ELAQRLALKLAEAASEGMIEADKMQEQLAKIAAKYVAKLIEDLAERASEKCLEELVNLLEAYKEYEEILKL
LEALRALKAEAASEMIEAMEEQLKQAAIAYKVALKIELDAEARESCELLVTLNLEAYSEEKYILSLK	ELAQRLALKLAEAASEGMIEADKMQEQLAKIAAKYVAKLIEDLAERASEKCLEELVNLLEAYKEYEEILKL
LEALRALKAEAASEMIEAMEQLKQAAIAYKVALKIELDAEAERSCELLVTLNLEAYSEKYEILSLK	ELAQRLALKLAEAASEGMIEADKMQEQLAKIAAKYVAKLIEDLAERASEKCLEELVNLLEAYKEYEEILKL
LYSSY	ELYAQKLKY
LSY	LQKY
ELVREFRDQ	LKYKAIEEHND
MKLKKDALAREEAKAESERLLELQLEKTLEYSLSALKAK	KMLDKALRAEAEDKAERSLEELLQKLTEELYSSLAKLAA
NLQM	DAT
LMKKDALRAEEAKDAEERSLLQELLEKTLEYSLSALKAK	MLKDKALRAEAEDKAERSLEELLQKLTEELYSSLAKLAA
MKLKKDALAERAKDAESRLEIDLLEQTRSVLLESELSA	KMLKDKALRAAEDKAERSLEDILEQLTESRVLELSESLA
KEQRDD	EKKEKD
KANFDK	QMLDNRD
KMLKKDALARAEKAESRLEILELQRTESVLLESELSA	MLDKALRAAEDKAERSLEDILQLVTESRVLELSESLA
KMLKKDAIRAEEAKDAEQRECLQELLETVYSVSALKAKAEAVELI	MLKDKAIRAEAEDKAERCQLEEQLQKLTEEVYSVAKLAEKAAEEVLI
LNMQ	QMLN
RELHLKPRLRKV	LPGSMLQSKHDDEYD
EHLRKRK	SMQSKHDDYD
EYDDDHSKQSMLLPG	KVLRRKPLHELR
TVMIV	TVMIV
LTTLLLLSQLISSILRVVQEMIRQTVV	SVTRVQMQIEVRVISLSLQIHLLSLTTL
TTLLLLSQLISSILRVVEQMIRQTVV	VTRVQMQIEVRVISLSLQIHLLSLTTL
LRNKEM	REEPQF
LRNKEM	REEQF
FDARM	LDVPK
RDSDDGGLQY	RGTGGR
RYRA	EGRLTGY
RR	QQPL
RRA	EGRLTGY
VHYQQRH	VHQYHR
ISKL	SLI
IHYQ	IHYQ
KERN	TNSD
QELRD	QLRD
TSGSW	WGST
SGYR	RN
FPNKN	KPFNN
NG	FSQ
TTSVA	RETW
TTSVA	RETWT
RKTI	KTRII
NRY	RE
RE	NRY
RKDT	YEGK
GQP	NLT
SCAS	KS
LSNS	LNS
TSGSW	WGSST
GR	HGFNS
REH	ERLH
PGHPR	KY
KY	PGHPR
LQIIQGPQR	LQRQIIQGPL
T	PSGAI
AHA	YCF
LVPG	PGLV
KLRTLGAVKE	TFEGRQL
TFGRELQ	KLTRLGAEVK
KLRLGAVKE	TFEGRQL
LQMDA	ALLSKR
QSGK	TGQ
QGSGA	TGQ
NKIN	PTAV
NKIPN	PSAV
KIPNN	PSAV
KINN	SAV
KINN	PSAV
NKIN	PSAV
NQIPN	PSTSV
KFV	SDT
GFKV	DT
NKIPN	PSTAV
NKN	PSAV
NKI	PSTAV
KGFV	SDT
KIN	PSAV
KTINN	PSTAV
KIPNN	PQVSV
DI	NKDKD
NKIPN	PSV
NKIPN	PTAV
KINN	PTAV
NKIPN	PSTV
KINN	STV
KINN	VSTV
KIPNN	STV
NKIN	PSTV
KIPNN	PTAV
NKIPN	PQSTAV
KTVN	TAV
KINN	PSTAV
NKIPN	PQVSTV
NKIN	PSTAV
NKIN	PQSTV
KIPNN	PSTAV
KIPNN	SV
NKIPN	PQVSV
NKIPN	PVSTAV
NKIPN	PSTAVE
NKTIPN	PSTAV
NVIN	PSTAVE
NKIPN	PVSTV
KIPNN	VSTV
NKIPN	PVSV
KIPNN	QVSV
NKTIN	PSTAV
NKIPN	PQSTV
NKVTIN	APQVSTAV
KINN	PSTAVE
KINN	PSAVE
NKIN	PQSTAV
TKV	DTV
NKIN	PTV
NPI	PQVSTAE
NKIN	PSTAVE
KINN	STAV
TK	SDTV
NVIQI	GGK
QGGGKP	KPGGGQ
QGGKG	KPGGGQ
DGFD	GQK
VRMILYDNRQYANSFVI	IRFVSAYRNQYDMLMIRV
SRYR	RFIQ
QV	EGLP
AYRRV	AYVR
QVA	QVA
PQLES	LGVGQ
PQLES	LGVQ
VGQ	LQEPS
PQES	LGVGQ
QLEPS	GVGQ
PQES	LGVQ
KKN	TWEL
ESDG	KKQH
NGE	KK
DN	FHAKEP
KVNE	VNKE
KVKY	FLLF
VKY	LLF
LLTAY	KYVLF
LLTADY	KYDLF
SDNQ	KTEL
GKTT	GKT
RQD	AQDD
DQKAN	KERD
SDYNIQ	SDNQ
FTTR	FTT
QKE	QKS
KRDYE	TGK
TG	RDY
QSN	TTGK
EPSD	EPSD
TTG	RDY
KTG	ERDY
NRK	TSDN
DQGI	QDG
DGQIK	QDGI
QAD	AQP
KGTI	TLTG
LTTG	GKTI
SDR	RTSD
TGL	LTG
SEPD	TENK
NKTE	EPSD
GKTT	GKQ
GTTKT	GKQE
RQEK	ARSD
QDG	KGKT
KG	KEGI
KKTG	TGKT
TLKTGT	KTLTGKT
GKK	QEGIP
RDY	TG
SNY	KTLTG
DDQ	RRVQ
KT	QDKEG
NRD	DRCN
SSPG	EN
VTTS	FGNTC
TVTTSS	VNFGNTC
AYK	WAD
RTLTSAVVALEFRAQD	PTLWAVVGWLVYINGK
RSTTALVVL	NPTALWAVVGS
RSTTALVVL	NTALWAVVGS
RSTLTAVVL	PTLWAVVGV
RSTLTAVVL	PTLWAVVGS
RSTLTAVVLAEFRA	PTLWAVVGWLYING
RSTLTAIVMVERAQF	PTTWAVVGWLYING
RTLTSAIVMVRAQF	TTWAVVGWLYIN
RSTTALVVLAEFRA	PTLWAVVGVWLVYING
RSTTALVVLAEFRA	PTLWAVVGWLYIN
RSTTALVVLAEFRA	TLWAVVGWLVYING
RTTSALVVLAEFRA	PTLWAVVGVWLYING
RSTLTAVVLAERF	TLWAVVGWLYIG
RSTLTAVVLAERF	PTLWAVVGWLYING
RSTLTAVVALERQFDD	TLWAVVGWLVYIGK
RTLTSAVVLAERQF	TLWAVVGWLYING
RLTSAVVALEFRAQ	PTLWAVVGWLVYIN
RSTLTAVVALEFRAQ	PTLWAVVGWLVYING
STALVL	LWAVVS
STLTAVVL	TLWAVVGS
RKSA	HEDCEE
YEKR	REEQEED
YKR	REEQEED
KSA	EDEE
KNPAR	EDEED
RKNP	ELD
RKSA	EHEDEE
KR	EDEED
EYKAR	RRQTEDEED
NPRK	EED
EYRKP	REEDED
PAKRN	REDEED
PAKR	REDTEE
RKSA	KEDEE
KR	EDCEED
AEYRKP	RREEED
YRK	TEEDED
RKNP	ED
KRN	EDCEED
AKR	REDEED
ANPRK	TEED
APRK	REED
YKR	REEQTEED
RKSA	HEDEE
YKR	RREEQEED
YEKR	RREEQEED
YEKR	REEQTEED
TYAVKQAY	TYRTFDDVLKGRY
IYSLRNQEPF	VTVFSAYRRVQRKY
TYAVKQAYP	TYRTFDDVLKNGRY
YAVKQQAPY	TYRTFDVLKNGRAY
TYAVKQQAY	TYRTFDVLKNGRAY
TYAVKQAYP	TYRTPFDDVLKNGRY
TYAVKQAYQP	TYRTFDVLKKGRYY
YTAVKQAYP	KTYRTFDDVLKGRY
RYSFFVGAFEFD	QTEDKGYLTACVAAYKN
RYSFFVGAFEFD	TEDKGYLTACVAAYKN
SSKRYNAVIGAFFQ	DDKRSYFGGLLSAKSE
SKRYNAVIGAFFQ	DDKRSYFGGLLSAKSE
AYSRFFIGAFEFD	EAKGYLTATVAYK
AYSRFFIGAFEFD	EAKGYLTATVGAYK
SLYKFFIGAFQ	DSYFGGLLSAKS
SLSFFIGAFQ	DDKSYYFGGLLSAK
SYFFIGAFQ	DRSYFGGLLSAKS
SYFFIGAFQ	DRSYFVGGLLSAGKS
AYFFIGAFEFD	PSKGYLTATLGAYK
SSKRYNAVIGAFFQ	DDKRSYFGGLLSAGKSE
FEFD	VGYKN
YAFFIGAFEFD	PSKGYLTATLGAYKN
AYSFFITGAFEFD	PSKGYLTATLGAYK
RYSFFVGAFEFD	TEDKGYLTACVAYKN
SKRYNAVIGAFFQ	DDKRSYFGGLLSAGKSE
RYFFVGAFEFD	TEDKGYLTACVAAYKN
RYFFTVGAFEFD	TEDKGYLTACVAYKN
RQYSFFVGAFEFD	TEDKGYLTACVAAYKN
RYRFFVGAFEFD	TEDKGYLTACVAYKN
RYFFVGAFEFD	TEDKGYLTACVAYKN
RYSRFFVGAFEFD	TEDKGYLTACVAYKN
RYSRFFTVGAFEFD	TEDKGYLTACVAAYKN
RYSRFFVGAFEFD	TEDKGYLTACVAAYKN
RYRFFVGAFEFD	TEDKGYLTACVAAYKN
RYSFFVGAFEFD	QTSEDKGYLTACVAAYKN
RYFFVGAFEFD	QTEDKGYLTACVAAYKN
ARYSFFIGAFEFD	EAKGYLTATVAYKN
KPPS	NR
WQHI	EHQWI
NEAL	EALN
YNT	TYN
QAIVTIE	ELIVATIQ
QAIVTIEL	ELIVATIQ
KYTDN	IVEKK
DRQ	VT
ESDP	RNEER
QALTLSA	QNAQEA
HTEPLA	DSEKYN
RGGQ	GGRQ
ETRA	ETRAW
NWW	WNP
KRTE	ERTK
QALTLSA	QNAQTAW
QALRTLSA	QNAQTAW
RDQFG	DRQFG
RDQFGL	DRQG
NDG	HDHV
QENAK	VTNES
PCEP	EPCP
NGE	QGPR
NGE	QGPYR
PFGQ	QPFG
PQFG	QPFG
RIFL	RLRG
RAVVAD	DAVAVR
STVAGGYNNEATGSTIAGGRKNQATGKGSFAAGIDNKNADNAAVALGNKNTEGENSVAIGSNN	STVGGGGYNQAKGSTVAGGYNNEATGSTIAGGRKNQATGKGSFAAGIDNKNADNAVALGNKN
STVAGGYNNEATGSTIAGGRKNQATGKGSFAAGIDNKNADNAAVALGNKNTIEGENSVAIGSNN	STVGGGGYNQAKGSTVAGGYNNEATGSTIAGGRKNQATGKGSFAAGIDNKNADNAVALGNKN
STVAGGYNNEATGSTIAGGRKNQATGKGSFAAGIDNKNADANAVALGNKNTIEGENSVAIGSNN	STVGGGGYNQAKGSTVAGGYNNEATGSTIAGGRKNQATGKGSFAAGIDNKNADNAVALGNKN
STVAGGYNNEATGSTIAGGRKNQATGKGSFAAGIDNKNADANAVALGNKNTEGENSVAIGSNN	STVGGGGYNQAKGSTVAGGYNNEATGSTIAGGRKNQATGKGSFAAGIDNKNADNAVALGNKN
DRR	RRD
DYDYME	KDGFIAAKV
YEYL	KDEGFAAV
DYEYL	KDGFAAV
RGSRH	ADRGQ
GPPRT	LEGP
FPWRGT	KKR
SRH	QNSQ
QLA	DKDLDTQ
LQD	DTS
DEE	RR
DEEQ	RR
RIAAQAYK	AAIVARKLA
DVR	ILLE
DVK	ILLE
RFDLV	SQKGILLE
RFDLVKRAR	SQKGILLE
RFDLVRAR	SQKGILLE
LSVEILLAEKAVKAEAKLLRELEYALAEAGSEVLARARQEVVRVALL	LRLAEAVAEALLAEKALEYREETLLYRRAEAVRALDAVVLVL
AQALTALRAQ	LLKELLK
TLR	GLISL
LRA	GLIL
KKLLK	ELDEADS
PSG	LA
LRLLKIVKFINRVLL	LKLTLEIVTFIEANDLLE
FEVTITLLELK	LKLLEIVTFE
RI	KGYQ
YQKG	IR
PD	ADN
PD	ADNQ
TEILITFWLLILV	TEIILTFWLLILV
LITEAAMW	EILEAVM
IELEAVM	ILETAAMW
EVELE	HVHDE
EAELERLK	RHEEAE
LLKDS	TARKD
YYENR	PVER
LQLKNRMLAIEKLKCEINLLELH	QLLKMNLAKILECKEEILNLLH
HFEQAKVQNKQL	HFSEQERLLQH
QQLR	LNLR
QILKNILAIEKLKCEIELLLLL	ILKINLAKILECKEEILNLLL
IKLNILAIELCEIKNELLLLL	QILKINLAKILEKEEIRLLLL
QILKNILAIEKLKEILLLLL	ILKINLAKILECKEEILLLL
IKLNILAIELKCEINELLLLL	QILKNLAKILECKEEIRLLLL
QILKNILAIEKLCKEIELLLL	ILKINLAKILECKEEILNLLL
IKLINLAIELCKEINELLLLL	QILKNLAKILECKEEILLLL
ILKNQILAIELKSKEIELLLLL	ILKINLAKILESKEILLLL
KILNILAIELSKEINELLLLL	QILKINLAKILESKEEILLLL
IIIIIIKIIIIERLINL	IIIIIIEIIIINIGLL
IIQIIIIKIIIIERLNL	IIKIIIIEIIIINILL
FSHQKQLR	LRQQHFS
QNLRR	QHFSEQE
RQNQNTKHQ	LKQNATQ
QNATESFEQE	RLRQNNQKH
IIQIIIIKIIIIERLINLQ	IIKIIIIEIIIINILLG
RQNQNTKH	LKQNATQ
QNLRRQ	QHFSEQE
NTQAESFQEE	RLRQNNQTKH
IIIIAIEIIIINII	IIIIKIIIIEIRIL
IIQIIIIKIIIIERLI	IIKIIAIIEIIIINI
RQR	SEQE
IIIIIEIIIINII	IIIIKIIIIEIRILI
EQSE	RQR
IIQNIIIIKIIIIERLIK	IIKIIIIEIIIINIKQ
IIIIIEIIIINI	IINIIKIIIIEIRI
IIIIIIKIIIIERL	IIIIAIIEIIIINI
WHK	WHE
KGMT	LWQ
FK	KEKG
KVY	DVARA
PQYVL	STPL
STPL	PLQYV
SILPDLRFF	KRDLPISLFF
SYG	AS
ISVGGNS	NFYMY
YYMFN	GNSGSIV
SQSKE	SKE
TYAAN	QTD
TYAAND	QTDVS
LLHLQVLIWE	WVELILQLLH
RK	LKDS
LAL	LNY
AIEQS	KK
IEMDAS	LKK
IMADS	KLKK
IMAES	LKK
ERKF	ERK
EAWAEPES	AWAE
NIS	LNYE
SDVQLKVRD	DAARPAGDS
STR	RSAT
KKLSN	KKLSN
KKLS	KKLS
YRTG	GYRT
ERE	REE
KHVKWKDSDKTEY	YKTEDSDKWKHVK
KHVKWDDKTEY	YKTEDDKWKHVK
KHVKWKDDKTEY	YKTEDDKWKHVK
DGVI	VPRCQLD
IVDG	VPRCQLD
LIIIC	ILIRCA
LIIIPC	ILIRCA
QAHN	DR
QEL	QELV
QLD	HTF
QWLD	HTFF
VAEA	VTGSIS
ESR	RES
VAEATK	PTGSISD
ELPKW	VH
TTYTRR	RTTTYI
VQGATR	ATARE
AGAS	RDSV
KSQFL	GVWKGA
SNASG	DK
FRGF	TGAY
KASD	QKE
RENGS	KRDKN
DRGIQQQ	QQQIGDR
AIGQQAQYI	RGIQQAQYI
RIGQQYAQI	AGIQQAQYI
DIQQ	QQID
DRGIQQKQ	QQQIGDR
REENGESR	GAAKGEQQQ
RQNEGSK	TKRDKNTN
NPASCAS	ASSCNPA
EYYK	KYEY
QELGL	LQGLNQ
GPTWA	EKNY
RS	RRQG
EKA	RAE
ENER	ENER
NRDWLQ	YDEAKHE
KRVD	QESKD
ENRA	YAW
EENRA	KYAW
EVLLE	KR
QKEN	ENQ
QKE	ENTQ
GIEIKLYGILEGVLFLKM	KLFVLEIGLYLKIGIQ
EAAGEILR	RLIGEAAE
GYSIAIGDRS	AKNSVAIGHSS
ALNGSQISIGTGN	KVNGKQSIAIGSGA
QAQLA	GNVTVI
ERQG	EERR
VAFDDRLATRLRYE	YELTRRLDADFVAI
LFVA	LAFVA
LAFVA	LFVA
VAGFDDLTRLRYE	YELTRRLDADFVAIAGF
YRNEY	KPYRN
NP	NPVR
AVA	AVA
DPLAN	MLDPA
TG	FEAKLH
DEEVDS	TEDEVDS
EDEVDSD	EDEVDS
PLDR	RPLD
PLDRD	RPLDD
ETWQDKR	KHNS
LDALKYQLLAATIKFS	AELQKFSGPLGSQGLFC
VNLDLFADFE	DRFFDLVN
VYSNQL	VQSNLY
VNLDLFRFD	DRFFLDLVN
ASHTLF	SRMKL
RLMKS	SFHTLA
TVD	WGHKW
VNDHD	VNDHD
VNDHDA	VNDHDA
QDYTIQN	QQKDGM
QDYTQIN	QQKSDGM
PIRVEGSD	DGVP
IWCED	IWCE
YGP	FR
FRN	YGPK
RYSERKPD	YRSEDRKP
YSKK	KK
SKKG	KKG
KSKG	SKKG
KYSKG	YSKKG
ALRVLLVT	TRVLLRVAL
VDLVLRRST	RVRLDVDL
LDLVVRDR	STRVRLLVDAL
VLTRV	ETRVLV
QHERENENNKQ	EEERNHKENEQ
ARCHGHD	DHCARHG
CLCD	RK
PLCD	RK
GRVREC	CGRG
GRGFC	VRECGR
KMR	HPC
RK	HCPHC
SHT	WQAS
QSV	YRNE
RS	MVHR
HTGT	SRH
VEK	RRY
VE	RRY
RSGR	SRD
EVK	RRY
KGML	CPHCDKL
WKNQ	TKCDI
LRKT	TIELS
LKET	TIEL
LTET	TKL
LTET	TKLR
LRKET	TIEL
LRKT	TIEL
FKT	CKK
INRCIRDAGLC	LCARDCIIRN
INRCIRDAGLC	LCAGRDCIIRNC
KNESC	CSNKE
PSCHFL	CRNGGE
KTGTHC	GTHCTK
YIN	NIY
WKG	FNCG
WQ	WNCG
GGFKK	KCEL
LRIN	LIN
DCTLI	ADLKAE
LQHHD	YKCECKFQ
LQHHDQ	YKCPECKFQ
PYKCP	PYA
CSES	KCE
VGPQ	MFV
ESVN	TRNDACQ
TRNDACQ	ESND
NESD	EKCLTSN
KCELTN	ESND
FRLLDRV	WELLRLEA
GRTE	TEKQ
KEGQD	QVR
KQVFP	EHW
CNG	GKGLR
GCN	KGR
GCN	KGLR
AQILL	KIFIR
QIALL	KIFIR
IALL	IFVR
QIALL	KIFVR
QIALLR	KIFR
IALL	IFIR
GRVN	RQLRN
VPGQG	QST
QIALLK	KIFVR
IALL	IFR
ILL	IFIR
QIALL	KIFR
IALLK	IFIR
AILL	KIFVR
AILL	KIFIR
DALA	RLPR
DAL	RLPR
DEEEE	KRR
DEEE	KRPR
GSMED	AKRVTMK
GED	AKRVTMK
DERSD	NRK
REDG	KQVHD
TEDE	SRSR
DTEE	SRSR
EKEL	NGKVTI
RS	PMAH
AART	QRLS
RIPTKTD	TPDITR
RIPTTD	TPDITR
RIPTTD	KTPDITR
SEC	NAGR
AGR	SEC
NAGR	SEC
SEC	NGAGR
EKLL	KELL
EKHLL	KELL
EKHLL	KEHLL
MELEFL	ELL
KDSIIE	EISDIK
LFMV	VFMQL
LFV	VFML
QIVDY	KHGEAQ
RDG	QRD
RAE	PKEG
MLFV	VFMQL
MLFQV	VFMQL
FSC	SCF
ALSCQL	AQKTD
QNLPVY	LPTVNY
NTVY	LPVNY
KE	QQGI
EK	QNGI
EGKFQS	GEKSF
RAD	SDR
KKI	AQEQD
ENQYARRA	ENQRYAAV
AETQK	ILSVQ
AEEQK	ILSVQ
ELKH	TD
ELK	TD
QDQGSD	QDVNK
QDQGFD	QDVNK
ITAVGLV	QYISKQE
ITAVLVG	QYISKQE
VAITGLV	QYISKQE
VGTAGDA	RKLY
VQRQ	YLQY
VQQR	YLQYI
SAAV	QY
VQQR	YLQY
KQSQAVQ	DQAVSKQQ
ALDL	LDA
QKSQAV	VDQVSKQ
QSKQ	QVSKQ
DAL	LDA
QKVVSQ	VDQSK
RSANQSADT	DATEAQSAQANAS
QSKQD	QAVK
QQK	ATEGALN
QKVASQAVDQ	VDQAVSKQQ
QKVASQAVD	VADQAVSKQ
QKVASQAVDQ	VADQAVSKQQ
ASEQANQSEADATD	ATADQSANSER
QKVVSQAD	VADQAVSKQ
KQSQAVQD	DQAVSKQ
KQSQD	DQSKQ
QSKQD	QK
RSANSADT	DATEAQSAANAS
QK	TEGAL
QKQA	QAKQ
VQSKQA	QAKQ
VAGS	RLT
IAVGL	QAVSQQ
ILVAG	QVSQQ
VAAGS	RRLT
EETLK	QNGLAN
RDKEDSKK	RMKKSEAKDR
SKKCS	ER
GFIKK	KAMPDY
NFSV	SVNF
KGDIGH	ERLARE
EEN	RRR
DSNV	RNL
VLPLTLEKLKTARLLLELLETQLFDLH	SHDLLQFELTELLTRLTLALEKKTLLSVLP
VLLTLEKLKTARLLLELTLETQLFDL	HDLLQFELELLTRLTLALEKKTLL
LPVVLLEKTLKTARLLLELTLETQLFLH	HDLLQFELTELLTRLTLALEKKTLLLV
IPK	HYPE
RYEWFLAYKD	KDLAYFEWYR
ERLTLF	RTLLF
LTLF	TLLF
RTHSY	WRK
SFQL	KR
RIQT	SIE
NTREK	RKEKT
RL	RGSE
RVEESITNF	ITNSEEVR
GES	ESG
EGRS	NESG
EVS	EVS
QVRTTLIK	TRVQTLIK
ALGDYQ	FTNE
MYQT	IHWW
DKQD	RRPR
MYQT	EHWW
MYQT	IEHWW
SAMRY	EE
VGET	VA
DQDT	RR
QVT	IED
DTQKQD	RR
MQYT	IEHWW
MYQT	EHW
MQYT	IEHW
MQYT	IHWW
YLFQLT	TLQFYL
DCALQ	DPVTN
SSQR	RQSS
QET	GRI
DMAL	KHE
PNLLLK	SLE
NGAG	DIFK
NSHSH	RNHSD
GLL	DRPG
RMESESSD	SSEQIH
EPKI	LARN
EPK	LAN
EPK	LARN
EKP	LAN
EPKI	LAN
EYHELHH	HKQYNL
NPGL	TGLNP
LFYLQT	TLQFYL
RDK	KCK
LKSTLE	LYSMPL
KVDTLQ	E
NAVG	DDIFK
QAM	NENN
KDGL	YKHTNQ
FTEFS	LNPE
QFVE	KSVNLDL
SQLQRD	LGSK
EANMH	RRTM
YQV	QLPYY
KCVEV	KCK
LFKLE	LEFKL
EQMYR	KS
EQKY	KS
FLF	FLF
YQV	QLPY
LLLSPEGHQH	QVEKQHEQIL
ERQFY	RFQ
NGMAGFL	MNLFGAG
GMAGFNL	MNLFGAG
NGAGFML	MNLFGAG
EFT	RLGNR
QRDGATQQD	DQTAQQRDG
QRDAQQTD	DQTAQQRD
QRDGAQQTD	DQTAQQRD
QRTDQ	DQTQR
DQWTLAHKQRE	REKQAHTLDWQ
RETL	HASRWT
VDGDASEM	IYW
VDGDASM	IYW
NQEP	KGVG
TVL	QLTV
EVHQQE	QEQVHE
NTAVNGR	DDERL
NANTGR	DDER
NANTGR	DDERL
NAVNTGR	DDER
DNANTGR	IDDER
NTAVNGR	DDER
QQL	HIEQ
PKYFK	H
LKRNT	RLDKGYY
FTQTRFSRKFSHG	HGFSKRSFTRQFT
RLKFSGVWHRE	EWHRVSGKFLR
EVY	VY
YVTRCFERSVFG	HGFVSREFCRT
RYRKFHERISRDHGF	RDHGFISREFHRKYR
HRYRKFERISDHGF	EDHGFISREFHRKY
HKRYFERISRDHGF	EDHGFISREFHRKYR
HRYRKFERISHGF	ERDHGFISREFHRKYR
GPEV	EPGV
KVGIV	EEK
RRYRHFERAVDFEGH	EDHGFVAREFHRRYR
EAQVRNKD	DQKRE
EKAAEK	NQAE
LAAKQ	LFAAQ
QALFA	QKLAA
LNL	LNL
LAQS	QVWG
LAMS	VGV
RL	LME
RSG	SLN
R	ATSTE
R	TSTEY
LRLG	LGVTYK
RL	LGVTY
LVRA	LMRP
EDSLS	KNY
YKN	SEDLS
GYSIL	SGYI
KLLTTE	KLLYK
KTPNL	RSG
ALLNGGKVA	VAGKLANGL
GVKVSEQV	ESVKVGR
LRR	RRL
AVTDP	PDVAT
RSNLTY	NSRLTY
QRALK	QRLAE
QQRALK	QRLAE
QQRWALKE	QRLAEK
QQRALKE	IQRLAEK
QQRWALKE	IQRLAEK
QRALKE	QRLAEK
QRWALK	QRLAE
QRWALKE	QRLAEK
QQRWALK	QRWLAE
LTR	LT
GDRA	PVQE
QE	VSDR
TIKSNLL	NLTIKSL
ANALK	KAALN
ITGVSTL	AVSTTIGL
TIGVST	STTIL
TIGSTL	STTIGL
TIGVSTL	STTIGVL
SLVNNVI	NVSLVNI
PTDTPM	TPPTDM
RFER	RRE
RLDEVF	RLDVF
TIKNL	NLTIKL
TIKNLL	NLTIKL
YKED	EDYK
TIKNLL	NLTIKSL
KTINLLS	RNLTIKL
EVSDVV	RSR
TIKSNLLS	NLTIKL
ALSNNII	NIALSNI
IKTSANLSL	SANLTIKSL
LDQGV	GVQLD
IKSTNLSRL	SRNLTIKSL
TIKSRNLSL	NLTIKSL
GDLEKRMT	KKLE
TIKSNLL	NLTIKL
IKSTNLL	SRNLTIKSL
TIKSNLL	NLTIKS
RQNRK	ESDQ
NDVDRT	RTDQGRTE
DEG	SAGER
KFRR	GRRT
VLLV	VLVL
LEAQ	AQLE
MSANSCI	SCNSMAI
VVN	LAT
VV	LAT
VVNRR	LART
EMIYK	QIVGC
DMTV	QAGL
DTPN	HLI
TDR	KRV
TD	KRV
IME	DQN
IEMY	EQIVG
YIEM	IEQIVG
RG	QAG
EMIK	QIVGC
EMIK	QQIGC
EMIY	QIV
GQL	HEAAGTS
IQVQ	RIKMQ
EMIK	QVGC
EMI	QIVG
EMIKG	GQIVGCSR
QRSKS	QDKR
QRSKS	QNLDKR
QRSKS	QNDKR
KDRQN	SRSKQ
THMPDA	PDAMTH
EVTE	MTHP
TEV	THP
NER	PTENTE
IEAAE	RATA
SGQPR	QR
DAG	KPNTQ
NYGG	TGGNR
LAYQSH	PELLNAA
LAQ	QLA
GAPT	PTA
TAVP	PTA
IKNVY	IYKNV
IKNY	IYKNV
NLI	EKA
NL	EKLA
VTRAAGADR	DRGARAVT
STIFRLF	FYRLSTIF
STIFRLFY	FYRLSTIF
STIFRLFY	FRLSTIF
LLFP	ILLF
YMEKLKIETQDK	YMEKQDKTLKIEG
YHFLP	LPFHY
AAKK	KKA
AKK	KKA
AKK	KKAA
IISAHAT	ITAIAHS
FRA	DIFQ
FRA	DIF
KGQ	KGQ
CSDE	CG
WCSPL	CGV
IHSIKELIQHEIA	IHAEIRLQEIHKSI
IHSIKLEIQHEIA	IHEILQEIHKSI
LWKKK	HVKC
LWKK	HVKC
RQDQA	DQRAEQ
REQ	REQ
EQR	REQ
KLWKK	CEHVKC
KLWKK	EHVKC
EQGF	NKK
RTDE	KHR
RGVT	SVGT
IGP	PIG
FQNAV	FLESS
ESDLFH	QTKLI
NHE	HAH
NAQK	AHN
RKEH	KER
THFDL	KDLHT
HTDL	DLHTF
LRDPG	GRAL
LRDGP	RGRVAH
NNHP	NNHH
NN	SNN
GLLD	MQDYV
TEYTFTTTG	GTTFTYTTE
DFN	FFDN
TVK	NDNG
NDNGD	TKV
DNDQ	KQND
EELAILRLEFEFLFKALE	EVCLEIQTVQSMMWWL
RIRNLRRCLQFKLMFRAV	LEALCLAIDTENMDWW
ELEAILRLEFEFLALKE	ELVACLEIQTVQSMMWWL
ELAIRLFSQEFLKFALE	VCLEITVQSFTWWL
RIRNRLRCLQLFQKLMFARV	LVEALCLNAIDTEQQFLDWW
RIRNRLRCLQQFKLMFARV	LVEALCLAIDTEQQFLWW
LAIRLELFSQEFLKALE	LVCLEITVQSFTWWL
RIPYN	KNYIRP
AAAPSC	VLLNSC
YD	LKKR
PNRSWPE	WPRSE
NSS	SNS
NLQMHDLEKSK	SKKLQEHLDQMN
LAEK	LQRD
RQWDTR	DTDPALD
NNEDTHQ	NMETHQ
RDK	EGTE
RDK	EGVTE
PCCT	TPCC
ASNG	HKF
HQR	RQH
KIVELSTPRI	PITSLEVIK
KIVELST	PRITSLEVIK
QNYHI	ANYPTAR
WRK	TGN
RAP	EVT
PGTTSL	NDN
RQQG	QGRQ
RQG	QGRS
YQG	ELFT
GQR	TGR
ELFT	YQG
RSG	YQGRS
RKYQG	YQGRK
RSQG	QGRS
QEIKN	KSLAKW
QQENKI	GYDI
QENKI	GYI
QENKI	GYIN
GARPPV	RQLG
GRPAV	RQLG
PGLS	YEPVVER
VFLLEI	LII
VFLLI	LII
GIL	PSLKG
VFLL	LII
NKIDTLV	VTLDIKN
VDKLLM	AIGLD
LDAKT	VT
RNSGD	RNSDGQ
RQAD	FKYV
CKE	RCEK
CRGG	LFM
LSH	LCH
LAV	ALV
LCH	LSH
EHLAV	HEALV
SLICL	ICSLL
QLAVH	SLYQ
SYQL	QLHAV
QLALVH	SLYQ
SYQL	QLHALV
LV	CSLL
CSLL	LV
EYLHQLAV	QHLHAYLV
EYLHQLAV	QHLHEAYLV
SYQL	QHLHALV
LLVARFGF	IVCLLEYC
ELA	ALV
HLA	EALV
HELA	EALV
LHLCALV	VCCSVCLE
HLCLALVC	CCSVCLE
FKYT	YQENC
LAV	LEAL
LEAV	LHEAL
LEHAV	LHEAL
HLAV	EALV
EHLA	HEAL
LEA	ALV
ELAV	HAL
HLCH	GSHE
HLCHS	GSHE
YASNL	YSANH
LHLQCAVLRFFG	IVCCTSICLLEYC
HLAV	EAL
ELA	HAL
EHLA	HEALV
HLEA	EAL
ELHQHLAV	QHLHEALV
RLGV	ICSLYL
CSLLYQ	LVRG
ELAV	HEAL
LEA	EAL
EALV	HEAL
EAL	HEALV
EHLAV	HEAL
ELA	HEAL
HELA	EAL
HLEA	EALV
ELA	HALV
LAV	EAL
ALV	EAL
HLA	EAL
YLEEVSHHLG	HLGSHVEYL
YLEVHLGS	HLGSHVEYL
LSHE	LCH
HLC	HLSH
LLLVARGFY	IVCLLEYC
LSH	CHL
CHL	LSH
LEHLA	LHEAL
VVEAQL	VVEAQL
VVESKAQL	VVKEASQL
VEVSKAQL	VVKEASQL
HSKFG	LQINS
QLNIS	SHKFG
VVLDS	LVQI
KRW	SALH
RKW	ESALH
RW	EALH
DWAG	KY
ENK	CDVCQE
WWAG	EKY
WWIG	KY
KWGIE	Q
WWIG	EKY
LIHDE	VGFRN
AVKS	AVKS
GR	IDT
HFP	TYKVR
HFP	TYVR
FP	TYKVR
EQKY	RTKEW
EKY	RKER
KYLF	REW
KYL	ERW
EKYLF	TCERGW
EKYL	CERW
KYLF	ERGW
YQNK	GKQNY
YNL	RKQ
YNV	LRQ
PEAT	ATPE
PET	ATPE
KTWSVL	LTL
ISV	SVI
TLL	TLKWSV
TVGYG	ATVGYG
ATVGYG	TVGYG
VTGY	TVGY
TVTGYGS	ATVGYGD
TVGYGD	ATVGY
TTGGY	TTGYG
MVAEWF	WRQAH
MVAEWF	WVRQAAH
LKFTK	KTLKF
LKFTK	KTLF
KRS	KFL
RQA	KRYL
DQML	RKFA
NSGDQV	LNEAV
ATRE	FGRR
R	EAFAQ
ENND	DENN
RLSVF	LSVRF
ENND	PDENN
ENNPD	DENN
END	PDEN
ENPD	DEN
KKAGLYE	EYGLAK
KKAGLYE	EYGLAKK
KNED	EDKN
APQP	PQAP
LYTVKQT	GTQKVTYL
YLVTVKQT	TQKVTYL
VIYL	YLVI
KAK	NEE
EVVHS	HSVVE
VVQ	VVQ
DIK	SAPD
NGV	EYE
WAV	AWV
IAIFNS	FIAINQS
AIQFINS	FIAINQ
AQFIN	FIAINQ
AQFIN	FIAINQS
IAIQFN	FIAINQ
IAIQFNS	FIAINQS
TTLTT	NKSQ
TTTLTK	NKSLVQ
PGH	HDS
KYGK	TT
GRCEVF	DSI
QILRKALREKMEEAIQQGI	GGIQIAQEMKEELARKLIRQ
LSML	SLM
LAKSVALPY	YPLAVKASL
KQL	LQK
LGEVAE	SLLLR
IVTEG	GVLI
LGHEVAVE	SLLLKR
LHEGVAV	SLLLK
LEGVAE	SLLKR
TINYRK	VYISS
LHEGVAE	SLLLKR
LGHEAIE	SLLLKR
LGVAEV	SLLL
GLVAEVE	LLLR
GVLAEVE	LLLR
GVAEVE	LLLR
LGAEV	SLLL
LGEAE	SLLLR
LGEA	SLLL
LGHEAE	SLLLR
LGHVEAE	SLLKLKR
LGEVAVE	SSLLLKR
LVEAVGE	LLKLKR
LGHEVAIE	SLLLKR
LGHEVA	SSLLLK
LEGV	SSLLLK
HAEGIE	LLLKR
LGVAE	SLLLK
LEVAGE	SLLKLKR
QHEKI	EVDDTR
HEKQ	VDTR
HEKIQ	VDDTR
QHEKI	VDDYTR
QDPQ	SYDEN
QHR	DMKQ
QRKH	DMKQTG
EKFSI	KEFSI
TLVIP	KSVTVLP
TLVIP	SVTVLP
TLVIP	KSVTVL
KFPD	GE
IITVTD	TDIIT
IITPTD	TDIITV
IITTD	TDIIT
IITTD	TDIITV
FTSKS	SKSFT
FTGSKS	SKSFT
LLEELRIKAALKLEQRLVSLKILVKKN	KLNVKLIKVLSQLRELAKAKLRILEL
VTLAVFN	DQSGEVL
VLLNELLKLNKLIVKLSQELKLKEALKI	EVLLENLLKLNKLIKVLSEQLKELAKKLE
MGVLINELLTLKNLKIVKLTKELQLEVKLKN	MVLIENLLKLNKLIKVLTEKLQELVKKLEKN
TYMF	KKYG
TFYM	KKYG
TYM	KKYG
TRMLLQLQEKLTNTLL	RTMLQLLQKELTTNLR
TRMLQLQEKLTNRTLLR	RTMQLLQKELTTNLRRLA
NKGI	NEHF
NKGIT	NEHFE
GSNSS	GHE
LINVFVV	KALLMM
LIVFVV	KALLMM
NSDG	YQ
YGQ	NDG
PDG	YGHTF
GPRMG	RGPR
PGRR	MRGPRG
GPRMRG	RGPR
PGR	MRGP
GPRRMG	RGPR
PGRR	MRGPG
PGR	MRGPG
RTGRARRQYRF	RGLIGLKLED
RRYF	RNILLKGE
GRRYF	RLLKGED
GRRQYRF	RLLKGED
RRQYRF	GLRGLKED
GRRQYRF	RLILKGED
KTGRARRQYRF	RGLIGLKLED
GRKLYRF	KGLLIKGED
RAR	HRS
TNGVLV	KSR
ERRVM	QAR
RLN	EVQ
RLN	KEVQ
GVTG	GP
NTG	EGT
GNTG	TEG
VTG	PGT
KGNT	TGGEI
VTG	PG
GNT	GETG
SDQ	GAGR
SDQ	GAGRI
DYQ	GAMRAG
KGN	SET
KGN	SEG
AKGT	GET
LS	PRG
GVTG	PGT
LGLLE	SRLNV
KSE	TAR
NKSES	TR
LV	VRVA
NARY	GLVR
KRIRVKDGK	IDDIFEEMK
KRIRVKLK	DEIIEFMKGIG
KRIRVKLK	IDDIEEFMG
KRIRVKLK	IDIEEFMG
MGRRWRCRTDGT	HDIIEEFQQK
KRVRY	DDYF
RRWRCRTDG	IDEIFQEKG
KRIRVL	IDDIEFK
KRIRVL	IDIEFEK
KRIRVKL	IDDIEFEK
KRIRVLK	IDDEIEFMG
KRVRYLVGGNK	IDDEYEFQGKQ
IVGKRVRYRLDG	FFEIGEYGLH
GRRWRYRTDGS	DVIEEFQQ
QKYVEA	QRAPI
QKYVEQK	RSKPV
QKYVDEQK	RSKVP
QKYVDEQK	RSFKVP
QKYVDEQK	RSVP
QKYVEQK	RSPV
QKDEQK	RSKVP
HQKYVDEQK	RSKVP
QKYDEQK	RSVP
YQKVDEAK	RAQPI
QKDEA	RARQPI
DEA	QPRA
QKFVDEQK	RSVP
AYQKYVDEA	RRAQP
QKYVDEA	RARQPI
QKYKNEVK	RRLEPE
QEAT	RPFT
QHNEVK	REHSPL
QKYVEA	RARPQI
QDEA	AQP
QKYDEA	RARQIP
QKEA	RALRPQI
QKVDEQ	RSFKVP
QKYVDEQS	RSFKVPG
AKVDEN	KATHPI
AKVDENS	KATHPI
VAQK	RGP
QKYVDEAK	KRYQYP
QKFVEQK	RSYKPV
QKFVDEQK	RSPV
QKFVDEQK	RSKVP
QFVDEQKK	SRPV
QKYE	RVK
QKVDEQK	RSFKVPV
YQKHNEIK	RRLEGDPL
AKVDEN	KHPAI
QKYDEQSK	RSKVPF
QPNSA	HQSQ
EQ	HGN
QPS	HGG
TPNSAL	EGKKG
TKPNSAL	EGKKG
LRLNPYVLKET	RINLAQERRQ
LRLNPYVLKT	RINLAQEQR
LRNPYVLKET	RINLAQERRQ
LRLNPYVLKET	RINLAAQKERRQ
LRLNYVLKET	RINLAQERRQ
LRLNPYVLKT	RINLAAQEQR
LRNPYVLKET	RINLAQERQR
LRLNYVLKET	RINLAQERQR
LKLPYM	RYH
LKLNPYTM	RIYAKH
LKLNPYTM	RYAKH
CRNPALLR	RTRLE
LGSEG	RKNKR
LKPYT	RYKH
KRPLKNVA	VKVKR
VYLP	RNYA
VRLIEVKRA	KGYIL
GGDL	GG
DR	RHVD
KENH	NHKE
ISLY	ISLY
DTT	NN
TYADSQ	KENW
LSDRD	EKLNGK
QRQ	THGE
TTV	TTV
SVQQ	SVQQ
KDK	NND
DVLAM	SAAD
SMSAVLAM	SQFVSSADA
MSAVLAM	QFVSSSADA
DVLAMS	SAAD
AAGF	QN
AAGF	RQNA
RAAG	QRN
VQTLY	LYTVQ
TVQTLYK	KDTLYQVT
TVQTLY	KLYTQV
RER	TER
EER	RYEE
EEYR	REE
EEYR	REYE
QTVLRQQ	LRQQVQT
TQTVELR	QLRVQT
GLTE	ETGL
QTVLR	LRTVQ
IQLKIV	LHSQIAYLIL
QLKIV	LDIDAQLL
IEASIVVIV	TVLQTLL
IVQV	LTLTQL
WMNPL	KNPL
KNPL	YNPL
EDSQ	HQAR
EDSQQ	HARE
EMDSQ	R
PPEMD	R
VETAD	RIE
ETA	IR
LGRT	RY
NGYQIHH	HHYQIGN
NGYQIHH	HHQIYGN
ELF	KVK
ELF	KK
ELF	KHKV
NNE	TGGQL
DNYPAAS	NYDASA
NVTQ	VTQN
NRNPAFN	NRPFNTAG
TAGNRPFN	NNPANR
SFQD	KNEE
IKAGK	QHK
YST	ACKGQ
YLCCKQ	LYMCCQK
ATDI	LES
GWK	PAD
QTALN	AILTS
DRFP	FPRD
TNR	RCEE
GDDTNT	RCE
RRPL	QMDID
RPL	QMDID
EQAA	QSSGGIM
LNTA	HPGG
EEEP	RKVGKG
EQA	QSSGGIM
SLNTA	HPGG
EEEP	RKVGGK
EQQAA	QSSGGIM
ELEEP	RKVGKG
RRA	TEEAT
RESE	MDGR
ERESE	QMDGR
RESE	QMDGR
EKEAESA	QSKGKGS
EKEAES	QSKGKGS
EKEAESE	QSKGKGS
EKEES	QSKGKGS
QA	SSGG
LNT	PG
LAEAEPA	RKVGKG
RRA	GTGEGAT
RRA	TEGAT
RRSRA	TGGEGAT
ERESE	QMGR
RRESE	QMDRG
HYR	DEW
ACSKAEEVR	NRTSEI
KVIWNRQ	ADMLSRKR
TN	NVS
QRIRDFL	ADHF
LKTLKV	FEQLTPK
LKETLKV	FELQTP
LKTLV	FEPT
LKETLK	FEQLKDT
LKETLKVTSN	FEQLKDT
LKETLKVTN	FEQLKDTP
LKETLKVN	FEQLKDT
LKKETLKVTN	FEQLKT
LKKETLKVTSN	FELQTK
LKKETLKVTN	FEQLKDT
KEHYD	GTSRYRK
KED	SKRR
ET	RYRK
LIPI	FFFKM
LIPIT	FMKY
LKTPL	KTE
EQLEAFV	RATILAEQL
AF	EQL
YFS	REHL
PI	RGLA
DPI	RLG
DDLE	RRHK
LKT	KTL
PTEFQLYKKKQDQFVLHGENY	NYGEELHFVDQKKKLYFQETP
ELKT	KLTE
PTEFQLYKKKDQFVLHGENY	NYGELHFVDQKQKKLYFQTEPD
PDTEFQLYKKKQDQFVLHGENEY	NYGELHFVDQQKKKLYFQTEPD
PTEFQLYKKKQDQFVLHGENY	NYGELHFVDQKKKLYFQTEP
DAT	KPI
GTNAR	RAHG
WYE	LNNK
WYE	LNK
WYEQ	LNK
YTNR	RSE
E	EKIGN
PFDY	EL
QY	STWRP
QYG	SRPST
QY	TSWRP
YGE	TWRPS
NN	PDGE
KPKSP	AWY
KPKS	AWSG
KPKSP	AWGS
KPKS	AWS
STR	QR
RN	VDGSD
REN	DGS
REN	VDGSD
REN	VDGS
RELN	VDGSD
NIKRWA	EMITD
HNGA	ARPG
HNGA	RPGA
LVSM	HVMGRY
VTAGEK	IFVQAE
VTEK	IFVQA
AIVQ	IGDC
AIVQ	IGD
EPGE	TRF
QEGE	RTRF
LAPGEA	LWTY
VVDKMDV	NL
VDKMD	LNSVH
VDKM	LNHSV
VDKMDV	LNHSV
PS	QETGAQ
AHDF	VK
DRKD	QRRQ
LDRKD	QRRQ
LDRKD	RQRQ
LGR	RSA
LGE	RAS
LGRR	RSA
LGRRE	RSA
LGRE	RAS
LDRD	RR
LDRD	QRR
LERKD	RQRQ
LERKD	QRRKQ
LEKD	QRRQ
LERKD	QRRQ
LDRKD	RRQQ
LDRD	RQR
LDRKD	QRRKQ
DRKD	QRRKQ
DRD	QRRQ
LCDRKDQ	RRKDTQQ
DRKD	RRK
DRD	RRQ
DRD	QRRK
LLRAIFGA	RVMRQLE
ETQLTPEEK	QARHGK
EELLIF	LEFLI
EELLIK	LEFL
EELLF	LEFLI
ELLIFK	LFELI
EELLIFK	LEEFLI
QLK	NTY
DGV	PR
HGQ	KYRT
YGSQ	KYR
RG	KSRV
NQFK	VSQ
NFKI	VQS
NQFKI	QVSS
SIDY	WLN
RTQM	TPPTF
GTADAEAA	EVLGEFD
EAG	EAARL
LEAAR	GEA
EAGE	EAARL
LERI	ERIL
TTLG	TTL
NDLTFLRIRK	KSKRIRFLQ
NDLTFLRIRSK	KSKRIRLFTD
RR	PSRDL
TTLS	TTL
TKQEK	NEDL
ISDLN	RVR
DAN	NAD
DAN	NDA
QRVEMRQMILREEQLLRIL	VVMRLIDLTVEKQLYIL
EMDVVMRQLIDLTAVLKIYLT	QRVEMQRMILKREALLIRKL
QMRVEMRQMIKLREALLRIL	EMDVVMRLEQITLAVLKYIL
IQRVEMRQMIKLREALLRIL	IEMDVVMRLQITLAVLKYIL
EMDVVEMRQLIDLTAVLKIYL	QRMVQEMRMILKREALLIR
QMRVEMRQMIKLREALLRIL	EMDVVMRLQIDTLAIVLKYIL
MEMDVMRLEIDTTGIVELKIHLMA	AHMLILKVIETGITLDREVMMED
IQMVVEMQMILTRGQVLLIKL	IKLLQLGVLRMITQMVEQMVI
IQMRVVEMRQLMILTREQVLLI	IKLLQLEVRLITQMMRLVEMVIQ
IQMVVEMRQLMILTREQVLLI	ILLQLEVLRITQMMRLVEMVQ
EKDVMRLEIDTIVLKH	ERQMLREQLLILQ
EQMVVEMQLMILTRE	ELITQMMLVEMVIQ
EQLIHLV	QRVEMMIQ
MQLIDLTEIQVLKIHLVQSEI	LHVLIVKIQETILLDMQRV
EMDVMRLIDTTI	RLRQELLIKRLQ
IEVMRLIDTEIVEK	QMLKREQLLILK
IEQMVVMQLMILEQ	LERITQMMLVEQMM
VMRQLIDLTEIQVLIHL	SLQHVLIVEQTIILLDM
MIMDVMRLIDTI	QMILRQLLILK
IQMRVEMQMILREEQLLRIKL	MVVMRLQILTEKQLVYILT
MVVEMQLILTEQVLIYLT	QMVQREMMILREQLLIRKL
IQVEQMILREQLLRIKL	MVVMQLILTERQLKYILT
IQRVEMQMILREEQLLRIK	MVVMLQILTEKQVLYIL
IQMRVERQMILREEQLLRIKL	IEMKDVVMRLQIDLTEKQLVYILT
KDIT	RQQM
IQRIEMRQMLEQLLRINL	IMDVIMRLQIDLTERQILKHILIP
IEMDIVMRLDLTEQILKIHL	IQMIREMRQKLTREQELIRL
MIQMRIEMRQMILEEQLLRINLR	MMEQDVMRLQIDLTEIRQLKHILIPV
EQMDIVMRQLILTREQILKIHLI	MIQRIEMQRMILKQERELLIRN
QRIEMQILREQLLRIL	EQMDIVMQLILTIEQLKHIL
IQMRIERQMLEQLLRINL	MEDIVLQLTEQLIKHILIR
IRIEMRQMILREEQLRIN	IEMVIMRLQIDLTIEQLHIL
MIQIERQMKLEEQLLRIR	EQMDIVRLMQIDTLEIQLKHL
MIQIEMRQMIKLREEQLLRI	EMIQDIVMRLQIDTLIEIQLKHI
IQMIEMRQMILREEQLLRIN	IEMIVMRLQIDLTIEQLKHIL
IMVEMQILREQLLRIKL	IEMVVMQLILTEIEQVLKYILT
IQRVEMRQLRQLLRIKL	IEMDVRVMLILTVEQLKYIL
TDFVS	NVST
SSGGES	QER
SGES	QER
REVSP	ERVPSE
NYV	EKKE
TYA	FREPQR
KRED	EDKR
DKD	GAK
ALDKE	KAHKG
MKL	MKL
MKLS	MKL
MKSG	SDV
MKSGG	SD
AEDVS	KSGM
RLTS	LTR
MRLTS	LSMRT
RLT	LRT
KQMGW	ELMQ
DMNR	KHDD
VPMN	YGIK
QQDSS	SSQDQ
QQDSS	SSQQ
EFAR	REFA
GTN	DA
FPFDK	FSQGR
FPDK	FQGRS
VIQKY	KYVIQ
EART	TALEQ
TASE	KFSG
GSNR	QGMFPT
GWQGPFGAVT	WGQGAVTGPF
YAMIAN	SAMAYEIN
WFGGR	GGR
MNR	HDKD
KRSEEE	ESRK
ANTG	NQ
NAHQS	KRD
RHGYEF	HNNN
QLHN	EGQIR
RHG	KFNT
FGNS	NS
NGI	IGNQ
FGNSP	NDGS
NGI	IGQ
FGNS	NGS
FGNSP	NDFGS
TDV	TFG
NQAN	NAQN
NQAN	ANQN
EHQ	EDSP
ATEW	RP
DLTK	PPSLSLG
GPDRWDPMY	RWGKVGRTG
RVWGK	KWGV
RVWGK	KWGVG
TSR	QEKTD
NCGE	EGNCP
KYIVDV	QKVLQF
THRQ	KSGEA
KIKSTISR	LPYSVTVEI
TGE	ERAAD
TG	ERA
TGVE	ERAA
PGSI	VR
AGA	ERP
TGVP	RA
EP	RVTP
TGVP	RAA
TGP	RAA
TGP	ERAA
TGP	ERA
AG	ERPA
AGL	ERPR
GIDAS	HRVTS
GIDPV	VRVT
PDLEH	VRQ
SGTME	YHV
ASVDVD	ERTRR
TGV	ERA
TGPVDEI	IERAADNAV
TVED	ERAAN
TGLPVED	ERAANVA
PGEVI	VRVT
GPEVDIQ	VRVTP
TG	RAA
TGE	ERAA
AGAVD	RPR
TGVP	RAN
TGV	RAN
AGAL	ERPKR
TGPE	RAA
TGP	RAN
PGRID	VR
GRIDP	VR
TPGV	RAAN
TGPV	RAAN
AAGLD	ERPAKR
AGDLAL	RPAK
AGVA	RPKR
AGAMDL	ERPAR
AGVA	ERPAR
ALA	ERPAR
ALAD	ERPAR
AADL	ERPAR
ALAD	ERPAK
PEDV	KTP
AD	ERPAR
GPIQ	EVRVTP
GVD	EPA
GTVP	ERA
TGVE	RAA
TGVPE	RA
TGV	RA
ADI	HRVT
RPGI	EVRR
TGIE	ERAA
TGP	RA
GTVE	ERAA
TG	ERAN
TGVE	RAAN
TGE	RAAN
TGE	RAA
LNAG	KEL
YVSGA	RGL
ELLYGMDFRFSRN	RLAPIVGKPLEIVFMKAK
ELLYGMFRFSRN	RLAPIVGKPLEIVFMAK
KSRYSD	VNLNR
KSRDYS	NLNQ
KSRDYS	NLN
SKRDYSI	NLNRQ
SKRDYS	NLNR
KSRDYS	NLNR
KSRDYS	NLNRQ
SSKRDY	NLNRQ
QGGYQ	QG
DAEA	QAR
EDKHY	VE
ETE	HEDK
YHKT	VSGAEL
YHKTE	GADRM
HYK	IGSGA
HYK	IGRSGA
YTKE	TSSAR
YKET	GADTSADR
YKT	VELK
AEKLKLKSEILLWTELEKTAIRQQLQM	AEKLKKLSELILTWEKLTEIAQRQQL
RTG	LEV
GPD	EGY
EADKVS	RVNDFN
QNHE	EDEKK
QGE	EQG
TRFH	RFTH
KMS	EPD
EK	EAN
SKYNS	LHQR
HPHRPG	PHHRPGR
HRPHPG	PHHRPG
HRPHPG	PHHRPGR
HHRPPG	PHHRPG
RHPDHPG	DPHHRPG
VVY	YLYL
TLLVQAIEFR	RFAIVQLTL
YIDLAQN	TDLKIKS
LLDVTEIYFE	FYEVTLLD
LLQIKLSI	ILSILKQL
II	LQIK
AINKIHD	KDNKII
RKW	RVE
KKW	REVE
YAD	SKAQR
GLELVSRV	SRVGLEL
GLELVSR	SRVVGLEL
GVEVTTER	ERTTGVEV
VGEVTTER	ERTTGVEV
LNLKQG	RPN
RLAVLGHKR	TYDE
QKN	DAQNQ
PAVYG	GAVYP
LPAH	HALP
LAEPT	AEWPT
EKNW	AD
KEGERE	VEVKGAF
LHRTID	RVLHDTI
PEQ	PEQ
IAPI	IAPI
WLQGE	R
KLLP	RSGF
GFRS	LLKP
PTT	TTP
IRTS	RTSI
GDNI	NR
IPNVYF	IKGT
IKGT	IPNVYF
IKGT	IPNVY
IPNVY	IKGT
IKG	TTYF
TYFT	IKG
IK	TTYF
TTYF	IK
TYFT	IK
TTYF	IKG
IKGS	TTYF
TTYF	IKGS
IKGT	PGQY
GQY	IKGT
IKGT	GQY
PGQY	IKGT
GTYF	IKG
IKGS	GTYF
GTYF	IKGS
GTYFK	IKGS
IKGTI	INVYTF
INVYF	IKGTI
IKGTI	NVYTF
INVYFT	IKGTI
IKGT	INVYTF
IKG	TTY
TTY	IK
STYF	IKGS
IKGS	STYF
TSFPD	DSF
STYF	IKG
IKG	STYF
STYFK	IKGS
IKGS	STYKF
STYFK	IKGST
STYF	IQGS
IQGS	STYF
IGDN	AGLQ
IKGT	VGQYF
VGQYF	IKGT
VPGQYF	IKGT
IKG	VGQYF
PGQYF	IKG
IKG	VPGQYF
IKGT	VPGQYF
IKT	STYF
STYF	IKGT
IKGT	STYF
TYFS	IKGT
STYF	IKT
KGGV	TY
YT	VKGG
LKNNKG	LTEYD
LTEYD	LKNNKG
KGI	TTY
TT	KGS
KGI	TY
YTT	IKGS
KGS	TT
LRLKLELTHDQELHEVKLLELEREMLQ	LKLLETLHDQLKHEVLKELRLEERMLK
RI	VKMG
VKMG	RI
GPKE	TIK
HHPENK	YNGNCSN
GMDV	KL
LRGES	IELQ
PG	KGY
PG	KGAY
PGE	KGY
RLQQEG	KEQ
RLQQEGE	KEQ
RLQQEG	KELQ
KIGS	DYEK
EQNGES	ARQNRNI
QERNIN	RQEGN
RQQNEGES	QGENRNI
QERINN	QEGEN
TNMGTDKP	PGMTDNT
TNMDGTP	KPGMTDNTT
TNMLDGTKP	KPGMTDNT
TNMDGTKP	KPGMTDFNT
TNMGTDKP	KPGMTDNT
TNMDGTKP	PGMTDFNT
MTNDGTP	VPGMDNT
MTNDGTKP	VPGMTDNT
TNDGMTP	PGMTDNT
KN	SIPD
KND	SRNS
NVK	VKE
LARLAE	RLAC
ANYN	SDGE
ANYN	DGE
RKDT	EIH
TKELLQ	KTELLQ
PDTD	DDTP
YKFR	FRYK
YKR	RYK
KLSG	QA
AQ	KLSGR
QAG	KLSG
YGLT	GTG
HITYNGLT	IHTYNGLLT
FSK	KDFS
DFSK	KDFS
PSL	FLQR
PSLL	FLR
HITYETGL	IHETYTGLS
YSI	YSI
R	SESAS
VFAMAITK	TMKAIAFV
SHTE	HSTE
GTE	QKM
VKFAMAITK	TMKAIAFV
GKE	QSEE
ASDLI	SDI
ETE	ETE
ETEE	ETE
KER	DID
ISPI	FMSSS
ISP	FMSSS
FFRK	FRFK
RKLH	ESDGSS
SEGSSWSD	RKLH
EDTARSQ	SQRDTAE
HGD	EDFKH
HEG	FDRK
QVGS	DN
W	SDQQN
SDQQN	W
SYA	NTTG
MQQTEKKT	SRQRAENKNDRE
MQQTETKK	SRQRAENKNDRE
SLDGRAAQAR	VEKTMNKKNL
SLDGRATARQA	VEKTMNKKNL
PYNVFGP	RRKQME
PYNFGVP	RRKQME
YPAADQ	PTGKSY
NAKREIDS	IDSTPL
QL	TPNGQ
GLV	TGG
LWPSTPVITILIN	IVINWVVVVAAVAF
IW	FNWL
VSGAF	L
VLSGA	WL
DAKHFFW	YIWLVLQ
ILLLN	FLLIVTD
LPRVILLL	IILVFLLIVD
DAKHFFW	YIWLPLQ
ILMLNL	FLLITDL
LPRVILLL	IILRVFLLIVD
DAKHFFW	YIWLPVLQ
RPFV	SYW
MIWRFL	PRFVF
PRFVFVL	IRFLII
DPRFVGVFV	MIFRFLM
FLL	FLIL
PWFRW	SYNW
PFVR	SYW
VFLWDH	LMILST
LWP	LMIS
WIN	FVSS
YVLV	FVLS
FFDH	FGLS
FSGYWQS	TLFGLSNW
VLWDFH	LMILST
LPW	LIS
FV	HMLS
LWP	LMIST
FVL	HMLS
RQLY	MIFR
VFFALIWV	VFFLVMLILS
KEN	WMIFR
WWN	LIST
WWNP	LILLST
ASSPG	DRR
IIH	MLTN
LLLAA	FLSTNW
YAVLDGPEQ	LDRRVTA
PNAAG	WMIFDPRR
FSL	VLMLI
VSF	MIF
PQPLAAN	WMFDPRR
IFSLAD	FLMLI
MKGWAGFL	WMIRFM
RMAGAGF	DQLY
MKWGAF	WMIRF
RSD	RQTP
ELEITV	NLLKE
ELITV	NLLKE
ELITV	NLLE
LEEITV	LLKE
ESVIN	LLKS
EVIN	LNLK
LTV	LLKE
LITV	LLE
ELI	NLLE
ELI	NLLKE
ENAQIN	RDLLQ
ENAIN	RDLLQ
EAQYININ	KRLLQ
IIVYISI	YV
IIVYIS	Y
KEFS	EFSK
KEFST	EFSKT
FSET	KYQ
GTKK	LVYG
KGK	VYG
KG	VYG
GTKK	LVYGKD
KYQG	SFE
YGLV	KKGT
VYG	KG
GTKK	LVYGD
KGY	KHI
CGKH	YGK
EMLEGNE	KKGT
MTKPEKH	HEKKPMT
YVG	KKG
GIP	FK
YAR	RLR
EDS	RHSLED
EDS	SLED
SNGD	PDKS
DRRHRN	RNRHDW
KY	RDSD
RDDSK	KY
IVNRTQE	QETIVNR
IVNRTQE	QETTIVNR
EGM	NTD
RS	GVASHD
RS	GDASHD
RS	DASH
RS	GASHD
RS	GASH
NNY	NNQ
NNYT	NNQ
NYNT	NQ
QNN	TNYN
QN	TNYN
RELNEK	SEKE
DN	NEGK
NRS	NRFS
KE	EKNG
DS	KWK
RKILT	EVLEGQ
QGD	GLEGQ
EGQ	KRVDEIR
QGD	LEGQ
FGP	MILP
FG	MIL
FGP	GMILP
QDKM	QSG
KGH	DVAK
KHG	DVAK
KSAAKHAAA	AAHAAKKSA
YWP	EEYFS
YPCE	EEHI
TIEF	FTIE
HSF	SHF
TFI	FTIE
TEFI	FTIE
RTWHVPDKT	TDKPVTRWH
QHLTE	EQKQ
PSL	PSL
HGY	REEQE
GHY	YREEQE
TDT	TGDPT
SILANAASAARNAAQKAAANDALM	KILDAKAQANDAAADAADARARLM
KILQDAAKAADAAADAADAARRLM	IDLSAQANADASANARAQAKAAANLDM
ILSANAADASANRAAQKAANALDM	ILDATAKAADAAADAADAARLM
ADSAANAADASARNAAQKAAANDAA	KAADATAKAANDAADAADARAR
KAADAQAKAADAADAADAARR	ADASAQANAASANARAQAKAAANAD
AASAANADASAARAAKANAD	KAADAAKAADAADAADAAR
WDSWWWWNDWWRWWQKWWNAQDWAT	KWQWDWWKWWDWAWDWWDWWWW
KQWDWWKWWDWWNADWWADWWWRW	WWWWNWDWSWNWRWQWKWANQWDA
WSWWWWNDWSWRWWQKWWNQDWAW	KQWDWWKWWDWAWDWAWDWWRWW
WWNWWDWSWRNWWKQWWANQDATW	KQWDWWKWWNDWAWSDWAWDWWRWW
WSWNWWDWWNRWWQWKWNQWDWA	DQDWWKWWDWAWDWWDWWWW
FDFFQNFFDFSFNRFFQKFFNFFDFAY	KFFDFFKFFDFAFDFAFDFFRFFY
KFFDFFQTKFFDFFADFFDFFRRFFY	FDFSFQFNFDFSNFFRFQFKFAFNFDFATYR
FDQFSFNFFDSFFNRFFQKFFANFFDFAYR	KFQFDFFKFFDFAFDFFDFRFRFFY
FDFSFQNFFDFSFNRFFQKFFANFFDFAR	KFFDFTFKFFDFAFDFFDFRFRFFKY
FDFFQFNFDFSFNRFFKFFNFFDFAYR	KFFDFFKFFDFAFDFFDFRFRFFYR
RSQNEYR	REYRSQN
YKANMSLDKEFMVKLLQMLELRQSYQKNEFEKHEALQFQVKLAREM	KYASNLDEKFMQVLKMLLEQLSRQYKEFEKAHLQQFVKALREL
LEELK	KLLEE
YKANSLDKEFMVQLLMLELRQSYQKNEFEKHEALQFQVLA	KYASNLDEKFMVLKMLLEQLSRQYKNEFEKAHLQQFVKAL
GCPS	GCPS
IKY	SCDSG
NPSIGLE	PCNGFGIYC
NLEVLDLNSSDFSGLFPLIN	QLKVLNLTHNSLSGSILLNL
NLEVLDLNSSDFSGFPLINL	QLKVLNLTHNSLSGSILLNL
NLEVLDLSNSDFSGLFPLLIN	QLKVLNLTHNSLSGSILLNL
NLEVLDLNSSDFSGLPFINLL	QLKVLNLTHNSLSGSILNL
SGS	SGS
NLEVLDLSNSDFSGLFPINLL	QLKVLNLTHNSLSGSILLNL
SLKYLDLNTHNLSG	SLTTVDLSYNILSDKIFI
KKLKSLSLENHGIDLLGH	KNLGWLFLDENKVKLLKD
KKLKSLSLENHGILLGH	KNLGWLFLDENKVKLLKD
KKLKSLSLENHGISDGLHL	KNLGWLFLDENKVKDLSLKD
SYN	NFRLT
TLLSDEVLDLSYNS	NFTNLKVLNLSHNN
END	NNGI
EDLKTRNV	RNLKELDLS
LTNRV	VTNLKELDL
GGGLD	AAA
QLIQYEVVRL	ANASLTELSLRN
ERQLS	AAE
LIQQYEVVRL	NASLTELSLRN
QLLQCQVVRL	VNPALAELNLRN
TNLTALYELNYQLQ	KNLNELRLDFNKL
TNLTALYLENYQLQ	KNLNELRLDFNKL
LLLSRTLNSHRI	WLPRLELLDLRGNKL
NSD	IIN
IIN	NSD
LLSLRTLNSHRI	WPRLELLDLRGNKL
FLKTL	W
EKLGILYLNNNQL	LKNLEVLFLNGNSL
QNLQKLKLYNEQL	QNLQQLHLSKNQL
THLIRLYLQNDQINH	TKLKEFSIVRNSLSH
TSLRKLYLQNDHI	VNLTELSLVRNSL
TSLRKLYLQNDHI	VNLTELSLVRNL
TNLQTLHLRNSQL	TNLQNLDLSFNQL
LLLSRTLSNHRI	WLPRLELLDLRGNKL
TNLRKLYLQNDHI	VNLTELSLVRNSL
TNLRKLYLQNDHIN	VNLTELSLVRNSL
TNLKELVLVNEQL	TNLTYLILTGNQL
VHLKELFMCNCKL	TLTVLDLGTNQL
VHLKEFLMNCCKL	TQLTVLDLGTNQL
VHLKEFLMCNCKL	TLTVLDLGTNQL
LNR	LSN
LSN	LNR
VSLHTLSLNDHMI	FLEELDLSYNNL
FPLPSLERLLLGNYEI	YGFALPNLLQLHLEHNNL
TKLKKLNLNANKLR	SQLQELYLQNNDL
TKLKKLNLNANKLR	SLQELYLQNNDL
HLKEFLMCNCKL	TQLTVLDLGTNQL
GRLEILVLSFCDL	PLQHLNLQGNHF
KLRELWLNRNPIE	ALNTLELFDNWL
TKLVS	SKTLV
VVIFKI	LTILR
RLFLSK	IRQIIL
RIFIE	VIVVLK
EALSII	QIFVR
RIYL	KILLK
RIVTQ	ITLITS
EED	KEFPML
IRLVELG	IVVLR
ILFYR	KMFLR
LKMIR	LYIRG
IRVVIM	TLLQS
RYIVQ	IIMLEA
RLLVL	IRFLIL
IRSLT	VSMTV
IRLVE	IVVLR
ILFYRI	KMFLR
KLMIR	VLYIRG
RSIVVIM	ITLLQS
RIYVQ	IIMLEA
RLLVL	RFLIL
IRLVEG	IVVLR
LFIYR	KMFLR
IRVVMG	TLLQS
IRYVQ	IMLEA
RLVL	RFLIL
IRSLTE	VSMTV
IRNLVEG	IVVLR
EALMII	QVYIR
RLFMK	IRYFIL
RGIYLV	RIMLK
RINIY	ILSTVV
VVIFK	LTILR
RLFLK	IRQIIL
AELSII	DQIFVR
REIYLV	KILLK
AIN	STVV
RLFLK	IRQIILP
IRFIE	IVVLK
LEAISI	QIFVR
RGVI	TLIT
REIYL	KILLK
IRVTQ	TLITS
LKVVIV	EIFIR
VRFQI	ISLEA
RIFVME	VRYVYL
RLFVD	VTLIST
SSLSVL	EIYIR
RLELQA	IKFIKL
RVFLMIP	VRYVQL
RIFAD	VVLVAP
CPILVV	ECYIR
VRIYL	KYLRI
TSIYLV	LDQILLN
VHVSA	VAVSH
HVSVA	VAVSH
VHVSA	VAVH
QAEREEKRV	AEREEKRV
NSRIQ	NRSRIQ
LRQITL	KFIVV
KLIFKI	AQLLR
SLLMRHG	VMYISE
RIYIE	LVSLSS
IGEVE	IH
HI	EIGEV
EVV	DIH
NGE	DNR
QNEV	YIH
QPEA	DIFN
KKD	KLNLDE
KDK	KLNLDE
PRLL	DFN
RLLP	FN
YP	DGRV
YRQA	FEQI
ENAN	DR
ENA	DRK
GEA	VGP
KEAE	AEEK
VKAKEA	VKEAA
VKAEA	VKEAAK
KEE	AEEK
NNEA	NENA
GSGFGQES	ESQFGSGG
GQKGSS	VTKHI
IGSEQ	KRR
HKRDSD	DSAHKER
DAES	MSRH
RHAMS	AESD
QRE	KAKDSD
NHQTV	NTHVQ
KGRTDV	NIPDTAN
RTDGRNK	GDQAR
ATTV	NGNNIP
WG	QIRGC
QGI	GIQ
GDIA	RFE
GDWS	NN
AGIEDNC	YQGISLSDE
NN	RGISDSW
RRF	FARGTT
RRGY	RRYGTT
RGYS	EMRGLES
RRGY	YRRYGTT
AKG	GVTE
GAESIDCN	YQGISLSDE
RGISDWS	NN
QL	NARIS
RQ	DQLD
QLDE	DQLD
KHALDA	DHALDA
EENLTK	NTEGGAY
DTSR	NG
DTS	NGK
QER	RQE
QTKY	SDA
KG	SGV
NCI	NCI
ETQWQ	WTEQQ
SRMAEVKNGL	EQARHECIRA
LDLNEIVKIIILEIDLANTLEILVM	LRLHIQVEIIKLIVLKTALIHLM
LDLNEIVKIPIILEDILTNLIELVMM	LRLHIQVIIKLIVLTALIHLM
LDLNEIVKIIILEDILANTLIELVMM	LRLHIQVEIIKLIVLKTALIHLM
LDLNEIVKIIILEIDLANTLIELVMM	LRLHIQVEIIKLIVLKTALIHLM
LRLIHQVIIKLIVLTALIHLM	LDLNIEVKIPIILIDLTLIELMMI
LDLNEIVKIPIILEILTLIELVMM	LRLHIQVIIKLIVLTALIHLM
LDLNEIVKIIILEDILANLEILVMM	LRLHIQVEIKIKLSIVLKTALIHLM
IKEDNIKKLLSLEVISQIQRSILHLI	IHENQIILELLLKVIKKINQNILELSIM
HINQIILELKLVEKIINNQISLELSMI	KIDNIKLSLLEVSIQIRQSILHLI
GSHSTINK	HEQSESE
NIHQIILELKLLVKIINNQILLEMI	KIDNIKLSLLEVIQIRQSILHLI
KK	SESI
EESLSQH	KNISTEGSS
HINQIEILLKLLVEKIINNQILELSMI	KIDNKIKLSLLEVIQIRQSILHLI
IDNILLKLSEVISQIQRSILHLI	IHNIILELLLKVIKINQNISLELI
NIHQEIILLKLLVKIINQQILELMI	KIDNKIKLSLLEVIQIQSILHLI
HINQIILELKLLVKIIKNNQILELSI	KIEDNIKLSLLEVSIQIRQSILHLI
IHNQIILELKLLVKIIKNQ	IDNIKLSLLEVSIQIQ
IDKNILLKSLEVIQIQ	IHNQIILELLLKVIKKINQN
IDNIKLLSLLVIQESIQ	IHNIILELLLKVIKKINQN
HNIQIILELKLLVKIIKNNQ	KIDNIKLSLLEVIQIQ
HINQIILELKLLVKIINNQ	KIDNIKLSLLEVSIQIQ
IKDNIKLLKSLEVIQIQ	IHNQIILELLLKVIKINQN
HNIQIILELKLLVKIINQQ	KIDNIKLSLLEVIQIQ
HNIQIEILLKLLVKIINNQ	KIDNKIKLSLLEVIQIQ
KKED	EDKK
HNIQIEILLKLLVKIINNQ	KIDNKIKLSLLGEVSIQIQ
IKDNIKLLSLEVISQIQ	IHNQIILELLLKVIKINQN
HNIQIILELKLLVKIINNQQ	KIDNIKLSLLEVIQIQ
HNIQIILELKLLVKIINNQ	KIDNIKLSLLEVIQIQ
LHKVVQKMVIQELVTTLIM	LEVDVLAQGSVIKLSVKLAIEMA
LRLIHQVEIIKLIKVLTKALIH	LDLNIEVKIIILEIDLATNLIEL
LDLNEIVKIPIILEDILTNLIEL	LRLHIQVIIKLIVLTALIHL
LDLNEIVKIPIILDILNTLIEL	LRLHIQVIIKLIVLTALIH
LRLIHQVEIILIKVLTKALITH	LDLNIEEVKIIILEIDLATNLIEL
LDLNEEKIVIPIILDILTLIL	LRLHIQVIIKLIVLTALIHL
LRLIHQVEIIKLIKSVLTKALIHL	LDLNIEVKIPIILEIDLATNLIELV
LRLIHQVEIIKLIKSDVLKTALIHL	LDLNIEVKIIILEIDLANLIELV
LDLNEKIVIPIILDILTLIELV	LRLHIEQVIIKLIVLTALIHL
AVII	AVII
LD	RGM
EARISE	ESRIEA
TDFKQLL	QIDE
EKII	RKY
GQDP	QGD
IHT	THI
QQS	NDTSLL
ND	TTHN
GSRG	RGGS
LNME	RAQLH
LNAME	RAQLH
LNEM	RAQLH
LME	RAQLH
RGAQ	QGR
YALIID	AYLDII
RRQ	IQTSE
AE	KAKN
GGD	RERGD
TDT	DTT
PIGLAT	LR
TEKPVNDA	FEQIHELDTF
TEKPVNDA	FEQIHEDTF
ATAE	DGII
ERAGN	PVYHGNE
HE	EIAEE
ESGQ	DR
TKG	ENKQ
TG	ENKQ
RSKKER	MDYGR
GKD	GK
DGIDASA	KDLSPEN
GQES	EGQS
ESLA	KRERD
QEN	ETRQ
HFPKEECVE	EISVNAKVNRN
LSYRISD	SIKIDKVNE
IDKV	VRL
FPSR	AKV
SEYRS	GIL
PKEFECE	VNKVNRP
VYDSIS	RIDHT
ITYKISDR	GIVIDRVNI
ITIYKISD	GIPVIDRVNI
ADG	DVA
DIYST	MIIY
IKDQDRE	MIEFVKN
IKDQR	MTLETVK
EIG	GIPEQ
QNL	INLQ
SSHV	SSHV
KSYF	SSHV
SEK	ED
WVDT	KPKIY
WVDGT	KPKIY
GAGILLAANVEALVNE	LYGLAGGRTTDLKIIVNSTS
RL	PAST
LR	LAST
DSG	GVQ
RDIAY	SVICP
VSCPI	DRIAEY
VSCPI	DRIAY
RDIAEY	SVICP
LEQGNA	LWPVL
LQGNA	LWPVL
WPVL	QLGNA
WPLVL	QLGNA
LGNA	LPVL
WLVL	QLGNA
PLVL	QLGNA
KTEVK	DQNLTKK
WPLVL	QLNA
NKQ	NTH
LVL	LGNA
QEEK	QEE
LQGNA	LPVL
LQNGA	LWPVL
HLL	ENL
LEN	LHL
RPSNL	NLSRP
LQNA	LPVL
LQNA	LWVL
LQA	LWPVL
HSEHP	EEH
EHE	EEHR
HEHPS	EEH
WLVL	QLNA
LEQGNA	LWPVKL
LQGNA	LWVL
DNEG	NDE
LASII	NTV
LASIIE	NTSV
KK	REAEE
HES	ESH
AGI	NAGIP
ALAAAGSVH	HAGSALAA
AALAGSA	AGSALA
EGRD	SGERD
HES	EQ
EQL	VHES
KIADG	IKAG
DEG	EDG
GRED	GERD
HLAILSV	VLLIH
KVVDGL	SVVKDGL
GQLR	EIAG
RDD	LDR
GNQHIP	TSDF
QGDPGN	GNQPGD
PGQH	NRD
SGEG	EK
HAMAQSV	RIEPT
RNGLN	LEMDAE
RNTGL	SLEMDAE
KGVEN	QKT
KGVEN	QQKT
KEGVEN	QKT
RNTGLN	LEMDAE
KDSEN	QTKT
VEGV	DVGV
VDV	DV
VKSI	SIVKA
ILVH	VILH
PGLTEQ	DRIQSSG
NHYLNVNNC	YHNLNVNNCK
NNHYLVNNCK	YHNLNVNNC
KPAI	NDT
TYS	TYSP
DNT	AKIP
TYSP	TYS
ARG	DPT
SKG	SKG
KEDLSQDE	KNFNKKGG
KNNKGG	KEDLSQDE
KSAELS	ASLSA
DKKA	KADK
RRTTGD	DGVRPFR
RTTGD	DGVRPFR
RRTTDG	DGVRPFR
AMLTARNLEAQDLSAGRTTAG	LGAVLDGANLHGANLNNANLS
TSFKAGDLTANVLTAEI	FNGSALIGADLHGADLTNG
TSFKAGDLTANVLTAEIM	FNGSALIGADLHGADLTNG
NCSFKLNSINE	CIIRALFENS
NCSFKLNSINE	CIIRALFENSF
NCSFKNSILNE	CIIRALFENS
GASELFRCILNSDLFLYYAK	MERFVDCKMLGVNWTAQAAL
GASELFRCILNSDLFLYYAGK	MERFVDCKMLGVNWTAQAGAL
NRSN	DNTGP
GGPL	LGG
DETPNLGG	DENTLGG
RFSN	DNTLP
RFSNN	DNTLGGP
EPYLDPK	HKEG
KEV	VKE
KVS	SLKE
DSSASFLAAF	AASFADSS
GWSWSLD	AFSWQ
DSSSFLAAA	AASFADSS
GWSWSLD	AFSFLADSSGQ
YSKR	RDVE
GEEWWG	ESFK
RSKSG	KGQLI
SCKE	ESCK
KYSR	ERDVE
YNNPKL	KNQH
DGYV	KAG
GIQE	RT
PQQAMFALLQ	RMFE
QFALL	RMF
MEKALLNP	FSFMLASN
EKEMLLNP	FSFMLASN
MEAELKLNP	FSFLASND
MEKAELLNP	FSFMLASN
NAYA	KTA
RYEVNKE	FSFDH
PDEAYIRT	QKGIPV
RDCA	CADNR
LET	SDTI
VLT	TLSV
RWLNSGVQWEQ	EQQWVSGWRLN
KNDTK	KTND
NKT	KTND
KNDT	KTN
KNDT	KTNSD
KEKSLS	SKEKLS
ALHR	HRLA
EE	TKEQ
SNE	GGR
EE	VKEQ
EE	KEQ
RK	PDMN
QSLYG	KM
HSEK	SH
KMNS	SKMN
IYG	EHGDF
PAG	GQ
EKAN	KESG
QSH	TEQ
YAR	ISTDT
LESSYITIAVRHR	TGSEIRARDDA
NWLRQ	TSATES
NWR	CTSAE
NWR	TSAE
NWLQR	TSATES
NWRE	TSATES
WNRE	TSATES
NWRQL	TSATES
NWLRQ	TSATE
WNRQL	TSATES
WNRQL	TSATESE
WLNRQ	TSATES
LNV	NVL
NRGK	RNGK
KGE	SK
IDGVTTPEH	HTPETVIDG
IDGVTETPH	HTPETVID
END	EQR
QPKSVNHV	HVNVQPKS
RVDA	VRDK
YRN	ARE
REAR	ERNY
DVR	PNDP
DLVLVATIAEGAL	QFRNTFSTTKGFV
WDT	LPFTS
KYV	NVNI
VNP	PLQ
RATVL	DSR
ATVLR	DSR
DRHVSSK	RDKHS
QLPS	SPLQ
DKMGI	KDIGM
DMGI	KDIGM
KDMGI	KDIGM
YPMQ	QYPM
VSD	DVSE
LRLT	TLLR
PQQIG	QPGQI
RPPS	LSR
MY	TPVT
MY	GPVT
NGQ	EQA
GNQ	NEQA
PEKN	DK
EVPG	RST
EPGV	RST
GNK	KNG
VLK	KLV
ADWRDK	LSD
WDR	TGS
DNE	QTF
TTGY	TDKN
YDASTGKIMM	KNQLIIT
RELE	GGSRER
VQL	DK
SSMRSQ	EVPE
SSMRS	EPE
SSSMRSQ	EPE
RGDL	LGDR
EYETHG	QTH
YLSALL	LRLA
GYDP	SWSKD
ENTN	NNTE
SEENK	KERQGID
SENK	KERQGID
SIENK	KERQGI
AEIA	IQ
QQMQF	QQN
KSE	EGKK
LHWTYYW	WYWTYHL
SGV	SNKG
RLQ	GKATVQE
YTSYG	AKTR
ATNQK	RGE
ATLNQK	RE
NG	QLNQ
ELAASFIFW	PLSGILGLVVY
EMAASFIW	PLDGLLGLFAY
FITAMVTL	PLCGILGLV
LSIVGLGWVLLQ	GFYYKR
LSIVGLGWVLLQ	GFYYKP
LIVGLGWLLQ	GFYYK
MEAASFIW	PLGLLGLFAY
MEAASFIW	PLGLVGLFAY
EMAASFIW	PLGLGLFAY
WLVVTW	LATGGYY
WLVVTW	LLATGGYY
WLVVTW	LATGYY
LVGLLIQ	YLTAALFR
MVGIVLVE	YLLTLY
LVLLIQ	YLTAALFR
LVGLLLIQ	YLTAALFR
ATLVLVTSWW	LAAYFLFTAL
AQIACVAFLW	LTSYLLALTY
ATVLLVSTWMW	LAAYFLFTAL
FSLSVFWGLLS	MMTGLIGFLLE
VVW	LVLLLI
VVW	LVLLL
LFTIAVGLWN	LSLIVGWLGVLLQ
NT	SRRTP
AQRE	ERAQ
ISKDV	SDQH
RKSVL	FNDQ
EGKE	KAK
EGEK	KAK
GGF	TVKITHI
RQVD	QVDR
KRG	TR
DGE	WEGSN
KGP	PSK
HKC	NRKT
DPN	NDP
NESS	SSNE
TKE	VPERR
KE	PETKE
KTE	PRR
KTE	VDPRR
RGYIDFG	NEGRY
REND	DNER
IRYGG	KNEGRY
RYFGGQ	EGR
RENDY	DNERY
RGYF	EGR
ALKD	NI
SVAKN	RSLEV
VEYRG	NVKASR
NIKALD	WHNIA
YFGG	GR
MADSAQ	RTSEYV
VEYTRG	QASAPML
GRGYFG	NEGRY
AYPA	VPQS
MAALRVA	ILTN
MAALRVA	ILT
MAALVR	ILTN
YYEAMVAIGFT	AKFLQAIAWVVVI
DPAALYSAYAMI	WVVGIGLFFKA
KAFQLAIWAVVVI	EYYAMVAGIFT
WVVGIGLKFFA	DPAALSAYYAMI
YGNAP	VNT
DT	SQQL
VGAH	HSIG
KAER	PRTP
YPRR	NG
TKT	IAEG
NTVY	HN
DNTVY	KHN
NTVYD	HN
HHH	HHH
KFEH	QKE
NDIF	NAFT
NDIF	NAF
KASTRVVTLDTPEVVTCNRLITGTELVQKGGTMRGINEHTGGELSSNG	TVPVVMVKASTRVTLDTPEVVCTNRLITGTLEVQKGGTMRGNIEHTGGL
TVVPVMVKVLASTRTDVTPELVCTNRTLIGTEVQKGGTMRGINELHTEGG	MVKASTRVTLDTPEVVCTNRLITGTLEVQKGGTMRGNIEHTGGELSSNG
KASTRVVTLDTPEVVTCNRLITGTLEVQKGGTMRGINEHTLGGESSNG	TVPVVMVKASTRVTLDTPEVVCTNRLITGTLEVQKGGTMRGNIEHTGGL
KASTRVVTLDTPEVVTCNRLITGTELVQKGGTMRIGNEHTGLGESSGN	TVPVVMVKASTRVTLDTPEVVCTNRLITGTLEVQKGGTMRGNIEHTGGEL
KASTRVVTLDTPEVVTCNRLITGTELVQKGGTMRGINEHTGLGESSNG	TVPVVMVKASTRVTLDTPEVVCTNRLITGTLEVQKGGTMRGNIEHTGGL
EYADESVMTVDTPRTTTFGDEVIQKGLGVKGKSQFDSNITAPDAIINGTKHHDSRGT	TCKTVEVYADESMTVDTPRTTFTGDVEIQKGLGVKGKSQFDSNITAPDATDHIHGDSGGTTG
WN	GFMNK
IGQGNE	MNR
RMN	GQGNEI
GFMNK	WN
WDN	GFMNK
EA	DAG
EAD	DAG
LANLATIRAENQTLFAMTEQ	FALTNQAIETRLANALLQS
QTLAYAGL	TQLAYALG
LANLARTIAENQTLFATMQ	FALTNQASIETRLNALQ
IQTLAYAGL	ITQLAYALG
LNLATIRAENQTLFAMTQ	FATNQAIETRLANALLQS
NLNALATIRAENQTLFAMTQ	EFALTNQAIETRLANALLQS
GGEN	GGE
GEG	NGGE
ERS	RTES
LSN	NLSM
RSPVLQY	QVLRSP
PRSVLWQYY	YQVYLRSPE
PRSVLWYQY	YQVYLRSPE
NQSIT	NEAGE
HN	EAY
HN	EAYL
GE	RSPE
KT	NEGE
NETGE	KT
THKK	NE
ETGE	EKT
ESTPPL	RER
RIGSF	SNEAISSCYY
REIGSF	SNEAISSCYY
RIGSF	SNEAISSYY
REIGSF	SNEAISSYY
EIRGSF	NEAISSCYY
RESIGSF	SNEAISSYY
RESIGSF	SNEAISSCYY
REIGSF	SNAISSYY
VTCGV	VTVGI
TELV	NKI
IKN	VLT
TLV	NKI
IKN	VELT
KE	PVTK
KTELNL	SEENK
KSND	CATK
GVSKE	GVESK
QPYNES	QQGAHHN
QPYNES	QQAHHN
FGIGG	GIGGF
GGIGF	W
W	GIGGF
W	GGVGGF
GGIGGF	W
HPT	MGI
IWGIV	INN
VIWG	INN
VIWGI	INN
IWGV	IN
IWGV	INN
RII	KNN
VIWGL	VNN
VWGII	INN
WGIVI	INN
VIWGI	INNK
VIWG	IN
VWGI	INN
GIVI	INN
WQ	NETP
WQ	NNET
EELE	KQGQG
EEL	KQGQG
QVGKF	KFVQG
DDVKVQGID	RYVEDDK
RYEDVDK	DDKVQGISD
QVGK	KFVQG
YEDDKVQGID	RYVEDDK
RYEDVDK	EDDKVQGISD
VGIAP	GVTGV
VGI	GVGV
YLQ	YMENL
MNLY	YMNL
KNK	NTEE
NKK	ANA
LGY	KRIL
SMV	QLY
QRSL	GDDGQKS
RQ	DLSK
AYGHRKHK	TEQITRVDMEI
IME	QII
QDFYCV	GFVCL
EVCVILL	YVCLVVI
QKQ	KQQ
GGVEI	MA
RGG	DSD
LFDF	EEQ
GGE	SND
ADS	EEQ
RGGE	EDSD
LFD	EEQK
QKEE	DLFF
LCSA	FE
YILD	RTLYLN
KALSKK	DLY
YILD	TLYLN
QQK	EICEQDKE
VRP	VVRP
SRATETGAN	GAETTSRAN
LLT	ALY
SYYAPAL	PALASYY
SHAPLF	PLASFH
HKSSPA	PASHSK
SHAAPMLF	PMLASFH
HSAPMLF	EPMLASFH
SHAPMLFE	PMLASFH
LFM	IMV
SHAPMLF	PMLASFH
SHAAPMLF	PMLASFHA
SHAPMLF	PMLASFHA
GAYPV	PVGAY
TNKS	VRS
KEND	ENKD
KEK	NGNGE
ATQV	QVAT
KLYAI	YYKL
RTD	DRN
YWKE	RVSDQ
RSVDQR	WKHE
SFPPQ	ERIDE
NAKT	TAKN
SPL	RRR
DNVR	NDVR
KDANDW	WDNKDA
NDRV	NNDVR
NDNRV	NDVR
DKANDW	SWDNKDA
NNDVR	NNDVR
TDGIKE	EHPDK
KNE	ENGKK
SN	NKKP
DKPEH	EKDTGI
GTAA	AASPK
NDA	YENGK
KEDG	DKA
EQG	EQG
QAALAK	KVVDKL
AQEALAK	IKVVDKL
KFER	DTSAVN
PEED	QRV
NSGSRV	EDNL
NKLDP	QRV
DIVSKNF	INSF
RVSKIFI	AEDDLSKL
SINF	KDIVNSF
SKRF	ELL
IWKTELEELKKNIQIERIALQNGVSLKNGELINRETLCKSATEYRKE	IWKTELKEKLNIIQRAILQGNVSKLGENLIENTRCLKSAKTKYEER
QVERVLRVLPEEI	QVLVDTLSEIEAIALKK
VVRLRVLPEESN	VLVDTLEILEAIALK
QVEVRLRVLPE	QVLVDTLSNEIEAIAL
QLVDTVLIEEAAKLLI	QEVRVRLVSPELEI
REKL	KKE
ERKL	KKE
RELKLG	KKE
RKL	KKE
ERLKLG	KKE
ERKLG	KKE
ERKLG	E
REK	KKE
REKLG	KKE
RKLG	KE
REKLG	KE
ERK	KKE
KQDL	RVSN
KNDL	RVS
ERLKL	KKE
QERK	KKE
FTEVE	ARHWR
SQK	LRPG
SQKEQL	LRPGTKQ
LILV	VLILLA
NTHYGSYSKG	GSKYSYGHTN
KLRLLLTLAVMQANKALQ	KLSLGLLTLFAMVEANKQAEQLA
LKDLSVRLLLTLAVMANQKA	KLSRLGLLTLFAMVANKQAE
KCLRLLLTLAVMQANKALQ	KLSLGLLTLFAMVEANKQAEQLA
LKDLCSVRLLLTLAVMANQKA	KCLSRLGLLTLFAMVANKQAE
LVRLLLTLAVMANQAQL	CLSRLGLLTLFAMVANKQAELA
LKDLCSVRLLLTLAVMAQKAE	KCLSRLGLLTLFAMVANQAE
LEKDLSVRLLLTLAVMANQKESL	ELKDCLSRLELLTLFAMVANKQSEQLA
LEDKLSRLLLTLAVANQKSQL	ELKDCLSLLTLFAMVANQEL
IDNREAEALEVLTLFANVMARKDEIENLLL	DIENELRAEALNVLTLFEAMVAREKIELNLTQL
LCSELE	ELKCLS
TFLAVMANQKAELQAIQKLVKELVL	TLFAMVANKQAEQLAKILQEVLKLV
RLCSEKLE	ELKECRLS
TFLAVMANQAELQAILQVKELVL	TLFAMVANKQAEQLAQKILQEVLKLV
INREENVLTLALVAKEINLLKQDLLL	IENRTENVTLFALVAEILNRLQLRKDLLL
DINERENVLTLALVKDINLLLQKD	IENRAENVTLFALVAEKIELNLQLKD
IDNEREAEAELVLTLFANVMAKEIENLLQKD	DIENERAEADLNVLTLFEAMVAREKIELNLTQLKD
IDNREAEANLVLTLFAVAREKIENLKLTLDQLLLTLQLK	DIENERAEEALVLTLFAVAREKIELNLTQLKLLLTQLLK
ITQ	TIQ
HIN	WG
VKHNI	WG
LLFF	VPYVL
PEIA	RVI
SIF	NP
QFPH	PHFQ
RNSNT	NNRA
RNAT	ENRTA
GFAF	AEV
FTN	IIFYK
IIN	VIT
WPK	LEK
DYEQK	FK
KNQS	QGQR
QL	TGGC
LDRD	WKQSA
LRR	WKQ
LRRD	WKQSA
RLR	WKQSA
LRE	WKQSA
RLDQR	WKQSA
RLRD	WKQSA
DQLR	KQS
GETRS	SQ
GERS	SQ
RSGE	SQ
PSILR	RGMSVQ
FYWAG	RWQTQ
RFYWAG	VRWQTVQ
RQFYWAG	EVRWQTQ
RFYWAG	VRWQTQ
QFYWAG	RWQTQ
SDNLAGF	DLNSDS
SDNLAGF	DNSDS
EN	RGA
RKQELDLK	KLDLKRQE
RAKDK	AICKE
TQN	VQ
KSI	KMAEVN
KSI	KAEVN
ASLE	KRF
QSN	LQDS
AFLLNMLAK	FLALNMAKL
DVGKKAKDK	KDAKKGKVD
RSP	NRG
RDKVQMPFT	QMPFRTVQ
ELRSP	NRG
RELRSP	NRG
FTR	MPFT
TFC	FC
TSD	RENTRQ
QHEPEQE	ENKDKCTVT
RHAG	SQE
YVRECDP	KVMMN
YVERCDP	KVMMN
YVRECDP	KVMMVN
YVREDP	KMMN
AGY	YTRK
LQAY	RI
WDD	LKNGI
SIYLNP	PIYNS
KLEELP	VRRH
QART	QARE
ATRE	ARETT
ARTT	ARTT
DDPY	RQR
DDLKPQY	RQR
DDKPQY	RQR
DDKP	RQ
DDKPY	RQR
DKPY	RQR
DQGILGIKHG	DDMTIAWES
DQIGILGKH	GDDDMKTIAWS
IILY	GQLALN
GQLALN	ILIY
WDAKK	AGNMQQ
YDKEKF	EKFKDY
HKLK	DDQ
DDQ	HLKK
FEQLTFT	TFTLQEF
TGD	TAEQ
QNHL	FHELLK
NQLHLGKE	WFHLLGKF
NQLGKE	WFHLLGKF
DFDQQKN	QN
QN	DNQK
QHME	TVKFST
GATL	YHGKIL
HGKITL	ATGL
QGT	LEYE
QGT	EYE
QGT	LEYET
GHNN	ESSP
DGH	PGNTH
DGH	PGNT
NGHY	SSPG
HQQYVEQ	EGQ
HNFPFYSQK	HNFPFKQYS
DGW	HTGRT
YDNVAFRE	YDNVESFR
QT	QKDP
QTD	QKDP
LGYGE	YHNG
AEAKTL	LTKAEAE
NEHW	DQE
HNYGLV	VLGYNH
HNYGL	VLGYNH
MSPTNP	WRY
MSPTNPD	WRY
TQQNF	NFQT
TQQNF	NFQQT
TSY	SYT
GKR	FNG
AQADY	DYQAA
RTGAR	HED
EQ	NKKE
EQ	NKKLQE
DED	RRTK
LLSKK	KLSKL
LSLKK	KLSKL
KKSERE	NKEDQKL
EENSK	KSNEEQ
ILIQLTNTLLTQSLLLKALLNFLYYM	LILTTNLTSQLLKLALLNFLYYM
MSKDYNYLSSLLEKFNENNKNELLN	LNKNENSFENLKELEKYSLSYNQKMDS
KSEQN	QKL
LMQKRYLYLDKELKFNLIENSNLLNL	LNLLLENLNSIFKNKLLDYLRYQKML
MSKDYNYLSSLLEKFNENNKNELLN	LNKNENFENLKLEKYSLSYNQKMDLS
KKSEN	NEDQK
AASL	SALA
Y	KSLIP
LDY	NPE
NKTE	EKEN
SN	YSLSTQ
RDKIMK	DLTSELDLD
KPEL	DRSL
AYAGETS	FRRDRQ
LYRA	YRAL
DDHQML	KHRRE
QQN	VMAGLVS
QAQAGQADNL	DNLADGQAQA
GLVSAA	QNDN
YQEF	QEFY
NSLA	EFKT
AGTSNQAA	NSNS
TAGSNQAA	KNNS
RED	FHN
IAP	RSP
VHL	LHV
VVMP	VVPM
IHS	SIH
KERVNFD	KKQNYVG
EDQLILIEHNKNPLLIRYLRFVAQESKITVTKMI	KINITLLRGQLIGIINLNLEIQQETNNLKLCLEDYI
EDQLILIENHKNLIRYLRFVAQESKIRTVKT	KINITLLRGQKLIGIINLNLEIQETNNLKLCLEY
EDQLILIENHNLIRYLRFVAQESKITKTM	KINITLLRGQLIGIILLEIQETNLKLCLEY
LLSKVST	LQKSDYR
LQKSDDYR	LKLSVST
KLMEV	EVKLM
KLEV	EVKL
LQKSDYIR	LKLSVST
LQKSDYR	LKLSVST
KLMEV	EVKL
LQKSDYR	LKSVSRT
LKSVST	LQKSDYR
ELENKK	SLRNIPFYEE
LKLEAQE	IKLQRLNNLT
DTEQ	HKFN
DEQ	HKFN
YHV	NLL
KDHH	NMKG
LYTV	VYYK
LVYT	VYYK
LTR	VYK
LGSLV	VYYK
LSLG	VYYK
LVGSL	VYYK
VGSLL	YYK
LGSLV	VYY
LGSL	VYY
LGSL	VY
DKRL	RSW
SQNHL	QLLKYL
SNHAQL	QLLKL
GIVLW	KFVLC
SHQLQE	QLLKLN
SNHQL	QVLLKYL
CTELL	WLL
KKY	NYGKG
KEYGKDLS	NASQSAHA
SDQDI	RLRDKALI
ESFQCDDI	STRLRDKALI
EFSDQDI	TRREDKLI
NDQ	DNQN
NDQ	DNQ
NDQN	DNQ
NLK	ERI
DRL	QDEAL
TQHGVQ	DFFYVFRQ
RFS	DHG
KK	FSSE
KRD	VDERD
YHRKYK	EDEEDRS
KKRDEEYDE	DYEDRKKKK
ICLG	GI
PAKERLE	INVHAYAV
LDDLAQLASEFAKAW	IRINVHAYVRASDTKAK
WKRE	YEHDYR
WKR	YEHDY
DLSLDADQLASEFAAKRWY	MIINVHAYVRADTKAV
LDLADQLASEFAAKWL	IRINVHAYVRADTKAK
SLDLADQLASEFAAKWLY	MIRINVHAYVRADTKAVK
DLSLDADQLASEFAAKKRWLY	MIINVHAYVRADTKAV
LDDLAQLASEFAKAWL	IRINVHAYVRASDTKAK
DLSLDADQLASEFAAKRWLY	MIINVHAYVRADTKAV
DISDLADQLAFEAGKKLKFW	MIRINVAYIADTKK
LLAASEFAKLW	MINAYVRAVDTAK
LLDADQASEFKALYW	MIRINYVAVDTAK
LDLADQLASEFAAKWLY	IRINVAYVRADTKAK
DLSDDLAQLASEFAAKLYWN	MIRINVAYVRADTAYS
KRWLM	EDERVSKK
DLDLADQLASEFAAKLYNWM	MIRINVHAYVRADTAKYQKA
DLSDDDLAQLASEFAAKLYWN	MIRINVAYVADTAYQS
LSELTAMMADSFAHMMY	MIRINVAYVRADTAY
LDLADQLASEFAAKLWNK	IRINVHAYVRAVDTAYQS
GLDQLSESLATSFSKRLMW	LISINVSSHVRASQLAYQ
LTEIADALAQKFANRVWM	NVINVADVQGVHTASA
GLTEIADALAQKFANRVW	NVINVADVGVHTAS
LTEIADALAQKFANR	NVINVADVGVHTA
LSDLADQLASEFAAKLYWNKMLIIIII	MIRINVAYVRADTAYQKAKKMICCILI
LSDLADQLASEFAAKKLYWNKMLIIIII	MIRINVAYVRADTAYQKAKKMICCILI
LDLADQLASEFAAKYLWNKMMLIIIIIY	MIRINVAYVRADTKAVKYQSKAKKMICCILII
LSDALDQLASEFAAYLKWNKMMLIIIIIY	MIRINVAYVRADTKAVKYQSKAKKMICCILII
LDDLQSEAFAAKWLY	MIRINAYVRADTKA
LDLDAQAFEKAW	IRINVAVAVDTKAK
LDDQEAFAAKWLY	IRNAYVRADTKA
LDRLTEELSEKFSQV	VISINVAHVQANQLA
VESQG	EMIDR
ESQG	EMIDR
VESQG	EMID
LVESQG	EMIDR
IEQQE	ENVDVI
ESQG	EMID
EHL	EMDRY
ILIRI	IVAVYVAVT
ILHFRILEHIRIE	IDIEVEAVVEAVTK
ILLIRI	IVAVYVVT
SLIKLER	MIINVHAY
DRIARRLTNLKSILMLRI	IDIEVESEVESDLQAAQ
QQLTRRLTNNLKSILM	IDIEVEAEVQNLSAA
QRD	RRKIG
QRDL	RRKIG
GQPKT	ANNPNS
MGRT	RMGT
EVIDAAAL	LVIDAEAA
NWQ	EGQP
DQG	HLND
TESNR	GNEA
FVN	DG
QLHSAHSS	EAKWLQ
LFHLVDHS	QAEAAREHR
KE	KDGN
DGN	EK
LDGNK	E
YYV	PSLL
YVY	PSLL
YKVY	PSLL
YVY	PLL
YVY	RPLL
YYKV	PSLL
YKYV	PFSLI
KYVY	PPSLL
KYYV	PPSLL
QNEK	KDSIE
PGDD	GSN
TSGADT	KGGNE
AIE	KGK
TIA	QGT
TIAL	QGT
KIA	EAT
GSARGSN	EHSFGS
IRA	TVTGL
IRA	TVTGPL
YGEGQE	TGEL
SKV	VTG
RIA	TVTGL
HPRH	SDVSQ
VKSE	TISAPL
LAL	ALL
AT	ALPYA
AYALP	STAA
AKGA	KGP
DTK	KGY
PPE	SYPE
PPES	ESYPE
VKVE	KEVV
QAK	TDT
ERSF	NR
SDENRR	RRNSDE
SDENIRKR	RARNSDE
SDENRRA	RAIRNSDE
SDENIRRA	RARNSDE
SDENIRRA	RRNSDE
SDENRRA	RRNSDE
VGLSQ	GLQMRG
DDENVIRR	RRVRNDDE
SDEARRA	RARASDE
SDEAMRRA	RARASDE
DEYSLKRR	RKRYSLDE
DSEYSNKR	RNKYSDSE
DSEYSLNKR	RNKYSLDSE
PSS	EGG
ITA	LLN
AGK	LQNW
NNQLLKQIKKLEAILLKYVTILENQQLIKLELKA	QNLNKLKQEILKIALRKLYVITLEQNLQILEL
EDEARRDR	RRRAQEDNAE
TWSLD	TWLS
TWSL	TWLS
RDEL	LEDR
KGVDA	VYDAPTK
DTKEHVYLN	NLYHEKTD
DTKEHYLNV	NVLYHEKTD
NSC	DDR
NPS	PVNP
FPHTWAL	LTLIL
HFPTALW	SDTLTLIL
HFPTALW	SDTLTNLIL
HFPTWAL	SDTLTNLIL
HFPTALW	TLTNLIL
QGAV	PGAQ
FAV	AAFV
QADEATLHKKHISD	DISKHKLTHEAADQ
QADEATLHKKHISHD	DISKHKLTHEAADQ
EPEATHD	HDTEEAP
RHAA	AGSVS
EQAH	GSVS
RHA	AGSS
KIRGWKLFNFIKLVKT	MFLRNVEWSYIYLKVAAAVL
KSWQK	KQSWK
KDSWQK	KQSWKD
DEWMQIEKAKV	VKAKEQIWEMD
QSLFQ	KGGGK
NQ	ENAL
R	EQHQN
LSCADI	ISDCLA
LACSDI	ISDCLA
QRARTSR	WNR
SY	EYDR
NQENN	PNNQNE
NQENNP	PNNQNE
DLEA	TGQN
DLE	GLN
DSS	GSD
DDEEI	RHNN
DLA	GQE
LTE	TQER
GRRGE	RH
QIGLK	NSH
LIVGTTIL	LIVGTTIL
R	EVATE
IKAIL	IATAHF
NRYE	YTPN
VKEFR	DGQT
VYFER	DGQTW
VKEFRY	DGQT
EVKFRY	RDGQTW
EGVRQ	SGSLA
WKF	FWK
VVLAAL	LAALVV
TDSD	DR
YCEL	LCE
ECN	CEN
LLLTL	RKLALLL
PYVIGERY	YVALSVQD
PYVIGERY	YVTALSVQD
DNND	HR
ITKIKPN	IAGLEFDTN
ITKKIPN	IAGLEFDTNT
ITKIKPN	IAGLEFDTNT
ITKKIPN	IAGLEFDTN
ITKKINP	IAGLEFDTNT
PESGN	RGSHTI
SGNT	SHTI
EPSGNT	TPRGSHTI
PESGNT	PRGSHTI
GNST	GSHTM
PESGNT	PRGSHTM
PEGNST	RGSHTM
PSGNT	PGSHT
PESGN	RPGSHTI
PESGNT	RPGSHTI
ESGPNT	PRGSHTM
GSN	GSH
EPSGNT	PRGSHTI
PGSNT	PGSHTI
RIQE	MTFY
GNST	GSHT
RFPP	PFPR
FRPP	PFPR
RPFP	PFPR
RFPP	PFLPR
FRPLP	PFLPR
RQL	GHTLG
RLGR	LQA
RLR	LQA
RMSE	GACHCAR
RMSE	GAHCAR
RE	LNCIQ
RK	GCDI
QLS	GYRI
QLS	GYRIG
WRSVMTP	LTGWG
RQK	GHDL
WRVSYCP	ITSYE
WRSVYCP	ITSYE
GRLR	QR
TSVKD	KVK
RVGR	GEEQ
RMSE	GACHAR
LGRR	SQR
WYLE	GYKHN
WYLE	GYAKHN
FWND	LLR
YRN	ESPDHD
GGHR	RAE
GPGHR	RAE
YRWN	ESSDHN
YRWN	ESSDHNL
RLQED	GRLG
RQK	GHDLS
RSE	GCLQ
RS	GCLQ
RSE	GLQ
NTD	CKRG
NTD	CKYRG
NDT	CKYRG
VHY	LRA
HEQN	EQEPAHGD
HEQN	QEPAHGD
NDT	CKRG
LKHQ	DDEENG
RTQ	GHEN
SDEA	PMP
NADTRR	HRLT
WVT	MRF
WVT	MRPF
WVTI	MRPF
WVT	RPF
KTE	NPGD
YKNRI	IPSTAL
NVLR	RSY
AKAK	VD
RAEE	TQR
SGKD	DESG
GVARKA	ALAARHG
KKR	RDQ
RQER	RDD
ENG	EN
RTSN	ASEAGS
EKA	AEAI
RSNN	RRWE
RWR	SNNR
RSNN	RRW
SPGL	QE
NDK	IGAN
ETQRR	QRAE
RAAMEPE	PAMEAQR
KDG	ERMQ
NDK	IGAGN
KY	QDPL
PLRKYQ	YGRN
PLRKY	YGR
APNN	AKRT
PLRKYAQ	YGRN
RGLP	DELG
LQQATHAAYP	QLQAPYTAAH
APNN	AKR
MVKDY	KDYM
WPKVEIP	IPVEWPKG
WPKVEIP	IPVEWPK
PLELQN	NKR
PLKR	GPDN
NGQ	GQI
EDRQ	REQD
GDRVK	RVGDK
KMDK	KKDMK
KMKDK	KKDYMVK
DWQGR	GRREGG
QWR	ADRE
KLRG	LRG
LRG	LRG
DDAER	ARE
GLC	CLGA
LRGA	LRGA
LRG	KLRG
DKEDEEFN	NFEEDKED
GMA	AMG
GAF	AFG
GFA	AFG
GGGN	NGGG
GGN	NGG
LGL	LLG
HPK	KTP
KQGR	YKTD
AIMDLGTVTGVSLKW	IADMLTGVVGSLKW
QAA	AAQ
KDAG	SKNNN
VTGKVD	VHQM
DVTGKV	VHQ
KVNNEV	NVEKVN
RDSQ	DSRQ
SDNEK	QNES
ISETENL	ENLTIS
KYL	DHLK
KYLND	DDHELK
QYT	KSR
TNAT	GGSTT
TTSGG	TATN
KFK	EMD
ACTGCGNCPNAVTCTNSQHKANTCTSGTDCNTAQTCTNSKDCFEANTCTDSTNCYKATACTSNSGCP	TGGADCTSCTACTGCGNCPAVTCTNSQHCVKANTCTGSTDCNAQTCTNSKDCFEANTCTDSTNCYKAT
CTGACGNCPNAVTCTNSQHCVKANTCTGSTDCNTAQTCTNSKDCFEANTCTSDTNCYKATACTSNSGCP	CTGGADCTCTACTGCGNCPNAVTCTNSQHCVKANTCTGSTDCNTAQTCTNSKDCFEANTCTDSTNCYKAT
CTGCAGNCPNAVTCTSNQHCVKANTCTSGTDCNTAQTCTNSKDCFEANTCTSDTNCYKATACTNSSGCP	CTGGADCTCTACTGCGNCPNAVTCTNSQHCVKANTCTGSTDCNTAQTCTNSKDCFEANTCTDSTNCYKAT
EPFD	FEP
QDRD	PKQY
EHTI	HETI
DKEFE	QFKE
NDR	DNR
EPF	FEP
NALTLV	NTAVLL
LLKEVYSKV	LLKEVYSKV
VLLKEVYSKV	TLLKEVYSKV
VTLLKEVYSV	TVLLKEVYSCKV
VLLKEVYSKCV	TLLKEVYSV
YYLGGSATGTSYNGRQG	QFVSSGGSAAKTTINSGG
YLYGGSATGTSYNGRQG	QFVSSGGSAAKTTINSGG
KDGRCNDN	GCNKNDD
KDSQ	KENN
KLQD	DN
YKEW	WEKY
LEAR	RG
NLVEVY	EVLVY
RVLTQTLL	DLVLSKLVEV
LLTQTVLR	LVAVKAVQYE
RVLQGTTLL	DLVLSKLVV
LLTQTVLRQ	LVNAVKAVQYE
RVLQTTLL	DLVLSKLVV
LLTQTVLR	LVNAVKAVQYE
LPGT	VQL
LQV	VYLE
VLRQTTLL	LVLSKLVV
RLVTQTLL	DLVLSKLVEV
TLPG	LVQL
LQVL	VYL
RVLTQTLL	DLVLSKLVV
LLTQTVL	LVNAVKAV
VLQTTLL	VLSKLVEV
LSIHYSK	NRLN
YLH	TLHE
HRKP	RHKP
DGDKGRL	KDRGDGQ
LQQNRIRDD	LRDDLIQRNE
GLSTKKK	KLSTGKKA
DGER	RDGE
RNND	RD
RD	RNND
HGPT	TPGH
QAES	EKAQ
VPY	PKGL
RLIQ	DLIQ
GYSSK	KYSSGK
GYSSKPK	KYSSGKP
RLHDE	RHDER
RLHRDE	RHDELR
RPGS	WNDT
KQV	APGE
QV	APGE
QIK	PTGE
EQI	LPGE
EQI	LPG
AL	VQL
TKQ	QTD
TED	GEQK
TKQD	QTD
QEGK	EDDGK
RGD	VGRD
RN	YKK
PGDK	HTY
TRSQNG	QNGSTR
RLPR	AYPIAANDE
EGK	EAVY
EGK	EAV
EK	EAVY
NEG	TAKY
TPLSDAQ	QQGKSWR
TPLSDA	QQGKSWR
PLSDT	QQGKSWR
PLSDTA	QQGKSWR
PLSDT	QQGKSW
AKL	GPV
AVSTR	VGSAT
QRT	SNNN
VKYLVVSSARL	LKVFMTFLLIEESLYT
VYLVVSSARKL	LKFMTFLLIEESLYT
LVYLVVSSARK	LKFMTFLLIEESLYT
LVKYLVSSAR	LKVNFMTFLLIEESLYT
VKYLVSSARL	LNFMTFLLIEESLYT
EGD	KGER
REG	LGEDR
TQQIR	YTDAASA
IQR	AAS
TGD	TDAH
ANAG	NAGA
VGNS	NRD
VGNS	ND
NVGS	ENERD
GVSV	WPLAT
TKLR	LFTD
RNV	VLPD
RNV	VLPDS
RYLRR	YELGV
RTL	ELGV
KYDY	RE
SGTLA	ARK
MVT	VVV
KSSKYC	YE
HWSED	TWE
RSNAK	SRNAK
SNK	TDT
YPID	KEAFR
RGTEWI	RRGEV
LLLW	LRLWF
WFRL	WLLL
WLFR	WLL
LLWL	LLWF
WLFLR	WLLL
LLWL	LRLWF
WFLL	WLLL
EGN	KER
SDLQIFDATK	KTADFILQS
NAG	DALK
SDVVN	N
EQKR	EQKR
ADGI	GIAD
SQH	HQS
LRDN	EMD
RLDN	DEMD
GEQRLD	DRLQEG
ETKD	RQ
EEDE	HSKEK
SHG	QR
TAP	ATP
AT	ATP
KEPH	PAYLP
EEFDE	HSKEK
DEE	QKDGK
FRDD	LSRGK
KG	FASG
DEKLANQ	KLANQR
AGV	SGDF
HLAAAERP	EPRAAAHL
HAL	ALH
ARRPE	PEAR
GTWRN	RWTN
TRN	RTN
HAPCK	GLLQ
SDVFRRL	ERT
HYVE	YHVEG
YNSS	SYN
NNS	NKDENG
KDENGY	NN
RLTGW	EART
TRA	TDESGR
GFSR	TATSG
TQTRQA	QVDGH
QRTQA	QVDGH
TTRQA	QVDGH
QPA	PAQ
RER	ADEEK
REQE	ADRQR
VAGVYTHV	YHVTVAGV
YWPK	YWPK
EEYG	LK
HM	TPED
AAEERKAHFA	RKAHFAMLER
EY	TFSQL
TWERLQRILQERKQEKLVRILEALER	WERLQIQLRRQEKLVIERLLRAE
SEN	SENTQ
FQSEN	NSET
NSE	RGET
NSE	GET
SNSE	RGST
NSE	GSTE
NSE	GEST
QSENT	NEQ
SWHSPLNS	GREDPPR
SWPE	GDT
SR	SSQQ
EQDAR	QDER
GAD	DGA
GTPA	DS
WKTTFTVAQNE	VAETTTFWK
WKKHFTVAQE	VAQETKHFWK
WKNYFTVAQ	VAQTNYFWK
WKNHFTVALE	VALETNHFWK
EDFQHE	QEDFHE
KNHFTEALE	EALETNHFK
KNHFTEAL	EALETNHFK
KNHFTEALE	TEALENHFK
LDTPR	RTLD
LDTR	RTLD
IAHR	RHIA
IAHPR	RHPIA
IAHPR	RHIA
ERP	RDAP
LQVLQVLAFQYKVFPN	VQLVLQFEYKKVN
VLQVLQFYKKVEN	LVLQQVLAFYVQKFPN
LQLQVLAFQYKVFPN	VQLVLQFEYKKVN
PNYPQVL	WNKITT
PNYPQVL	WNKIT
NLYQ	RYTG
QNLYQ	RYT
NLYQ	RYT
LYQ	YRT
GFY	KCKY
QNLYQ	RT
CYLIGEEI	EEIYLGIYC
YLIGEEI	EEIYLGIY
LYQ	YRTG
HPG	HTSQ
PRFL	YYGD
ANLYQ	RYT
QNY	EDI
HTRTW	QFATL
FY	INSTV
FY	INSV
YY	LNAFM
YY	LNAM
EKLELQALLK	QKDLLKLAEQL
LEQKLL	LTYIM
LTYII	QKLL
LYIRIALMIVH	HVEMIIIALRY
QKDT	KDQK
QKDT	KDQ
QMVQYQ	QMVYQQ
EFYQ	KRP
KFQMTY	EMTQFG
FQMT	MTQFG
KFYGQMTRY	RMYQTFGEY
MTRYQ	REMTYQ
FYQ	SGGVPD
KRLYEYS	RYTH
RYT	DEYS
QMMQYKQ	QMMYKQQ
QMMQYKQ	QMMYQQK
QQ	DQQ
QQYKQ	QYQQK
KEFYQ	FQKEY
SNGDGVP	KFQY
KFQMTRE	RMQTFK
FQMT	FQMT
SGDGVP	FQY
QKDT	QKDTK
VELLYSR	SRPLYV
HERRIRYGL	DSEDLSVRD
RRIRYGI	DSLQVDER
RRIRYGIKK	DSLQVDRE
RERIRYI	DQLLVDR
RERIRY	DQLLVR
RRIRKY	DLQVR
RRIRY	RDQLLVR
RER	DQLL
ERIRY	QLDVR
RRIRY	DLLVR
RMIKY	LSMDDM
KY	DDM
IKY	DLDM
RIKY	QDLDM
IKY	LDDM
MAR	LKA
LDQSDDQSTKRW	WRWKTSQDDDQSL
IIVYST	VIIIKWK
LTQVVVMRVKVLRDL	EILKSILFMMLQV
SNLQTQVVVMRNVVLRDL	REILKESILFMEMLVQ
LTQVVVMRNVVLRDL	REILKESILFMMLQV
LQTQVVVMRNVVLRDI	DILKSILFMEMLVQ
NRLQTQVVVMRVRDL	EILEKSLMFLQ
NLQTQVDVVMVVRDL	EEILKSILMFLQ
NLQTQVDVVMRNVVLRDL	ETREILKESILFEMMLVQ
NLQTQVDVVMRNVVLRDL	ETREILKSILFMEMLVQ
WWL	MLS
NLTQVDVVMRNVVLRD	REILKSILFMEMLVQ
IVKAVVLAARLDRGL	EILISLFEMMDLVQ
NLTQVVVMRVLRDL	ERILEKSILMFEMLVQ
TLQITVMRNIVARGL	LLKSMLFELMDLVQ
TLQITVMRNIVARGL	ELLKSMLFELMDLVQ
TLQIDTVMRNIVARGEL	ELLKSMLFELMDLVQ
HMLQTQVDVVMRNVVLRDL	RTEILKSILFEMMLVQ
HMLTQVVVMRNVVLRDL	RTLKSILFEMMLVQ
NLQTQVVVMNVVLRDL	REILKSILFMMLQV
NQTQVDVVMNVVLRD	ETRELKEILSFMMLVQ
LQTQVDVVMRNVVLRDL	REILKSILFEMMLVQ
NLQTQVVVMRNVVLRDL	EREILKESILFEMMLVQ
NLQTQVDVVMRNVVLRDQL	EILKSILFMEMLVQ
SNLQTQVVVMRNVVLRDQL	REILKSILFMMLVQ
NLQTQVVVMRNVVLRD	EILKSILFMMLVQ
IRLLLF	LQLLL
SYDLGKKPIYKKAF	SYDLGKKPIYKKAF
SYDLGKKPIYKKAPTNEF	YDSLGKKPIYKKAPTNEF
RILILFM	RILILFM
RMME	HDMDRNH
HGVATVE	EVATGVH
HGVATVE	EVAGVH
GAVE	VEATGVH
VGAVAVA	AAVAVGV
KTKEGVVHGVATVAEKTKEQVTNVGGAVVTGVTAVAQKTVE	KTKEGVVHGVATVAEKTKEQVTNVGGAVVTVGTAVAQKTVE
TVQTE	VVGE
TVQTE	VTVGE
TVQTVE	VTVVGE
TVQTVE	VVGE
VGGAVAVA	AVAVVAGV
HGVAVE	EVAGVH
HGVAVE	EVATGVH
RRK	EKHRSG
TETNVHAHK	KKQETSE
KGYR	GYKR
RETNHQVK	VKHQNERT
LA	ALLI
KVDQ	DQVK
VADQG	HFLE
LALV	LVAL
EVNHQVKF	GHFVKRNHQ
SVTK	KR
QTGYPYVDED	REEEFLLG
YDED	REQLEF
ERAEGLEFLE	TQGQYPYE
RKG	LPDDPW
KAQKVTVNDML	LMNDAVQVTAKK
KAQKVTVNADML	LMNADVQVTAKK
NLSER	HLSTD
LGAYA	RLND
VSVGS	RYKQR
HNETRSIQ	MRSEQMI
QMA	QMTK
LRQYVWE	LQQTE
IYV	IYV
REAESAAIY	HYVGDIKSAAARE
EAQQ	RDQ
VFLQ	VFEQ
VREAQ	VEQLAQ
NLTRD	NLRT
MTNL	KEQ
AFDIAIN	IIANF
IELENMDLLS	ILLENMDLEM
DRVRGRRNET	TNERRGRRV
RI	QHEQ
QPGIQ	QPGRISDN
GIQN	IQQAR
QGIQN	QGIQAP
QPGIQN	QGPIQ
QRPGIQN	QGPIQ
VLQSLAQNLETLKTEILTLI	LVQLSANQLELTTIKELCLI
AASK	ITD
VLQSLAQNLETLKTEILTLI	VLQLSAQNQLELTTIKELTCLI
TDI	KAAS
KELICL	EQLHKAL
AASKR	IDT
ERYLKAKLANEIVRAQALSLEQRILETVKTENLTLI	GEYRLKALKAEIRVAELAQLSQERIELVTTNKELTCLI
ERYLKAKLAEIVRAALSLEQRILETVKTENLTLI	GEYRLKALAIREVALALSQIEERLVTTNKELTCLI
AQVSK	QR
AASKR	ITD
ERYLKAKLAEIVAQALSLEQRILETVKTENLTLI	GEYRLKALKAIREVAELAQLSQIEERLVTNKELTCLI
AHEQLQ	LIRELQE
ALHK	ITCD
ERYLKAKLAEIVRAEALSLEQRILETVKTENLTLI	GEYRLKALAIREVAQLALSQIEERLVTTNKELTCLI
YLKAKLAEIVRAQALSLEQRILETVKTENLTLI	YALKAIREVAELQLQSIEERLVTTNKQELTLI
LISICQ	YR
THGKPDIN	INDKTGH
THGKPDIN	INPDKTGH
HGKPDIN	NIPDKTGH
RDNL	DV
RNLKI	DQVD
HHSDTATAVNA	HDTAANVA
HHSDTATASVNA	HDTAANVA
PVCQAHGL	ATPCQHGLQ
VCQAHGL	ATPCQHGLQ
CQAHGL	TPCQGLQ
CQAHGL	TPQCGLQ
PVCQAGL	ATPCQHGLQ
PAA	PAA
AFGR	QP
NCYC	CYCN
SLA	ALS
AADQ	GT
HRE	ESHR
TS	SDAP
GRSDEQ	SDERGQ
GRSDE	SDERG
GRSDE	SDERGQ
GLSAEK	SAEGLE
GLSAE	SAEGL
GLSAEK	SAEGL
SDAP	TL
VAQ	EATG
TGLSVK	SVRLG
ATG	VAQ
GLSR	KVGLS
GLSVA	SVALG
STE	TSEQ
STE	TSEKQ
GRSVE	SVEGR
GRSVE	SVERG
QRES	EQRE
KALRARNAEYNKRR	DRFNTYCNL
ALRARNAEYNKMRR	RTYNFCDNL
KRNAYNKRR	DTYGFCDLD
KARNAYNKRR	DCTGYFDD
KARNAYNKRR	DFTYGCDLD
KALRARNAEYNKRR	DRTNYFCNL
DLFYGLTLFV	DLFGTYLFLV
ETSFT	TSFET
KGVK	DNS
LQIDN	KYEQ
HRTDA	NR
RVVDNNLT	NNVDRVLT
KFQL	FQKL
FSAHE	FSADHE
FSAHE	FSAHE
REN	ERN
NG	ANLS
ADSN	KKKD
RNE	QLFQ
QAQ	EQRN
RNE	ADEK
RNE	ADEKK
LQF	NRE
NEQR	AQQ
QLNLT	QEQ
NTL	LGK
NTL	LGIK
NTL	LG
SRG	SRGY
SR	RSR
SR	RGKS
SR	SRGK
QVEKQ	EMRGVY
IW	TAQE
ER	NLLD
ITIRLIIRSLLIRRLIINTI	IAIVNDLTIDYLKITADELIVLI
INADIVLTIDYLKITADLEIVIL	IITRILIRISLLIRLRIINIT
TIRLIIRSLLIRRLIINTI	INAIVDLTIDYLKITADELINVLI
TIRLIIRSLLIRRLIINTI	IAIVDLTIDYLKITADELINVLI
TIRLIIRSLLIRRLIINTI	AIVNDLTIDYLKITADELINVLI
IRLIIRSLLIRRLIINTI	AIVDLTIDYLKITADELINVL
ITIRLIIRSLLIRRLIINTI	IAIVNDLTIDYLKITADELINVLI
INADIVLTIDYLKITADLEINVIL	IITRILIIRSLLIRLRIINIT
IITIRLIIRSLLIRRLIINTI	IAIVNDLTIDYLKITADELINVLI
IITIRLIIRSLLIRRLIINTI	IAIVDLTIDYLKITADELINVLI
INADIVLTIDYLKITADLEIIL	IITRILIIRSLLIRLIIIT
IRIIRLLIRRLINTI	IDTIDYLKITADELINVLI
ADIRLIIRSLLIRRLIINTI	IVAIDLITDYLKITADELINVLI
IITIRLIIRSLLIRRLIINTI	INAIVDLTIDYLKITADELINVLI
IADIVLTIDYLKITADLEINVIL	ITIRLIIRSLLIRLRIINIT
IITIRLIIRSLLIRRLIINTI	INAIVDLTIDYLKITADELIVLI
ITIRLIIRSLLIRRLIINTI	INAIVDLTIDYLKITADELINVLI
IAISVEIVKLAAAEIVL	TATLVIAEALAKIVE
VAIQVLLLARAIL	ILRAALLLVGAQVI
VEIKLAAAEIVL	IVLAEALAKIVE
EAER	RND
PNV	AHAS
PSF	YHA
LPTSF	YHA
EADR	RND
EAERE	RND
HRSPG	RE
ERR	SPHR
GA	EKS
IALDAAY	LLAFK
ETE	GVSHK
AELQL	RGAYW
AMELQL	RGYAWTH
ETDD	GVARKR
ETDD	GVARRK
EVG	GVSSSQQ
EV	GVSAQQ
ASAN	GVEHH
ETEQ	GIARKR
ETE	GIAKR
NAS	YGRP
NAS	YRPS
GETAFARK	AFRKAETG
HAGLSH	HLSGAH
DRGELTDGH	LYYV
KRIGLDR	GVEGVDR
TRSEK	KERTS
GVEGVDR	KRGILRD
TRIV	RTA
ETEY	NNGAK
ETE	NKNGA
ETYK	NGKN
TGSAVIGE	TTGKFA
LLSQDVV	LMAESG
ERQ	GYAAMATK
RY	EAARG
RY	EAARGI
GQASRD	EKGGLVE
H	FGDRG
DPYRE	QKTDK
HQRQ	REITVIEK
NSN	QTN
HHHFT	R
LEATAE	KYGAF
LEATAE	KYGFA
KYFT	EATAL
EATA	YF
PGYA	YAPGT
SNG	NSG
RGYN	YNGR
RGYN	YFNGR
ATEKE	QHREA
AEGPA	AGE
ESGQ	QES
KRYQLFE	YQLFEKR
SQHG	HGSQG
PSELL	HS
VACNS	LY
VACD	LY
RQEGVP	PISR
RSNCL	SCLRN
REGVP	PISR
YSGLDR	ELKYG
YSGDR	ELKYG
YSGDR	ELKY
NRAGFE	YSGHG
NRAGFE	YHSGG
KEHK	EHKG
EDSTN	RPKK
DSTN	RPM
SDSYVLLS	MLPRVLWV
KETIKSRS	FSRSKI
KSNP	KSNP
KSNPL	KSNPL
YLPW	WPLY
CSC	CSA
TQY	RLA
DRPLRKDLG	GRKDLLRPD
SGAGR	RRL
KKAVALVDL	KPVVH
RKKAVALDL	KVPVH
RKKAVALVD	KVPVH
RKKAVALVDL	KVPVH
AKACILVDA	RFPVPH
AKACIELVDA	RFVPRPGH
KACILVDA	RFVPPGH
LERLKG	LLRQKS
LERLKG	LLRKSQ
LERLKG	LRKLSQ
ELERLKG	RLLKSQ
RFT	HRFTK
YFLPQ	QLPFY
FKNYLP	LPNYKF
FKNYLP	LPENYKF
FKENYLP	LPNYKF
FKNYLP	LPDNYKF
FENYLP	LPKF
FKENYLP	LPNYLKF
FKENYLP	LPENYKF
YAKLPER	PERKLAYR
HQK	QQQ
EHRN	HERN
EHTRNP	HERNQ
EHRN	HERNQ
VPHFNQDFNTFQ	FNVPHNTFFQDQ
ENN	KNEK
VPHFNQDFNTFQ	FNVPHNTFFQDQK
TRER	RRRGAP
KRRG	RRE
YSQD	PDKT
LSRDGFR	LFGRDSR
LSRDGFR	LGFRDSR
AARWGAR	GAARMWAR
AARWGARM	GAARMWAR
LARSGYR	LYGRSAR
LARSGYR	LYGRLSAR
MRWGGA	MGGWR
MRWGGAV	MGGAVWR
MRWGGA	MGGAVRWR
MRWGGA	MGGAVWR
MRWGGARV	MGGAWR
MRWGGARVI	MGGAWR
ERTG	FH
MRWGGARV	MGGAVWR
MRWGGA	MGGAWR
LKARSGYR	LYGRLSAR
LARSGYR	LYAGRLSR
GRWGAR	GGARWAR
AGRWGARM	GGARMWR
AGRWGARM	GGARMWAR
AGRWGAM	GGARMWAR
MARAGAK	MAGAKAR
LRGGVKF	LGVKFRG
LRGGVKF	LGVKFGR
LNLRTGAK	LLNGAKTR
KPERGFPT	PTGGFRPEK
KPERGFPG	PGFRPEK
KPERGFPTG	PGFREPK
KPERGFPG	PGGFRPEK
MRGSTPL	MTVPSGNR
MRGST	MPSTG
MRGSTPV	MTVPSGNR
MRGST	MTSG
MRGST	TSGM
MRGST	MTPSGR
MRGST	MTPSG
MRGSTP	TPSGMR
LRGVKF	LVFKGR
LRGGVKMF	LGVKFGR
LRGGVKF	LVKFGGR
LRGGVKF	LGVKFR
VRFGT	GTVRF
VRFGT	VGTRF
TAHYSTV	KVVTEK
CLTATKL	LKTATIAC
NCLCVRLNA	NALRLCVC
TCPSN	SN
CTGGSTIL	FNANT
PIIHVTT	ITGSGR
AFTGG	PTIGIHV
ATAD	SSAK
DTANKD	VATDK
QEDTANKD	SVALMGTDK
QSSQ	QSQS
ELNYE	KTQ
SRD	KKG
VQVRR	RRE
HK	DRYRF
GD	KSTN
KTDAD	DDTK
NGEQ	VNK
ETQ	KQTD
GEQTK	QET
HLH	HLH
KNEVAG	AGEVKN
YIDG	IYR
LKS	RSLEE
KDTTEKE	TKDTEKE
GRLFDKT	WGMIESD
GEAC	RDE
ETKHH	HDEYWI
KEAL	EKLA
DQE	DYD
KDYD	QDEK
EWGGAT	KYQFC
AQAAE	ER
GVTG	VTGG
AQAAEK	ERE
EAG	SGK
KKAD	GQE
KAN	KAN
PKDN	RQK
NHD	GGI
VIMGL	MQLML
ED	RRYA
DRLE	DRLE
EQDA	RDR
DKV	DQAN
FTIESLRIE	ERILESI
FIPLDIKF	FKLIIPD
ILIKF	FIKLIPD
TISLRIE	REITSIL
TISLRIEF	REISILFT
FIPLDIKF	FKLII
ILIKF	FLIKDFI
FMTSLIFIL	FMLFTSIIL
FNILFIVHWRI	FNLLIFLHFRI
TLLIFLLF	FVHWLF
KIKNLDDR	EAQLAQKCE
FYADH	KERARRD
QTV	QTV
EIK	FTD
EI	FTD
RRA	EG
RRAN	EGE
AEAKP	SVYQ
GAE	SYR
RRAN	ARR
SKYPQD	YNLETQFRWY
YGPTE	NYLQWH
TRYPEL	LNGSIAHLL
TPRYPEL	LGNSIAHLL
RSAA	QRTSAD
RAA	QRTDS
RSAA	QRTDS
RSA	QRAD
RA	QTCD
AAG	QTD
DSYPEPT	YNLTQFRW
TPRYPEE	LYNETQFRW
AVVVFW	AVVVWF
IAVVGLAYF	IAVGLYVAF
SQQ	QQS
RLRVAEIIRRIRNSLEIY	CDELVSEIKIGEIENLWI
CDLEVSEIIKGEINELIW	RLRVAEIIRRINRSLI
RLRVAEIIRRINSLIY	CDELVSEIKIGEIENLWID
GGELQVD	QVSR
KGLQ	QEL
GELQV	QVSR
QVS	ELQ
VEVTLESHSLLQLNQILRIQQLNVVQILID	VRVLSHLLLQLNDILQINQLVRQVQIQQI
VRVLHLLLQLNDILQINQLVRQII	VEVTELSHSLLQLSNQILRIQQLNVVQILI
VEVTLESHSLLLQILRINQLVVQILI	VRVLHLLLQLNILDQINQLVQRII
VRVLSHLLLQLNDILQINQLQVVRQIQIL	VEVTELSHSLLQLQNIRLIQNLNQVVILIDSL
VEVTLESHSLLQLNQILRINQLNVVQILIDLS	VRVLHLLLQLNDILQINQLVQRQIQIL
VRLSHLLLQLNDILQINQLVRIQIL	VEVTELSHSLLQLQNIRLIQLNVVQILID
VRVLHLLQLQLNDILQINQLVRQII	VEVTELSHSLQLLSNQILRIQQLNVVQILI
VEVTLESHSLLLNQILRINQLVVQILI	VRVLHLLLQLNILDQINEQLVQRII
VRVLSHLLLQLNDILQINQLQVVRQIQIL	VVETELSHSLLQLQIRLINQLQVVILISL
VEVTLESHSLLQQLSNQILRIQQLNVVQILIDLS	VRVLSHLLLQNLDILQINQLVRQIQIL
VRVLSHLLLQLNDILQIENQLVVRQIQIL	VEVTELSHSLLQLQNIRLIQLNVVQILIDLS
KMHVN	LTR
KMHV	LTR
FKIQRQETFVMTRQALR	CKKYERNQTLLLYEAD
KREAFEVDITL	EENIKKLY
FSKIQRQETFMITRAL	CKKYERNQTLLEAYL
DERM	RMDLEK
IKCYQPVSR	SYFKTN
IKCYQPVSR	SYFPKTN
SYFPKTN	IKYQVPSKR
IKCQPVKSR	SYFKTN
KFG	GF
SYFKTN	IKCQVPSR
KRG	KSKFG
KSFGK	KGR
IKCYQVKSR	SYFKTN
SYFPKTN	IKCYQVPSKR
IKQFPVSR	SYFKTN
SAY	AQS
SSYFKTN	KICQVPSR
IKCQPVSR	SYFKTN
SYFKTNG	IKQVPSR
SYFPKTN	IKCQVPSKR
YFKTN	IQVPSR
IKCYQPVKSR	SYFKTNG
KCMNR	KDA
TAES	HNK
SQAGK	N
NRQ	NHS
KLVLF	FYLV
TGFLLL	FTGLLL
VLSCCES	ECSCSLK
LSCCESEV	CESCSLK
KLSCCES	ECSCSLK
TSKD	DCKTS
LLDLGN	NDLLGL
GELI	EGLI
TLLLW	LTLLW
PGE	EGV
PGE	EQGV
SATFP	FPATS
NATF	FATN
RKQ	RYQ
PSAVV	QQAV
PSAV	QQAV
ACLGR	RSQR
ACELGR	RSQR
ACLGR	RASQR
ACELGR	RASQR
EERN	NEDA
AEERE	RNED
VNIPRR	NSEDTD
VNIPRR	NTSEDTD
VNPRR	NSEDTD
VNPRR	NTSEDTD
GRAHH	HWSTR
GRHH	HWSTR
NKLELDSN	ENLSKLDN
NKLELDS	KENLSLDN
DKEP	KEKDN
YLMHK	MYEQ
YLMK	MYEQ
LMK	MEYQ
LMHK	YMQ
LK	LALV
LKE	LALVR
IEAVYRL	VQKLEH
DAQ	NRVNGFE
ADAQ	VNRFE
ADAQ	RNVNGFE
ADAQ	RVFE
QGDY	QG
EYEM	SHAQE
EYEM	SHAE
SNSA	GRKF
LGDRL	RGLD
LGDRL	RGDLQ
LGD	GDRL
DKV	QLE
LYVL	AF
VLKIQ	AYVFQ
VLKI	AYVFQ
MSLS	RR
QMDSLS	RR
MSILS	RR
DTDLRADM	DMADLTK
LYM	LAYM
DTKDLADM	MADDLRT
HNSR	QDQS
AIR	RIEAR
DYED	RSR
HLLGNFRD	DRNFGLLH
GLT	ELH
HEL	TNL
LLCLETFEVLNVEVAAHQILSVLEI	LRLFVILEVVTAQDKLVLI
KNV	ECVNR
TIVE	FTIVLRE
LLCLETFEVLNVEVAAQHDQILSVLEI	LLTFILEVVTAHACQDKILKVLI
LRLKTFIVLEVVACQHDILKVLI	LECLTFEVLNVVAAHQILSVLEI
LCLETFEVLNVVAACSHDILSVLEI	LLFKIVLEVVTSHCQDKILVLKI
LLCELETFEVLNVVAASHRDQILSVLEI	LRLFVILVEVTCQDKILKVLI
LRLFIVLVRVTAQDLVLI	LLECLTFEVLNVEVAAEHQLSVLEI
LRCLKTFIVLEVRVTACDKILKVLI	KELELLFEVLNVHLIRIELVQLL
DQLF	KEVT
KDLLK	DDKALGE
DQLF	KEIG
DLA	KALG
LSQ	TETI
ALSQ	RTDE
ALSQR	RTDE
EESQWGS	R
RLRIRRA	DRVQNWFTN
LSEQ	HRKQLQ
RLIARR	DRVQNWFN
KLAASRNE	RLTVEDE
KLEHRLVE	RRIQDGYAYDR
KLEHVRLE	RRIQDGYAYDR
KLEHVRLE	RRIQDGYYR
KLEHVRL	RRIQDGYAYD
KLEHRLVE	RRIDGYYDR
KLEHRLE	RRIDGYYDR
NYEKETDLT	YRRERTRATLN
SA	KRD
RYDVQRRDYA	YELTGNRI
RYDVQRRDYA	YELTAGNRIR
RYRQRDDYA	YELTGNRIR
RYDVQRDRYA	YELTGNRIR
RYVQRDDRYA	YELTGNR
RYVQRDDRYA	YELTAGNRR
KLEHRLVE	RRIQDGYAYR
RYVQRNDDRGYA	YEGLTAGNRI
RYVQRDDRGYA	YEGLTAGNRI
RYDVQRDRYA	YLELTGNRI
RYVQRNDDRGYA	YELTGNRI
RYVQRDRDYA	YELTAGNRIR
RYVQRDDRYA	YELTAGNR
RYDRQDRGYA	YLELTFAGKNRI
RYDRQDGYA	YLELTGKNRI
RYDRQDGYA	YLELTFGKNRI
KLEHRLVE	RRIQDGYYR
RYDQRDGYA	YLELTGKNRI
RYDRDRGYA	YLELTFGKNRI
RYDRDGYA	YLELTGKNRI
RYDRQDGYA	YELTGKNRI
RYDRDGYA	YLELTFGKNRI
RYDRQDYA	YLELTGNRI
RYDRQDGYA	YLELTGNRI
RYDRQDRGYA	YLELTGKNRI
RYVQRDDRGYA	YLELTGNRI
RYDQRDRGYA	YLELTAGNRI
RYRQDDRYA	YELTGNR
RYRQDDRGYA	YLELTAGNRI
RYDRQDRYA	YLELTAGNRI
RYDRQDGYA	YLELTAGNRI
RYDRQDRYA	YLELTFGNR
KLEHRLVE	RRIQDGYYDR
KTRKHRD	QSNELLY
YLKGIR	YKEETQLSE
FSSTF	GGLRP
INY	HRPFA
GKRP	SFSF
SAVRPFG	TVW
SVRPG	VTF
RPLG	NSF
MRPLG	SNF
MRPLG	SF
RPFG	TIF
GGLRP	FSSTF
EEDH	KRTFQ
YSFS	DY
YSF	RYD
DRAI	DRY
EER	RERA
FSSDAK	EQAD
SGHVTA	VAGHTS
GDP	GDRE
SGHVTA	VTAGHS
ERHG	PDPG
SGHVTA	VAHTSG
FPFLL	WLI
DDH	RWD
NCDPRIAYGVCPR	CTNCAGRIKYFSIDKC
WERGQA	PAKMRD
GVL	GVL
DEEEN	KES
ETR	TRE
ETR	RTE
LGQ	QLGI
KLEPLK	KAELFLK
TSVI	AHRIIQ
SIL	EWSL
LLFQW	WLFQL
FWVEQLRNLTELALSLAVILERARALF	FWVQRELLNLTEALSAIVLTRREALAF
SLLLLF	EFWLLL
NSLEW	LI
KTLELK	TLELKLAQKK
YLTK	RAG
PNI	VRQG
MKAT	QV
PN	WSN
PN	SIWN
RQDAI	PRL
VLIELIL	FLSLT
VLITLIL	FLLST
VLIETLIL	FLLST
IESV	LFSSL
VIELIL	LFSLT
IELIL	FSLT
WTI	VAAL
SWT	AVA
YFL	FLVF
AYFL	QFLVF
VELNRLGLILLASYFFN	LQTLYEISFVPTNGAVL
VELNRLGLILLASFFN	LQTLYEISFVPTNGAVL
VELNRLGLILLASFFN	LQTLYEISFVTNGAVL
VELNRLGLILLASFFN	LQTLYEISVPFTNGAVL
SVELNRLGLIFAFF	KTIYLTIFANFT
VELNRLGLIFASFF	IKTYLPTIFTNAF
NVELNRLGLIFLASYFFN	KITLYLTFIPTNAAVF
NVELNRLGLIFLASYFFN	KITLYVLTFITNAAVF
VELNRLGLILLASFFN	LQTLYEISFVPTNGAVQL
VLNRLGLILLASFF	LQYTELSIPVFTNGAVF
VELNRLGLILLASSFFN	LQTLYEISFVPTNGAVF
NVELNRLGLIFLASYFFN	KITLYLTFIPTNAVF
NRTYLLLVALSSF	EFRLFAIFICYET
NRTYLLLVALSSF	EFRLFAIFICYFET
NRTSYLLLVALSSF	EFRLFAIFICYFET
NRTSYLLLVALSSYF	EFRLFAIFICYFET
NRTSYLLLVALSSF	EFRLFAIFICYET
NRTSYLLLVALSSFN	EFRLFAIFICYFET
RYLLFVVSNF	FREFAITILSYEV
NRTYLLLVALSSF	EFRLFAIFICYMET
NRTYLLLVALSSYF	EFRLFAIFICYMET
NRTYLLFVAVSNFN	EFRIFAISTLLYEV
NRTYLLLVALSSYF	EFRLFAIFICYFET
QLLIALLVIIVQTS	QLLIALLVIIVQST
QLLIALLVIIVQTS	QLLIALLVVIIVQST
QLLIALLVVIIVQTS	QLLIALLVVIIVQST
QLLIALLVVIIVQTS	QLLIALLVIIVQST
IFIALLALIVKS	IIFALLAILVKS
LLIALLVVIIVQTS	LLIALLVVIIVQST
IFIALLVALIVKS	IIFALLVAILVKS
IFIALLVALIVKTVS	IIFALLVAILVKVST
QLLILLVIIVQ	QLLILLVIIVQ
QLLILLVIIVQTS	QLLILLVIIVQST
QFILLVIIVQTS	QIFALLVIIVQST
QFILLVVIIVQTS	QLIFLLVVIIVQST
IFIALLVALIVKTS	IIFALLVAILVKST
MLTV	EMTI
MVLTV	EMTI
MLTV	ETI
MVLTV	EMTIF
VLTV	ETI
FTI	MEVL
LTV	MTIF
VQLTV	MTIF
LTV	MTI
MVFTV	EMTI
MEVFTV	EMTI
VFTV	MITI
FTI	MEVLF
EKD	EEPFVR
DGQH	NVGEL
GQH	NVGEL
WSGER	FD
GE	MSVT
RFE	SFQDF
LWAAMF	PVDDLF
FLWW	FFF
FLWW	FFFF
QD	KVQR
QKD	VQR
GIIFA	MWI
GIPIFA	MWI
IIFA	MWI
GPIF	MWI
IPIFA	MWI
PMIFA	WI
PIFA	WI
GIFA	MWI
MIAILLRRGN	FVIVPASP
MIAILLRRGNL	FVIPVASPQ
MMIAILLRGN	VFIVPVASDY
MIAMILLRGNL	FVIPVASD
MIAMILLRRGNL	FVIVPASPQS
MIAILLRRGNL	FVIPVASP
MIAILLRGN	FIVASQY
MIAILLRRGNL	FVIPVASPQS
MIAILLRGNL	FVIPVASPQ
MIAILLRGNL	FVIPVASP
MIAILLRGN	FVIVPASQD
MIAILLRRGNL	FVIVPASPQD
MIAILLRGNL	FVIVPAS
MIAMILLRRGNL	FVIPVASPQDS
MIAILLRGNL	FVIPVASQ
MIAILLRGNL	FIVPVASQD
MIAILLRGNL	FVIPVASQD
MIAILLRGNL	FIVPVASPY
MIAILLRRGN	FIVPVASPQS
MIAILLRRGN	FIVVPASP
MIAMILLRGN	FIVPVASQ
MIAILLRRGN	FVIPVASDP
MIAMILLRRGNL	FVIPVASP
MIAMILLRRGNL	FVIPVASQPY
MIAILLRGNL	FVIVPASQD
MIAILLRGNL	FIVVPASQD
MIAILLRGNL	FVIVPASQ
MIAILLRGNL	FVIPVAS
MIAILLRRGN	FIVASPQ
MILLRRGN	FIVASPQ
MIAILLRRGN	FIPVAQS
MIAILLRRGN	FIVASQY
MIAMILLRGN	FIPVASQY
MIAILLRGN	FIPVASQY
MIAILLRRGNL	FIVPVASP
MIAILLRGNL	FVIPVASQS
FI	SYVL
AFL	IYI
FL	AYVL
AFL	LIYSI
AFL	IIS
AFL	IIYIS
FI	SYVLQ
FMAFI	ILLVA
TFL	VMYAV
FLV	MYI
LFLLVL	FSLTIGL
SLPLLLVL	SAALIGL
SLPLLLAVL	SAALIGL
LLLLVL	ISLIGL
LSLPLL	ANYTLGS
LSPLL	NAATILGS
LSLL	NAATILGS
LSPLLA	NAATIGS
RRE	SGKN
FYFHAGDF	NADLLP
DL	KEQI
INRP	IV
LVTDSLPPFIYR	LYRIMGLQ
LK	IKNLNG
LK	IKG
LK	IKLNG
VDGA	SYQ
VDGAK	SYQ
KKNLPAV	KKNLPAV
KML	NDD
NDK	KLK
ALQEKLD	LAEQKD
ALQEK	LAKEQD
TALQEKD	TLAEQKD
LQEKLD	ALEKD
DFNRFGTRLQ	RLQTNFDRF
ALEKD	LAKED
ALQEKD	LAEKD
ALQEK	LAEK
ALQEK	LAEKD
ALQEKD	LAKED
ALEK	LAKE
IVAVIM	IVVAIM
SLAVIM	LSVAIM
NLAVI	LNVAI
SLATI	LSTAI
DFSTA	TNY
TQGDR	RKPG
TAVLSK	TVALSK
TAVLSK	TVALS
AVLSK	VALSK
VHVAL	HVLA
ELAALA	LEAALA
AVALER	VALARE
VIVAVIM	IVVVAIM
NLKEN	ELRN
KDLR	QLAGH
AGHTQL	LRGDPR
KERNNNI	NIENEDRLG
QKLVG	EKLL
LEKL	VGQV
DPADK	QRGERL
VLIIVIQQLEQMEVIQLLGHTSVLLVRVVKVRLQAILE	VLLIAVIQTQLRQQMVAIELLAHTTVLVKVVNVSLQILQ
VLLIAVQIQTQLRQMAVIELLAHTTVLKVVNVVSLQQIL	VLLIIVQQILEQEMVIQLSLGHTSVLLVVSVVRLQAEIL
VILLVIIGVSQRMRQLSVVELLDHTTVLKVHVVRVQRVKVTQL	ALLILVIQQVEMQELVQVLLAHTAVLLASVVRVVENQVEQVL
AILLVIVQQMEQQLEVVQLLAHTAVLLAVVVRVEQNVVEQLL	ILLVIIVSQMRQLSVVELLDHTTVLVHVVRVQRVVKETQL
ILLRVIIVSQRMRQLSVVELLDHTTVLVHVVRVQRVKVTQL	ILLVQSIVQQEMQELVQVLLAHTAVLLAVVRVVEQNVEQVL
TRRS	RLHQKKLE
RR	LKKLE
EILV	GILV
VFEL	VFEL
FDLG	LLSKG
DLKGEL	LGEDLSK
EEPD	QP
DAVQ	RR
VRCNAH	HCNRVA
NGVFFSCHKSHEFVA	ELHTMHYAVHLLIL
GVFFSCHKSEFVA	ELHTMHYAVHLLIL
NGVFFSCHKSEFVA	ELHTHYASVHLLIL
GVFFSCHKSEFVA	ELHTHYASVHLLIL
KDQ	FESLKEQ
FESLQK	KDQ
QLQM	DFY
DFY	QQML
QY	PAE
MKQ	KYC
EREAQRRDD	EQAYDQIR
MTA	IAALV
VNNFR	FRET
PLEPSEA	SLEPRG
VIDTILK	IDVPITL
NDLKELEGRR	QSHRKQIS
NDLKELEGR	QSHRKQI
NQDLKELEGR	QSHRKQIS
SKQIHRQS	RLEGREQDLKN
NDLKELEGRR	QSHRIKQS
SKQIHRQ	RLEGREQDLKN
ETVLKLER	RRLLTKE
RIGNF	NEFS
TEFHGA	FEDYV
EERA	REA
ERA	ERAE
WDN	PGF
ERA	ERA
EVE	NAY
EER	RAEE
QEFE	DRL
NPKK	KNPK
KNKQ	NPI
VDT	VDN
GLY	YLG
LDNIT	KTG
PRGL	NESL
RGL	ENSL
ENLS	RGPL
PRGL	ENLT
SFLET	QEML
ENLT	RGL
VSFLET	EQML
LQEM	FSVLET
ENLT	PRGL
RGL	ENLT
LQEM	FSLET
PRGL	ENLAT
ENL	RG
TDLPALLL	ALLPDLTL
VHDLGVK	KFGDV
VDLVK	KFG
PSNDA	APNPS
DREANSWRVRE	RVEWRSNEARDD
DDREANSWRVRE	RVEWRSNEARD
DDREANSWRVRE	RWVERSNEARDD
REDAE	RAG
GAR	AEDKRE
GAR	AEDRE
REDAE	RGA
GAR	AERED
KREDAE	RAG
GAKR	AEDEKR
DAE	ARG
SDLSNS	SNLSDS
EPNG	NEPG
QMVHF	ER
RE	TSNN
REK	SNND
VFEG	KAE
VFEGW	KAVEI
VFTEGW	KAVE
PNLWALGFVF	RAVNVGFAFAQ
NFKE	KNFE
LYLSY	GLY
LKLSY	GLY
LKYLS	GLY
LLSHY	GLY
LKLSH	GLY
LLSY	GLY
LLSYD	GLY
LYL	GLY
LKYL	GLY
LLHL	LY
LKYL	GL
LKYLHL	GLY
DFNN	FNNDK
IEFK	YIVV
YIVV	IEKF
IEFK	YIVVG
SLKL	IIG
SLKL	IG
QILHID	LQIDIHY
QILHID	LQIDIH
QILQQSR	SDSFELDKQKT
QKTKDKELSS	RSQQQEQ
SDSQLRL	RLQSDF
LQELVSEVQFVSLQQLI	ALQLEQESVFVLSLI
RLQELSEQFVLSLQLID	ALQLEQSVFVSLQLIL
IEQDEQ	VEKSR
QIEEQ	VITIE
FWKVALH	MIANEVL
FWKVALH	MIAEVL
YAKE	YAKE
MAGGG	NNY
EGS	YDGHW
IITAE	MKRK
ITAE	KEPKKGY
KRK	ITAE
ITAE	EPKKGKY
ITAE	EYPKKKG
ITAE	RKK
ITAE	EYPKGKK
KK	TAE
IITA	MRKK
TAE	PKKGKEY
IITAE	MKK
ITAE	KK
KGT	EEQK
TEHL	VKN
RQIK	FNDL
EKFN	QK
SEDF	FSED
KN	RDHAD
DHR	HRD
IKD	IKDK
GET	ETG
YDI	QRT
TIEP	GIRSY
DMVGKV	NESW
GET	ETGV
AENRA	RLYP
KTGYNKQR	TERQADK
KGTFD	VKTFRI
SLAFRD	LSAFRD
VGET	TEG
HHD	HDH
TEEQ	RRD
DDPIEKAK	YVPGNI
AKE	PAHISTQ
EES	RNK
EFES	RNK
SSPYR	SSPYR
NSSPYR	SNSPYR
GQFT	YFQG
SN	ATTV
RCGV	DGVC
RLY	IGV
RLY	KSIGV
RLY	KSIGVE
ERLY	KIGV
ELY	KIGV
RLY	KSIG
FRDR	RSN
HELY	IRGV
THELY	RTIGV
RLY	SKSIGV
QIM	YIAYR
RLY	KSIV
ERLY	KSSIE
RLY	KSEIV
KDHILEYILLRVETILR	DIKEHLILYLVILTRE
SRLAIQEINLQYIII	RSLIAQQENILQIYI
TYVLELHL	YTVLLEHL
TYVLELHKLLKDHILEYILLRVTILR	YTVLLEHKLLDIKEHLILYLVILRTRE
NIIII	NIIIA
ENQIIIIL	QNIIIA
NIIII	NIII
ENIIIIL	QNIYII
AGRMDE	DRMGA
SASE	VQEREY
EFES	RLLGR
EFKA	LLE
KELRT	IWER
KELT	IGSPAET
KELT	IPGSAET
EDLI	RGD
NNGV	GVNN
GDR	LIED
RHDEPQRVGDDG	DRVGQPHERD
HGD	GDH
RRE	VWAGG
ECS	CSE
ENKSKK	HRRSARSL
ENKSKK	HRSARSLQ
ENKSKK	HRSARSL
EVNK	RRP
LRGR	RGRLRY
HRSARLS	ENKSKK
NLRWQEQ	QWQELRN
NLRWQEQ	EQTWQLRN
LRWQE	WQELR
AIGDL	EAID
VMFGNP	MNPGF
SEPVDT	RKQPF
GLLALTM	LTMAGLL
IELALL	LLAILE
VRLSQIIK	IISVLR
IELALL	LLKAILE
IELALLK	LLKAILE
HGVD	NK
GAEGLS	TEGAG
QITEGAG	RAGGLE
VWVRN	PGKQT
VWVVRN	PGKQT
VWVRN	PGKQ
SFR	ALE
LHEE	LHE
KNEA	RAKT
TARK	AEKN
KNADAGLT	QL
NFR	GAMGTSD
QKNEA	RAKT
AGGTSD	NFR
KEA	RAKT
QL	KNADAGLT
AVSLS	GM
GM	AVSLS
AAPAI	GPKV
KPGV	AAAPI
LTI	TELI
AELADQSVKVFLKYK	KYFLKVVSQEADAL
QVMVTLL	LTLMVVQ
LLY	MVLTL
MVTLL	LLY
ALQVMVTL	LTMVVQLA
RLH	RLSH
RLSH	RLSH
EAHLEND	HHTRR
VAVIFG	YVT
VADVGG	LRGHH
EIDFQ	QDFKEI
IDFQ	DFKEI
DL	RRG
DPFTY	IESL
KEDLSLNG	LYRAD
DTL	KMFAG
TL	MFAG
FE	IEAA
FLRR	FVE
DSN	GGANG
DSN	RGGANG
FLIVQ	LIVE
LIVE	FLIVQ
PDFEE	RY
IVQE	LIMVE
LIMVE	IVQE
IMVQE	IVQE
LIIVQE	IMVQE
KDIN	NIMDK
KDINM	NIMDK
SDM	RALA
IQA	FDM
AQIE	FMLK
IQSL	LTAI
GALR	RAAG
ADHR	LAIE
IAQ	IAQA
ENKYT	QNKGY
LDKA	KADL
LDKA	KADKL
LDKA	DKAL
QVADYE	RKHRD
KIDQPMKV	DKQPM
NDMALS	AFVLR
YG	KKNS
AGLTLGD	DPKH
WG	SAL
GRSE	TPAL
IWGS	TNSL
LLR	LLR
IYNR	INRY
LYLR	LLRY
IYNR	IRNY
LYLR	LLR
VSD	SDV
ALTGMET	TLMEGGTA
NALTGGMELT	TLMELGTA
NTK	PTGEY
ELRKGETD	RREEKRL
TDTTK	NK
GVS	YD
GLSA	LSAG
MLAVE	VEALMG
MGL	VSS
SSV	GLM
EMLASVE	KKVEASLM
PLVNIYNCSGVQVGD	YTINSTGIQIGYAN
VVVGD	DVVIN
TIIQIGA	GAIIIQT
TIYNSTGIQIGAYN	NIYNCSGVQVGD
IGAN	VVIVN
LVNIYNCSGVQVGD	TIYNSTGIQIGYAN
IGANYM	VVIVNL
TIYNSTGIQIGAYN	PVNIYNCSGVQVGD
VNIYNCSGVQVGD	TIYNSTGIQIYGAN
VNIVVGD	GDVVIN
ISCTEM	LVKNRLA
LVKNRA	ISTCTE
TISCTEMK	KLVNRLA
LVKNRLA	ISTCTME
EVKG	GVEK
QLERR	RRQLE
ALPQEELRQRKN	NRKRQLQEEALP
LFSYELSS	SLSYELFS
RYQ	YNQTR
RYN	YNQR
RYNQ	YNQR
RYNQT	YQR
RYQ	YNQR
RYNQ	YQR
RQTYND	DYNQTR
YND	ADYN
YINDA	ADIYN
SRNDRS	RSDNRS
RNDR	DNRS
RNDRS	DNRS
RYNQ	YNR
QVHQYS	RQVQHYS
SNRPS	RSR
RNS	FNRS
SSSPD	RR
RTYQNAD	ADYNQTR
RTQYNAD	ADYNQTR
DSSL	HSCCPE
HVQYSC	QVQHYS
SPHYC	DLSS
HCSCP	DLSS
VQHQYS	VQHYS
DSSL	HSCCP
TRQVHQYS	VQHYS
RSD	SDN
RD	RSDNR
SCCP	ENS
SSSD	RR
TRQYN	YNQT
TRQYND	YNQTR
QTYN	YNQT
TRYQN	YNQT
TRQYN	YNQTR
TRQYN	YNQTSR
TSRYQN	YNQTR
RTQYND	DYNQTSR
TSRQYND	YNQTR
HSNS	RDR
QTRYN	YNQTR
TQYN	YNQT
PSITLTTIK	ALTLTTHE
GKK	KGK
FST	AEGL
VPAD	ADVP
NNHG	LN
NLT	HGNN
NNHG	LNT
NL	HGNN
NADAVDR	NPAPLPG
DKSW	DDW
QSPGSYPKSWS	QSSWPKSSPGY
RELRGADE	DGELRR
RRELGEAD	ADEGELRR
ELSEHNKGW	KGHLNSEE
QSSPGYPKSWS	QSSWPKSSPGY
QSPGYSPKWSS	QSSWPKSSPGY
RQSPGYSPKWSS	QSSWPKSSPGY
QSSPGYPKWSS	QSWPKSSPGY
QSPGYSPKWS	QSWPKSSPGY
QPF	VPTS
PKQVNQ	KEA
AAQ	ASE
AQA	AS
AQAH	ASE
AQA	ASE
AAQH	ASE
HVKPP	CLPVK
KHVLP	CLPVKC
HHVLHATVHS	HDSVATLHVH
VAL	VAL
RYPVGLRLSEI	SEDILLRVGYPR
RYPVGLRLSEDI	SEDILLRVGYPR
NSFR	ERD
RR	QDDAG
PRSLRP	PRLSPR
LDD	LDD
DLD	SLDD
DLSD	SLDD
VERT	DRWGR
ERG	TQCE
TPDF	ENA
DLH	TPE
AGRF	RFA
QES	ESQ
AAQTS	ASQ
RSN	SRNR
NY	PID
NGIEE	GWRKD
PDN	ET
KK	KARG
GRFA	KKNPE
GFR	KKNPE
AAH	AAH
ETVQK	LNLVEE
GSD	TSD
GDS	TTSD
NRNQI	NKR
NNIRQ	NPKR
SQQCFS	QSCFQS
QCFD	CFQD
MTQED	DMTQ
PGDHK	GVFNV
PG	GVFN
KDN	ENDK
KDNE	ENDK
QV	LKVV
DR	NQE
DR	NQKE
SELDKR	INQE
LELRYFQNLIKELFLEL	ELFLLEEEKILQYFRLL
EKPTID	KWGQRK
CTHT	LCTH
NKTS	KFDL
WLTNILVVEDQLRLIQ	WDLNGILHVVKQLDLLQ
WDLNGILHKVQVDLLDILQ	WTLNKILEVKVDQRLELILQ
WTLNKILSEVVDQLRELIQQL	DLNGITLHVVKQLDLILQLE
LGILHVKVQDLLLQIKELLSLEV	LNKILEVVDQRLELFIQQLLLLS
HMTHLIDILNQTKIYKLLRTVKQ	LINGILHVVKQLDLDILQLELSLEVE
HTQLDISIQLQTMIKYLSLTLV	WTLNKILEVKVDQLELIQQLLLL
VVQ	VVQE
HES	HES
PSIQ	DW
WD	QPSI
EARERR	RPKD
KPDR	REAER
RR	PLNTQ
DSQN	QRQ
PTSS	TS
SPT	PTS
TFV	FTV
FEA	FEA
FEAM	FEA
DTVP	VTDK
KDTV	PVTD
YEAT	YEAT
YEAT	YEA
TIF	FTI
FDE	HNL
FED	LHNL
LGVV	LGGVV
RNSQFA	QRQYS
EKDNMN	KEDMNN
ERENAA	RENLAANH
NNTEENRQQQER	RVQEQRENTNN
RNELAI	EENN
NSTNEERQQRE	RQEVQRENATNN
ERNNALAH	REELAN
NNTENAERQQQERV	RQEQRENTNN
EHNTN	ADYIQ
NNTNEERQQER	RVQEQRENTNN
NNTNERQQERIV	RQEVQRENTNN
IASR	FIYI
WVQADGSR	AGGQFE
QFEGGA	ADGSRQVW
QVWADGSR	GQFE
QFEGG	ADGSRQVW
WDVQADGSR	AGGQFE
QFEGGA	ADGSRQVWD
QFGGAA	ADGVWD
LPILGLF	PILLGLF
PLILGLFR	PILLGLF
LPILGL	PILLGL
LLPIGL	PILLGLF
LFL	LFL
WS	ICPTQ
KALT	EGQ
NTVKLEI	LEIKTNV
YMEFLSSAD	ACRETLWQYK
LLPEYPDNV	WRMWKIK
FADQLVKLYLDAI	KLYLQLKVEAKF
DAHEKQ	HKQEKD
FADQLVLYLDAI	KLYLLKVEAKF
HQLHILIDLY	YYIDDLEIQHQQG
LIIHQGLHELID	LEIHQGLHLIIDL
DADYILYLILL	YYIDADLILL
IKLVDLIILHLQQQGLHILI	YILIHLQQGLHLIII
YIYDLLIL	YYIDLLIL
KIIILLQSLQKKR	YALIKLKQQELSLII
ILLIQSLQKKLIAY	KLQQLSLIIDIK
IKLVDDIILGLQQLHI	YYIDLIHLQGLHLII
LQIHLIDL	IDLEIQHQQ
VKNDV	NDVVK
KVNDV	LNDVVK
FGEAI	QTAKQVVQ
GRVR	RER
GRPEA	RER
VDVKQEAY	YAEQDVKV
EKRTGG	EEDSE
KRTG	EES
GNKEHGPIERI	IREIPGHKGNE
GNK	GAY
FEVIILAF	FEVIILAFA
EGKSTEL	FIMI
SATELN	FLM
TEES	FLIM
TEESR	FLIM
QREHNDLKNK	KNLKDNHQRE
DLAD	SAV
AKTHKI	HKIAKN
EKPL	QGKG
VAAQAQP	PQAALVAQ
DPANP	NPAPD
PND	KTR
LE	DTPSHY
KTR	PND
SNVAN	PRKLR
SNVANV	PRKLR
QG	YQG
GDSK	DEA
DGIK	FQ
GDKD	FQ
QRQE	NDDAK
NDDAK	QREQ
QRQ	NDDA
RE	KERC
NAGR	EG
KQMY	YKQM
YKDAN	KTTDR
TDRT	DANK
KGAK	KDDN
AQNQ	QG
EDS	EDS
LQE	ELIQ
LQE	ELQ
PRQR	RPRQ
TNP	DEA
SETE	ET
YASEP	PSEYAK
AYPS	PSEYA
YAPS	SYA
YAPSE	PSYAN
RDNTLSDNQ	DNQILSTR
RTILSQND	DNQLSTDRN
RDNTLSDN	DNQILSTR
RISTLQND	DNLSTDRN
RILSTQND	DNQLSTDRN
CYSP	PSYC
GVQ	NK
VESDKGRYG	LPRVYDFSFIR
VESDGRYG	LPRVYDFSFIR
VESDGIRYG	LPRVYDFSFIR
VEDRRRY	LPARDEWDAERL
EDRRRVY	PARDEWDAERL
QKGIK	MGREE
VEDKRA	LPAREEFAR
RRPSQV	ESRRPQ
TSLNG	TSLG
QKTDN	GKTDNQ
DQNTG	KTDNQ
QNLTTD	KTDNQ
PERMSD	DSMPER
KLLQD	EKQ
EPKK	KQD
RDETS	SETDR
RDSE	SETR
NADYS	ADSN
NAQDK	YTGTSA
AGKK	KAG
GVGN	NGVG
FKDGKD	EKVFGK
PERK	HEEK
VWSDT	LANEAW
VWASD	LANEA
NEALA	WASVD
VWASD	LANEAW
VWASD	ANEAW
LLALILF	MILVACAALSV
LALLIF	LVAALSV
LALLIF	VACALSV
LLLILFFM	IIVACALSV
LLALIF	ILVAALSV
LLLLIFR	ILVACALAVGD
LLLLIF	ILVACAALV
LLLLIFMFS	ILVACALAVN
LSTLIIFN	IIGVALSVRG
VFVVILYVF	VFITAAALALY
LYVVYS	ILISASIGLAL
FVIY	LMAAVAVLGLV
FVILYV	LMAAAVAVLGLV
LIMLAPIKIMH	WLVSIGVEI
LIMLAPIMH	WLVSIVI
LLIMLAPIMH	WLVWSIVI
FFVMLAI	LVTII
LVFLAPKII	WMVWSIEI
LVFLMNKIP	WMVWSIEI
DRMDK	MDRDK
RYYE	IKA
DLT	KGVNV
DGVNVK	KTDLV
DLTK	KGVNVD
DGVNVK	KTDL
DLTVK	KGVNVD
GVNVK	TDL
RCG	DQS
KADHVA	SVFGRDNP
QHADV	DAQHV
QGH	QH
QGH	QGH
QHADFV	DAQHV
KAAALQ	QLAAAE
HNE	PHNE
RQEL	ARNERRKA
GAGFGPK	DKPGGGF
PVAFL	FLPVA
PVAF	FLPVA
PVAFL	FLVAL
VAFL	FLVA
PVALFL	FLPVAL
LILP	LL
LLIYP	TLL
LLIP	TLL
PAQ	EDA
HEQN	DIQGDVL
PAYSH	NPGS
HQN	DQDVL
RHPQ	QPDR
PVIF	TPFVI
QQH	DQD
YF	LLL
LIYLP	LL
QH	QGH
LL	LPIYL
LL	LPIL
GNLE	SQM
EGR	AE
GDE	TFSD
NSDD	WKL
DPEWF	LSETFLW
LLMSVPLLL	LRSLLLVPL
ILK	IEL
LLSMVLLL	LSLLMLVL
LLSVLLLKRE	LSLLMLVLVYEQ
KLLALEE	ELEALLK
KLLALE	ELALLK
KLLQALEE	ELEALLK
MELF	MFEL
ELMF	MFEL
EMLRF	RMFEL
LLALKQA	LALLKAQ
LKLALEEQ	ELEALLKQ
LKLAELEQ	ELEALLKQ
LLKALE	LEALLK
EMLR	RMEL
LLKALEE	LEALLK
LLKALQE	LEALLKQ
KLLALREEQ	RELEALLKQ
KLLALREE	RELEALLK
KLAEL	ELEAK
KLAEE	ELEAK
KLAEE	RELEAK
KIEL	EIKL
MIE	IKL
QMVPSLKLI	RNILLSL
LLSIE	IKLSM
LLQME	ILKL
LSMKELIE	EIKLESLM
YQYL	REFE
YYLT	GSD
LSMKELIEE	EIKLESLM
YQY	REFE
MELSELKIEE	EEIKLESLME
DETYY	GSDETYY
FRE	YYLQ
YYE	TYY
VLMESLKEIE	EEIKLESLML
MELSKELIEE	EEIKLESLME
MELSKELIREE	EEIKLESLM
MLSELKIE	EEIKLESLM
YDYT	YRFMKK
YYQ	YYLQ
MELLSELKIE	EEIKLESLM
LLSVLL	LSLLLV
EER	REEI
LLSVL	LSLLLV
GRE	EDY
KIL	EIL
KILN	EIKL
ILE	IKL
ILEN	IKL
KLLAELRE	RELEALLK
ELRM	RMEL
ILSL	ISLQ
LISMLTLY	KISLLMYLT
KMI	EMI
MKIE	MKI
KILE	EIKL
DLLSSLKD	KLSLLSDV
LLSSLKD	LSLLSDV
ILE	ILKL
RQV	LELSDVV
LLSSKLV	LSLELSDV
LDLSESKLV	KLSLLSV
LLSSKLV	LSLLSDV
APSDDVVS	SDVVPASD
LLSSKLV	KLSLLSV
DLLSSKLV	KLSLELSDV
LLSESKLV	KLSLLSDV
LSDLSKLV	KLSLELSV
LLSESKLV	KLSLELSV
QGTVAIQSGFT	TFSGQSNAVIGTQ
GNNS	NN
TGVP	VPGT
KAN	QPS
DHD	GELN
FTTLC	CTFT
AKVFKD	GSPKISDK
GSPKSIKD	AQKVFDK
VVLRQ	ANSN
YAD	RVFR
YSAA	AQVF
YAA	AQVF
YSAA	PAQVF
YADR	RVFRN
YAA	PAQVF
NGNFD	EDGNNF
GNND	DGNN
GNND	DGND
GNDD	DGNN
GND	DGNN
AVA	HE
HE	LAVA
LAVA	HE
HE	AVA
DPGRF	KED
DPGRFY	KEDL
DSPGRF	KED
YSPTGRFY	EEDL
EPGRYY	KEDL
DPRF	KED
TPGRF	KED
EPGRY	KEDL
DPGHY	KEL
EPGRFY	KEDL
DFRY	KEADL
ETANL	KRYR
VNEY	AFSK
DNRTL	WTM
DNRTL	WT
DNRTL	AWT
DNRTL	TAWTM
DEGS	KSD
LWFDP	LFPWD
EEL	EVS
SDRDT	RDTSD
LGQ	AL
NE	RHGEC
GERHH	EN
GLQ	KAL
RVADD	DAVDR
DAV	SDAV
VRAD	AVDR
DAV	DAV
SDAV	SDAV
RVAD	DAVDR
YSDAV	SDAV
DYSAV	YSDAV
SDYAV	YSDAV
EYTRP	RPTE
QQLR	LQQR
KEES	RD
YSWYR	YSWYR
DR	SFEE
VNYAP	YEP
QE	EGTK
RKHKR	LLSEQLN
QYG	MSECN
RLQYLD	LYQKHREF
NMD	TIA
LYN	YHS
HELHTSL	FFKHGYN
QLSNELLY	KRHRKDK
DVD	YYDS
DDVVD	KYYDS
DVD	YYDSM
DDVVTDE	KYYSTDR
DVVTDE	YYSTDR
DDVVTDE	YYSTDR
DVVTDE	YYSDR
QVVD	YYDS
QVVDD	YYDSK
DQVVDD	QYYDSK
DQVVDND	QYYDSK
EEIVSD	KYYSD
EEIVSD	KYYSTD
EEIVSD	KYYSTDR
DPISD	KHYTDR
DPISDVG	KHYTTRD
DPISD	HKYTTDR
DPISDVG	KHYTRD
QVVD	YYDSK
QVD	YYDSK
HQVVSD	YYSTD
HQVVSD	YYSD
HQVVSD	YYSTDK
HQVVSDN	YYSDK
DQVVTD	KYYSDR
DEVVTDD	KYYSTDR
EELVADI	RYYTDK
EELVADD	RYYTDK
EELVADI	RYYTKD
NNVSDR	HYSD
DPISDVG	KYHTTRD
DPISDVG	HKYTTRD
DPISD	HKYTDR
DPISDVG	KHYTDR
DPISDVG	HKYTDR
DPISDIG	NKYSSRDN
DPISDIIG	NKYSSRDN
DPISDIIG	NKYSSDNR
DEISD	KYHTDR
DEISD	HKYTMDR
DEISD	HKYTDR
DEISD	KHYTDR
EEVVSDD	KYYTDK
EVVSD	YYTD
EEVVSD	KYYTD
DPISDVG	KYHTDR
DQISD	HKYSDR
DQISD	KYHSDR
DQISD	HKYSTDR
DQISD	KYHSTD
DQISD	HYSTDR
DPISD	KHYTTD
DPISD	KHYTTDR
DQVVSDD	KYYSTDR
EELVADID	RYYTDK
DPISDVG	HKYTRD
NDEISD	YHSTD
NDEID	YHDS
NDEISD	YHSD
EPLRD	HYSDR
EPLRD	HKRYSD
EPLRDY	HYSDR
EPLRDY	HKYSDR
EPLRD	HKYDSVR
EPLRD	HKYSD
EPLRD	HKRYSVD
EPLRD	HKYSVDR
EPLRDY	HKYSVDR
HQVVSDD	QYYSDK
HQVVD	QYYDS
HQVVSDND	QYYSDK
DVVTD	YYSVDN
WRGRCNN	EYYYDS
WRRCNN	EYYYDS
DDVTD	KYYSVDN
DDVVTD	KYYSVDN
DDVVTD	KYYSDN
DEVVQD	KYYSD
HQVVSDN	QYYSTD
DEIQDVD	HKKYSHDR
DEIQDVD	KKHYSHDR
DEVVQD	KYYSDQ
LPLDR	YHDSV
EPLRD	HKYSDR
PLRD	HYSDR
EPLRDYS	HKYSDR
LPLSDR	YHSVD
RAN	YDS
LPLSDR	YHSVDR
EIQDV	KHYSHD
EIQDV	HYSIHD
DEIQDV	KKHYSHD
EPLRDY	HYSVDR
DDVTDE	KYYSTDR
IPLVD	HYSDT
EPLID	HYDST
PLID	HYDS
EPLID	HYDS
EPLID	KHYDS
PLIDR	HYDSI
EELVADI	KHYTDR
DQVVTDD	KYYSTDR
DDVVTDE	KYYSDR
DQVVTDD	KYYSDR
EELVAD	KYYSDK
EELVADD	KYYSDK
LPLVDD	YHDTR
LTRA	GHLYDT
LPLDD	HYDR
LRAQ	GHLYDT
LPLVVDNHD	HYTRD
LPLVDNHD	HYDTR
LPLVDND	HYTDR
LPLVDFD	YHTDR
LRAQ	GHYDTS
LPLVVDD	HYTDR
LPLVDFND	HYTDR
PLRAQ	DGHYDT
LPLVDD	YHTDR
LPLVVDFND	HYTDRH
LRAQ	GHYDT
LTRAQ	GHLYDTS
LPLDFD	YHDR
HLTRAQ	LGHLYDT
LPLVDFD	HYTDR
LRA	GHYDT
LPLVVDD	YHTDR
LPLDFND	HYDR
LPLVDD	HYTDR
LPLSDR	YHSDV
LPLSDR	YHSDVL
LPLDR	HYDSV
LPLSDR	HYSVDL
LPLSDR	HYDSVL
LPLSDR	YHSDVG
EPLRD	HKYDSV
EPLRDS	HKYDSVR
EELVADIND	RYYTDK
EELVADIN	RYYTDK
EKLHDD	HRYDSR
EKLHDD	HRYDSVGR
EDLVTD	KYYTVDQ
EDLVTD	KYYTD
EDLVTD	KYYTVD
EDLTD	KYYTVD
EDLTD	KYYTDQ
PLID	HYTD
PISDK	HYSTDV
PIDK	HYDSV
DEISDVG	HKYTMRD
DEISD	KHYTMDR
DEISD	KYHTMDR
EELVAD	RYYTDK
EELVAD	RYYTD
PLVD	HYSDI
EPLVD	HYDSI
EPLVDR	HYDSITL
EPLVD	HYSDI
TDEISD	RKHYTMD
DEISDVG	KHYTMRD
DEISDVG	HKYTRD
DEISDVG	HKYTMDR
DEISDVG	KHYTDR
DEISDVG	KHYTMDR
DEISDVG	KHYTRD
AVVSDD	YYSTDR
AVSDD	YYSTDR
EPLVD	HYSI
PLVDR	HYDSIT
EPLVD	HYSD
EEVVSD	RYYSVHD
EEVVSD	RYYSVDH
DLVTD	YYTVD
EELVADI	KHYTRD
ELSDR	HYSDIM
LELSDR	YHSDIM
NEPISDI	YHKSKD
NEPISD	YHKSVD
EPLVID	HKYTD
LARA	HLYDT
EPLID	HKYTD
EPLVD	HKYTD
EPLVID	HYTD
EPLD	HY
EPLID	KHYTD
DVVD	KYYDS
EELVADIND	KHYTDR
EELADID	KHYTDR
EELVADID	KHYTDR
DQVVTD	KYYSTD
QVVTD	YYSTD
EDDRR	KKWE
EDDRR	KKE
SKGKRE	YDDDS
SGEV	KRPP
TS	ETLS
RPLAER	YRYLE
ARPLAER	YRYLE
RLLE	YLR
RMFEK	YYLR
RMLEEQ	WQMRR
ETVMK	RIQRL
RRLDR	EQRLSE
DNRA	PF
RWAIGPHD	RGFSER
REDIASDR	RASDREDI
KQFE	QTKFE
AVE	AVVA
FFKYL	FYLF
FFKIY	LFFSK
GSEK	SGKE
PEAAIR	RIAE
ERVR	KNNA
ERV	KPN
ISI	KHKL
SI	HKLK
KSI	KHL
KEF	EP
ERVM	RNAPV
ERV	RPNA
ERVM	RNAP
ERVM	NRPV
ERVM	RNPV
GLP	GAG
ERV	KPNN
NQAN	QGRTP
VYR	PQALM
DEKL	MKGL
ERVM	NRAP
ERV	NRP
RVDR	PNVKL
RVDR	NPVKL
KAV	PMG
SLN	KD
LVVWSQQ	LLSVLPP
LVVWSQQ	LLSVLSPP
VVWSQ	LSVLLPP
HKKK	ESE
PSQAG	GQAPS
HGGRKE	HGKGRE
TKDKHRD	TKDRKSD
TKDKHRD	TKDRKHD
QSDMTQET	DSAKQW
ERL	KPN
RQ	PAY
RQ	AYNP
REL	FQGP
RELW	FQGP
SAWGD	GGR
AEE	AKSF
EEEY	KV
KNYTSP	QTKRR
LLCNLPI	MLRVPQ
ALSAPH	RLTPQDC
ALSAPH	RLTPQD
RYA	AKP
RGTNYNR	HTRTHLHS
KRG	LAP
DAKK	DPVAE
KRGR	PLGAH
QWGQKRAV	VAPPSDPL
LYRISK	RYYKS
YTNY	SQNQG
DSRGLEK	KDSRGLEK
QDNK	DQNY
AALES	QSHGQ
QDYN	DQNY
KND	EDPKE
EAKALR	LRAKAE
EKNR	GQNDKSH
FAG	FAG
QLFKH	EFPG
QLFKH	FPGE
RYAF	FQQM
AEKN	GDK
NETL	AFK
KKS	EDNQR
PYE	NTYE
LFQ	RAV
KTTN	GSQ
LVACGDPVPPKLR	RLPPVPCGDVLA
LEKSAL	RL
LEKSARL	RTLES
LEKSAL	RTL
TQEK	EDVRY
KEMQELLKELIK	ILKLELMEKE
VQN	VQN
EIQL	ILEQ
QSKH	KKEKS
PVT	SVA
GKS	KVLHE
KGKS	KHE
NELEI	MVRL
DPS	PSDK
DPSLKN	PSDLKN
DPSLK	PSKDN
FEDYQY	QFEDYY
FCL	DMQEL
EPSYD	NNKFI
FRR	DGLS
TNLIFNSG	QLLITAIIDVS
QTNLIFNSG	QLLITAIIDV
YQKG	SRTSST
SSRTST	KYQ
SSRTST	QKYG
YQK	SRTSST
DAAL	GVGR
KDIM	KY
IEE	RNP
ENDEHE	RSRGKK
FGSAD	PSD
SPD	GSAFD
LYGASK	APD
FGSAD	PDS
SPD	GSFAD
YHDT	YHDT
LYGASK	AKPD
PAD	YGLASK
PADK	YGLASK
QIVDNGALLSGN	GNSSTVS
KVE	GRE
KVE	GER
KKVE	EGR
GFSR	KK
DYLN	HIV
QDYLN	HIV
QDYLN	IVH
QRKS	GDKIE
DGF	GFD
STTQ	QTST
SNRR	GLAQ
LQG	QL
GKMEDKT	MTGDKEK
NGN	NNG
AREQ	QRDE
REQ	DQR
QRADEIKRR	NRIESDE
MSR	ADEIS
RADIK	NRIED
IAEGN	RS
RADEIK	NIED
NRADEIK	KNIED
KGNE	EQ
KEGNE	QSE
TTITI	IAIS
DY	PPPAV
KEVGT	DLI
SGAAAQF	RYTL
RSSDADKRYEIT	KSGTRNTAIGN
LEAGGDMS	LEDGMSGA
SGAAAMQF	RYTL
KEVGT	DL
AMAGAT	RHW
PEDREQ	PEEDQ
RRE	RR
GTLGAITAQQ	RSMDLMVNQR
RFPGLG	DNYE
DVQQV	SF
DTGV	AELE
AEAAA	FIG
GAAGVMQF	GFQI
SGAEGMQF	FQKKHS
SGAGMQF	FQKHS
SGAAGMQF	FKHSQ
SGAEGMQF	FKKHSQ
AAGAMQF	FQ
LQAG	KRRE
KAAAGAMF	GIF
KMEQ	HFE
KKLE	VNDPYD
KKLE	VNDYDP
DRYL	FKK
NFVTAFQ	QTAFVFEN
NFTAFQ	QTAFFN
FTAFQ	TAFFR
ENFVTAFQ	QTAFVFREN
LLQ	LQN
YSE	QES
YSK	NQES
YS	NQE
YSEKE	NQEL
YSEK	NQEL
YSEKE	NQLE
PAA	AFMH
PAA	HAFMH
QRL	PILTGC
ILTPGC	RL
YMAK	VPVLL
YMAK	VPVLKL
VPDR	VDPR
TSKGNFF	FFTGNSK
TGNFF	FGK
LTL	LTL
LVKNYG	NKFRF
PRELELLKQQRLIEFQHLQHQLHQQMK	KMHQQLQHQLFQHLIEQRQKLLLEREP
LKQQRQLIFQFESREHI	HIEERFSFQIRLQQKQL
NKGVD	SLT
SLT	NKGVD
TPDKE	DTPKE
QDLN	EDLN
KGKY	GIN
INDKKQ	KNRDV
AWGRCE	CEGRAW
LALDEEV	LARW
LALDEV	MLARW
LANLDEV	LAERW
LALDEEV	MLARW
LANLDEEV	MLAERW
LADV	MLARW
LALDV	MLARW
LALDEEVAAK	MLARVAWYD
LANLDEEVAAK	MLAERVAWYD
LALDEVAAK	LARVAYWD
LS	PLADRV
LG	PLADFV
LGWRQAV	PLADFVDEAA
IDATF	YYW
VSDV	KD
SDVN	DRL
SDVN	IRD
DVN	RLD
DSNDR	DRV
NDPR	ERQ
FDLA	VGR
VG	FDL
KK	KDKP
AGM	AVY
KRN	TA
DAATQ	QTKADA
DAATQ	QTAAD
DAATKQ	QTAAD
LER	VLT
TRQT	PRWVNER
EGTGTA	GTTGE
EGTGT	GTTGE
SGAN	VREK
EEEQ	RLERINN
NLERRIN	QEEE
NEEH	LRERIN
LERRIN	EHE
SSLR	TTE
GFGG	NLLI
PEAK	KTPA
QNEY	QK
LN	NIL
EL	KNIL
ELNKE	KILN
ELNK	KNIL
ELN	LNI
ELN	KIL
LNK	NIL
YFSKL	VMQI
NGI	KNR
VDSGI	MSTQ
NNGI	RKNR
NGI	KNRR
VDSGEI	MST
VDSGI	MST
NNGI	RKN
NNGI	RKNRTK
VDSG	MST
DTSF	KRC
PDR	RKED
GTT	EVG
QGTDGNDVLIGSD	ISGGAGDDRDGGAG
LTFGTE	RITPPA
KGD	DKG
KGD	DDKG
KERL	VEKAA
QLSQ	SQQL
DFNMEFSSA	SAFSMEFND
YVETAFR	KAEFAMVT
TYMVF	TMVTF
TMVF	TVF
QTYIVE	EQ
QTYE	EQ
EAKIGENVEIAPFVYIDR	NVVIGDNNIKMANAINLYG
CQHHGSACHIGSGSVIGAYSTVGE	YSTVGEHSYIHPRVVIRERVSIGKRV
GDAEIGDNVNIGAGTITC	TKIIGDDVVFGSDTQLVA
GDAEIGDNVNIGAGTITC	TKIIGDDVFVGSDTLQVA
GDAEIGDNVNIGAGTITC	TKIIGDDVVFGSDTLQVA
GATSIIGNNVKLYQGVTLGA	HPILEDDVIVYSNATILG
EGAQLGDDVVIEAYAYVSK	DAKIGNNVVIKQGARILSDT
PAAGDDTFIGMQAFVFK	SKVGNNCVLEPRSAAIGV
PAAVGDDTFIGMQAFVFK	SKVGNNCVLEPRSAAIGV
HPAAVGDDTFIGMQAFVFK	SKVGNNCVLEPRSAAIGV
HD	GHVK
NCF	NEK
SRE	GVA
TKHK	GGSEE
NKYR	EPFNED
NKYR	EPFNEDD
QNKYR	PFENEDD
NKYR	PFENEDD
NGI	IKNG
GIK	GYNIK
RVNK	MY
YM	VNKR
YNGIK	IKGL
NGIK	GYNI
IKQ	IKQ
NGIK	IKYNG
NGIK	IKGN
YGIK	IKNG
NGI	IKYNG
IKLQ	IKQ
LPFARE	REAPFL
NE	RRGKD
ADDMEP	NKIDK
DTKR	RKSAT
RNY	RHD
RSNY	RDH
RSNY	RH
DTKR	KTSA
ADDMEP	NFKIDK
DDMEP	NIDK
ADDME	NKIDK
ADDMEP	NKDIK
HRDYGH	HQRH
WQHRH	GRDYHH
HRDYGHK	HQRHKQ
QHRHK	RDYGHH
HRDYGH	HQRHK
YGDKLYH	RGVESE
RERLELD	DLERER
RERLED	LELDERR
LLPIR	ILLD
LLPIR	LIDL
YP	RAFN
YAP	RAFN
AYAPKK	NRFD
DYGQ	GK
DYQ	GKK
RGYKQ	NRGK
HKDAASH	ASHADHK
KGD	QYIIN
GENRQI	RQEGEN
QINY	GD
EGENRQ	RQIEGEN
QK	PSAL
QTECKK	NSKLKE
QAGK	QGAT
KER	RTKE
LRG	WME
LRG	WMEN
KLRG	EWMEN
DTDT	ALSDQR
NYAQ	NYAQ
NYAQ	YAQN
NYAE	GNYA
NYAE	NYAE
KNYAE	ENYA
GNYAQ	KAYKKS
KAYKKS	GNYAQ
NYSE	NYSE
NAE	NYAE
NYAE	NYAEK
NYSE	NYS
NYSE	NYSEK
NYSE	TTHGS
NYSE	TTHGRS
KSRTTSH	SHTSRTKG
EGNDLKV	KHRYS
KQVHPDT	HS
R	YQKST
KSRTTSHG	STTKSHG
NYSE	YSEN
NYAE	YAENK
NR	KQST
NYAE	NE
RNYAQ	QNYAR
NSE	NYSE
NYSE	NSE
NYA	NYA
KKGPK	KPKKG
NYA	NYAE
PKY	NERKS
NYAE	NAE
KSRTTSH	STTRKSH
KSRTTSHG	STSRTK
KTRTTSH	STTTRKH
NYAQ	NYAQR
KQKAAKE	DKEQK
AH	AAH
VTERP	ATPVDM
FV	VLWT
VTEA	ATPA
FDQEIK	PKLSKY
FDQEI	PKLS
VTERP	ATPADM
RTSTGDE	QLQKVWPGDRC
VTEE	ATPVN
VTEA	VCPV
KGYPA	SGYP
ARISIK	ITLDY
ITD	NAE
TLDDIAE	IKRH
RKI	DADT
RKI	IADT
TDEAED	QQQEE
RLE	EGAEK
ESTP	PE
SETP	SPE
ERG	RDE
QLAPH	ALDTEQA
EQELAPH	KALDTQEQA
RRAK	ERDG
RAPK	ERDG
SYGVH	QY
GSDK	KDGS
TAH	PNG
GCITA	TSTL
N	VDNPNR
MMAAM	AMMMA
KE	TGRVY
KE	GRVY
KEK	VY
FPLN	VART
FLN	IAR
LQSR	VIR
LPLSA	VIR
FPLS	ILR
FLR	IARD
YVPES	REE
SEL	EEL
ELE	ELSR
DALWMGG	WMDALGN
DALWMGG	WMDALGNR
IRELK	QGR
DFRDLNP	FRDLDPN
EMAE	MAEE
QRKGE	KEGQK
RYEHND	KNR
QNEKARTE	MGDLGIGAK
QNEKARTE	MDLGIGAK
RDT	DRT
RE	VADHS
QDGD	RRVK
VGK	VGK
FRYS	FRYS
LYMFTLVAIL	LMFTVAIL
PKLED	SSE
PK	SSE
KDEYQG	VR
GKDEYQ	VR
GKDEQ	VR
DED	QGTL
RTVI	PG
YRNY	VPGQQ
RFDAQ	YLD
EGTSA	KY
ETSG	NSGR
YGQ	MSKY
ESKWV	GTT
MVQF	GN
MVQFQK	GNQRLIND
KDAE	GSMVRER
VMYQP	RDGGDQ
RDS	VDKR
QTA	KY
EGTS	KY
KY	NSDT
KY	SDTS
STDS	KY
SDTS	KY
SDT	KYI
GYV	YV
ESG	NQM
NAM	SGEES
MNQ	GES
RAQT	QKY
ARQTG	KY
DARG	PGV
RAESVE	RPGDR
ARNG	GTG
VADAE	FR
HE	MSTK
HNE	GMSK
AAASE	FR
NRE	AGDK
AERE	PGDR
SGAE	GT
DSQE	PDR
ADNE	SGDR
ESAE	PGR
SDAT	RPGR
ASQE	RPGR
NGAK	PPGT
EARSE	RPGR
SADQE	RPDR
ADLRNE	RSGDR
NGA	PGT
GS	PGT
AESE	PGDR
NADNE	SGDR
AESEM	PGR
AQDAL	RPGD
NADNE	SGDRK
NSTGAERSE	RPIDR
DSADA	RI
SGAA	PGT
ADSEM	RPGR
DNREM	RSR
NSTGAERES	RPRID
DAS	PGR
DNAE	RSGR
NSTAERSE	RPIDR
DAGATL	PGRIR
NSEQM	RPGDR
NDANRE	LRSDR
ASGAE	GTK
INSEQM	RPGDR
ADNE	LRSGR
RTSGLES	YVKR
GAD	GV
SGAEKGTE	RPGLDR
SGAD	PGCG
DQE	RPGDR
NADNLE	RSGDR
ET	RIDR
SGAK	PGT
DRNE	RSDR
TGA	GTT
TAESTE	RIDRK
DSL	PGTK
ADNRE	RSDR
GAS	PGT
SGA	PT
ASGA	GT
NGAN	GTTLR
TGAER	GTGKT
GFNADN	TGKLLRA
AETMFIRR	RRIDRK
DGS	PTKT
SGAEK	TL
NGA	PGTL
NREM	RSDR
NGA	GTG
DLSGA	PTGKL
NRE	LRSDR
FNGA	GL
GAVK	PGT
SGANQ	PGCTK
ADNRE	LRSDR
AAVE	PGR
AET	RRIDR
FGNADN	GTGKLLRA
SGAD	GT
AENQ	PGDK
AENNQ	PGD
SASE	FR
GAD	GT
RNTE	SGR
NGAQ	PGT
ARS	PGD
NGA	PG
DAQE	PGR
NQGA	PPGT
ARE	PGDR
ADAE	PGR
KAEGE	DR
ADSQE	PGDR
NDANEM	RSGRDRK
NGAQ	PG
ASGV	PG
GAKEGEY	PGLDRK
ADSNQE	RPGLDR
NDANE	RSGDRK
AESRTEM	PGDRK
SGAA	PG
ANE	SGRDR
AESME	PGDR
SADAKE	RPGR
ASG	GT
ADNSQE	RPGDR
TGAD	GV
SDAAE	RPGR
SADAKTE	RPGDRI
ADAE	PGDR
ADKAE	PGDR
SADAK	RPG
ADKATE	PGDR
SADAE	RPGDR
ADAKE	PGDR
SDAAKTE	RPGDR
ADKAE	PDR
SADKA	RPG
SADAE	RPGR
ADKAE	PGFDR
RLR	SQSGA
RLR	SQSG
SGAE	GC
FSGA	GCGL
SGA	GC
FSGENAE	GCGLR
AERSE	PGDR
AERSTE	RPGDR
AGTE	PGDR
ANRTE	LRSDR
AESEM	PGDR
GAS	GT
SDAQTE	RPDR
SGAD	GTG
SDAGKTE	RPGDR
SKD	DDVPT
SD	DVPT
SKD	DVPT
DVR	VPT
DTIAL	PGVG
TPKHTS	NEVPETLK
RLPD	EPGVG
VNY	MAGESR
KTRK	YTVSEQ
ENK	TQD
TRP	RRR
TRP	SRRR
MRC	LDGMK
HLN	SLH
FV	TFLF
NDQIKE	QKNNYSDE
LGEEN	MRKE
MVRW	EGYS
DGGHD	PP
GSP	SRLVGSP
VGS	TGSP
QEDVSG	TMADTLVDNK
FSD	TVDF
GRA	SG
DMG	LSG
DMGAR	SGS
IRRTHER	PEQGPR
VYGAR	TG
YAR	TG
EYG	PTGV
EYGRA	PTGV
IRRHTRE	PEQGPIR
EIRRHTR	DPEQGLPR
IRRHTRE	PEQGPR
IRRTHRE	PEQGLPR
RRQR	LNLDE
IRRTRE	PEQPR
EIRRTRE	DPEQGPR
KTGAR	TG
REM	QI
KDTDR	KGA
KDTDR	KG
EDDTR	KKEYS
QR	EEPG
RQ	EEPG
RQ	EPGD
RQ	EEPGD
LQVLTAMN	TVFHLKVA
LLTAMN	FHLKVA
HV	IRGYGY
RIK	PVIQE
QQIRS	PMEFTDF
HIE	VEIG
N	DDSGK
QENEH	EQNH
MKN	KMN
YLSNRE	RTEGMIKV
KEE	DMK
STQ	NEER
TQS	NEER
TRSQ	EER
IKQV	RL
KTQA	QEMK
KVPD	VKL
KQESAE	DMK
KEQA	DMK
DGSP	PN
LEGI	RAR
VLNE	IRRK
HN	ERRM
KDNE	LR
RDANNA	EFEN
AAFE	AARDT
LK	LTLL
AL	TLL
AGL	TLL
KAL	KTQ
QERILSNH	AVHAQEFENAAN
KAL	KNT
HDGDR	DRHDG
VGC	CVG
EDYPKTSK	KD
CGN	NCG
VGA	AVG
RPIYD	RKREG
REK	PRIY
NGV	PSYSW
PSYSW	NGV
GVC	CVG
HQ	NKAGI
GVQAA	QAGV
RMEK	ANPV
RME	AAPV
DGT	KAG
RME	ANPV
FYN	VGD
FYN	VGDR
FYN	VGFDR
LLKK	YE
EGYKTTETKGNGP	KEGYTTPETGNKG
HRE	HRE
HF	HFL
GRSGLTV	VTLSGGR
LLTN	AGSTK
LTLN	AGSTK
LLNT	AGST
LLNT	AGSTK
LLTN	GSTK
PNELVD	QKKK
DKGN	NDG
TETVAGPTQ	QTGAPTETV
DHH	EA
QDEDR	RRHRER
ARPQ	TGRKA
HNTDQ	HNTDQ
RDRVRLG	TPFGQTS
RDRVRLG	TGQTS
RDRVRLG	TFGQTS
NEKCPAYD	NEKCPADM
ANEKCPYDM	YNEKCPAD
DLGFFDRD	DLGFDDRF
PGAS	LLGT
LLAS	LSLA
AESVA	ESAVA
DGNR	GNDR
TMAR	TRMA
YQS	SYQ
RSAK	EASS
TGDKEYG	PPSQL
ETRNG	HET
AAARK	AYAGP
LKLV	LEVL
GRSLFQNE	EQNFLSRG
KTR	ADD
ADDQ	TRK
AES	RR
KAFTED	EAFKT
KAEVEG	GKSEEAD
GFRPPLV	LVPRPGF
HYD	EYLNDHPA
DE	AGS
KIRKAR	DEMERN
GCRIA	IARGC
KIARKR	DEMERN
HKYQER	KHYQRE
APFLYQ	YPFLAQ
NIK	YRLH
IKN	YRDH
EHQLVR	HRQLV
HQLVR	EHRQLV
HENQLVR	EHRQLV
HENQLVR	ENHRQL
KGKHE	EHAG
QISNS	NSISQ
GFESL	RRG
RELG	DPW
WDLP	ERLG
REG	DLW
WDL	ERG
TEPYESGN	EGNN
GNE	PYETSE
YETEPS	EGN
QTREV	RETV
RRD	RQG
RKNK	DPDD
QKHIKQ	LSE
IEEGD	LE
LES	QHQIK
LVSNRL	LNVRSL
QYD	PSRGR
KITELP	KDLYQ
RRGFER	AEAQR
RRGFE	AEAQR
AEA	RRG
AS	QAA
NQVEV	AVEQVN
HEE	VNP
EEH	VEPH
EVK	RNRDT
DLTR	RRDLT
RGLFT	NNQ
LKD	LK
QEEF	IAEKNH
VVGRRESTI	TIRESRVVG
EAQISE	RQNI
ASEIE	HRQNI
AEESI	HRQNI
NPARE	PHAAED
WMW	RWYD
WWSWKFY	AEWERWYHWQ
WEYWQY	WKFWWKF
WKFWWKFYS	AQWEWYHWQ
WFHWVWKFSY	AQWEWYHWQY
VHNQD	DEERK
WWSWKF	AEWERWYHW
WYWQY	WFWWQ
WKFWWKF	AQWEWYHW
WFHWSVWKFYS	AQWEWYHWQY
QWVQHIAP	QAPIHWVQ
QWVQHVAP	QAPVHWVQ
RVRPND	RNR
WRLT	DGQT
AKS	ASK
DDLGK	FTHQR
DDLGK	THR
DDLGK	THQR
DDLGK	FTHR
LEPESGEN	KQK
EQ	THQ
VMQG	GYA
HHSSIEE	EESSIHH
HGSHSIEE	EESGSIHH
PKA	TERG
NPLR	RKE
NPR	RKE
LNPR	RKEG
PLR	RKE
LNPK	RKEG
LNPR	RKE
NPLR	RKEG
EAQTEQ	QWTQEEA
ADPR	PKAE
PRAV	IR
YETDVDPE	GDLKKIRISAPQR
ETYDV	IRISAP
TKR	LIGE
TKR	DLGE
PTNL	DEAG
RVA	YNR
TSNT	QQ
NDTSTKAD	QGVMVGMGQKD
DSNTKAEDTYE	QGVMVGMGQKD
DSNTKAEDTY	QGVMVGMGQKD
GAKT	LEMRPF
TFPKK	WELR
TFPKLK	WELR
LQG	LMAGD
TGRIE	SVAPTER
TGREI	SVAPER
ILRPDI	ILRPD
QHAIK	HQAIE
QHAI	HQAI
QGL	GQL
QHAIF	HQAIF
QFLM	FQLM
QTLY	TQLY
EWL	EWL
QFAV	FQAV
AGT	AGT
AGT	AGRT
AGRT	AGT
QFGLW	FQGLW
QFLT	FQLT
QNGIF	NQGIF
QNYLF	NQYLF
QHGIF	HQGIF
QHGF	HQGIF
QHSD	HQSVD
QHSVD	HQSVD
QHSD	HQSD
EFGVF	FEGVF
QKLA	KQLA
QLNQK	QLNQK
QLNQK	FQLNQK
QFLQK	FQLQK
QFGLH	FQGLH
LQVIF	QVIF
QVIF	QVIF
QLVIF	LQVIF
QNL	NQL
QANL	ANQL
QRNL	RANQL
QRNLI	RANQL
QNL	ANQL
QNL	RNQLI
QRNLI	NQLI
QRA	RQA
QRAD	RQAFD
QFMQD	FQMQD
QNGVF	NQGVF
QRIIH	RQIIH
QFLV	FQLV
QLG	FQLG
QLG	QLG
MWGGMD	LYSNSY
MWGGMD	LYSNSAY
ALQNR	YNRMA
WGLGMD	YTAGSY
RYTS	YRTS
YPA	PYA
ETPD	TPED
PRP	TPGQ
GQTP	RPP
LSGWD	YAASRQ
LSGWD	YAASRQD
IAGA	FTHPD
PG	RAQ
RWDAQD	QLTQYW
LTQW	WDAQD
DEA	EMR
EEE	WRK
RWQR	DEE
EMSCD	QCLDGNC
ESCD	CLDGNC
EMSCD	CLDGNC
EKCD	CKNGK
EKCD	CKNG
EKCD	QCKNGK
ESCDM	QCLDGNC
EMSCD	CLDNGNC
KNRD	SQLKG
DNKFA	NKR
KN	GYDVSGI
SCEI	RWVNEA
TAEFLSKLKD	INCWPSESDVNIE
QIRTF	FTE
HGFIAT	IAHGFT
YADLN	DLAYKAN
YKDL	DLYAN
EETLG	KVK
KTH	GADGF
RSQTD	DRS
RSE	ERS
QEDTGEG	HDVTDR
ESGQ	HDVTTD
LAPR	RNPT
LLTP	YD
RST	RST
AYTD	WAGVR
RQNVTRMPLTVY	SIVSSYL
SRDLLLLL	RDLLL
KLLLLL	DLLLTL
HGPD	PDH
HRDY	IDDTR
HYERKN	ELDSNL
HRDY	SDDTR
HYRKNE	ELDSNL
HRYEKN	ELDSNL
HYEREN	ELDSNL
HRYEEN	ELDSNL
HRYKNE	ELDSNL
HRDY	ISDDTR
HRYNEK	ELDSNL
LTYL	YLTL
YKLKLQYETNY	LNYTYLEQKKLY
GGVNN	QLSTA
GGVNPN	QLSTA
LKAAAGGVKAYVM	REVASRVDFFTM
LKAAAGGVKAYVM	REVASRVDFFTMVRG
ETFFNQ	QFTFE
IFIILLM	NLICLIILL
QLIFLLLIML	NLIICLIILL
QIIFLLILLM	NNLIICLIILL
QILFCILLLICML	NLINLIICLIIILL
NNLLIICILIIILL	LQFICLILLCIML
NLQQANQNILICLIIILL	IEMQRQLQFILILLCIML
ARLPQQQQIFLILICM	MQQNQNINLICLIIIL
QQMNNQNILICLIIIL	PQQARQLQFILILCIM
ARLPQQQQIFLILLICM	MQQNQNINLICLIIIL
ARLPQQQQIFLILLICM	MQQNQNINLICLIIL
ARLPQQQQIFLILICM	MQQNQNINLICLIIL
RVGG	GGR
VAGVG	AGVVG
QNKGE	VCNTK
NV	GTNE
RGSG	SGR
ELKSY	YSLKE
ELLD	RNICK
GKSIQE	NKY
KYN	IIQETGK
GR	SGG
NTAAPST	STAPATN
EPKERFK	KDTEDKE
QWDK	LTKAQK
PLESEDE	QPELESD
QHAVS	KQ
QDWKPEE	LKAQH
QQFCVG	KVRE
QQFCVG	TKVRE
QQFC	KVRE
AQQFCVG	TKVREY
IGAQLKGAHY	YHAGKQLGAI
EIVQGIHGTC	TGCHEIVQGI
NLET	HSLLWGPE
NLTE	HSLLWGPE
NLTE	HSLLWGP
NLET	HSLLWGP
NLT	HSLLPE
NTE	HSLLWGP
NLT	HSLLGP
NSLE	HSLWPE
NLTE	HSLWP
NTE	HSLWP
NSTE	HSLWPE
NLTE	HSLLWP
NET	HSLLWGP
NLSE	HSLWPE
SGSL	HSVI
LGS	LEG
LG	LEG
SLGS	HSVI
SGSLL	HSVI
SGSL	QSVV
SGS	QSVV
LLGSS	FHSVDV
SSLGL	HSVI
GSSLL	SVI
SSLGL	SVI
SGS	QSV
LGSS	LEGN
SSYNL	NII
ME	SQRF
MEV	SQI
IRIA	VNSFGIA
IRIA	VNSGIA
IRIA	VNSGI
RIA	NSGI
IRPI	VNWSFGV
RIA	NSGIA
VRIA	VNSGVA
IRPI	VNGAFS
IRPI	VNGAFSN
PRIA	NSGIA
IRIA	VSGI
IRIAP	VSGIAS
IRIA	VNSGVA
TEGR	WEA
TEGRS	WEAA
EGMRSTDD	HFWEAASE
IPRK	TLE
LET	PRIK
IPRK	TLED
RLR	LLRGN
LR	RGN
LRG	RGN
RNG	LRG
GYPG	DTRG
TRGD	PGY
TRGD	PGGY
GP	DTRG
YTN	YTN
NDNSTAST	KQVADN
EYYK	KYYE
TASD	QAGY
GAY	DAST
ASTD	AGY
AGY	DAST
AST	AGY
DAST	AGY
GAQY	DAST
SEYYK	KYYSE
AGY	AST
DAST	AG
TAS	QAGY
NSTNSSA	VSNA
SRGD	PGY
GYP	DSRG
VSNA	NTSNSS
NSNTSS	VSDNA
VSNA	NTSNSSA
NSTNSS	VSNA
VSNDA	NTSNSSA
SRGD	PGGY
NDNSTAST	KQVADNA
DVQ	PGY
PGY	DVQ
VQGD	PGY
GYP	DVQ
VQD	PGY
ARGD	PGY
GYP	DARG
AGD	PGY
GYP	DTRG
TGD	PGY
NTANAST	VSN
ASNY	NTSNAST
NTANAST	ASN
TRGD	PG
NNATAST	ASDYN
TRDG	PGY
ASN	NTANAST
ASND	NTANAST
NSTNAST	VSN
TPIG	KAEK
GYP	DTG
EKAK	ITPG
PGY	DTRG
DNSNTAS	QNTDYNA
DNSNTASA	QNTDNA
DNSNTAST	QVADNA
GYP	DTR
VSN	NTSNAST
VSNDA	NTSNAST
NSTNAST	VSNA
VSNA	NTSNAST
NTSNAST	VSN
NSTNAST	TSNA
SNA	NTSNAST
TSNA	NTSNAST
TPGIP	KEK
KEK	PGITP
NSTNAS	TSNA
VQGD	RPGY
GYP	DVQG
ARGD	PGG
DSN	NTGNASS
GYPG	DARG
DSNA	NTGNASS
GP	DARG
ARGD	PG
NTGNASS	DSN
AGQKA	NQK
HDYG	YHDG
HYDG	YHDG
WWM	WWM
GGN	GGN
TELLE	SV
QP	EHLGDF
PKYR	YRPK
YGCVIN	KFPIAD
YGVVGVNA	KFPVKDIML
YGVVGNVSA	KFPVKDIL
YGIVNA	KFPKD
YGVVGVNA	KFPVKDIL
DTPNLLTILA	NPTDTILLAL
FKGFFGF	RAEFF
FFF	EFFF
LDKCYQLR	LRYQKCLDA
TDLKVLLEEK	LQMRIRQY
NLRLED	DELRLN
NSLVLASLNRELR	SNLVALSLENLRS
YLAMR	RMYR
RYLD	DSSR
RGALE	QLRK
EGALISPRG	QLREPRE
ALISEGPRG	QLREPRE
QRAG	EVGGL
DGLS	RES
ESRR	GLRSD
GAAY	YAAAG
DGLRS	RES
ESR	GLRSD
AGAAY	YAAAG
RGGD	HRE
SETCQL	LETSCQ
IN	SRG
QGT	TT
TG	AKV
LIKEIRELLRKEILKLK	ILKERILERLKEILKKL
IKKLREEKE	LERELKREKEK
LIKEIRELLRKEILKLEKLQ	ILKERILERLKEEILKKLLQ
IKKLREER	LERELKREK
KILMILLKILLK	LKILLEILLQ
PDGKDFGSE	EGFDPDGK
PDGKDFGE	EGSFDPDGK
NLREH	HELNR
KPRN	NRPK
YTLNRN	RYLATNE
YLNRN	RYLATNE
SIGARS	KISGSA
IGK	KIG
MLGC	MGE
PKR	KENR
RREK	RVTE
KDD	DKR
RGELV	YQ
HQK	HHD
DLLG	AI
KR	SEE
PKDLG	EKV
TYQN	EIH
SRRIG	QIQ
DENK	KQ
NVHRW	VWHR
VNHRW	NVWHR
VGEAN	KK
EDDPV	KIGK
QAED	RV
PYT	PYT
NEERT	ENER
YPSEQ	QEESPY
QTK	NDTK
QY	THQH
NEER	ENER
NQ	GDN
DSS	KSGH
RV	QAED
KG	YAFD
KGEN	GKGK
QG	FTK
QALKAD	LDFRVRF
QLKAD	FLDFRVRFK
RRQEKMRD	NLGCNDSVRE
DNGSQ	KD
RHIL	LHRI
RPDGP	RPD
YSQK	EDVE
QTID	DG
RD	PPGL
QN	MKHK
RQNCER	RECNRQ
YVS	LGRC
RMQM	MRIE
DNQ	KVKV
DGT	REYER
MIRN	ERMQM
MIR	EMQM
ERMQMK	MRIN
MIRN	ERMQKM
MIRN	EMQME
ERMQM	MRIN
MIRN	EMQKM
MIN	ERMQM
ERMQME	MRIEN
MIRN	ERMQME
MIE	ERMM
RYIQDK	DGIPEIKE
DRFY	PGLHQ
KGERQIMR	DGESIE
TGGK	KGTG
RQNECR	RECNRQ
SDYG	GS
SDG	GSDY
KPI	IKP
FRRF	PEN
SERDL	RHAR
NQI	DGQFT
DERIHIH	HERDHI
DERH	HERID
ETSGV	ENR
KR	DAQE
IPTLFV	PITLVF
FGGIR	GGVIE
YRE	LTVA
VNRL	KYLGD
KYDLG	VNRL
KKSEL	TELKY
YKSLKTE	TELKKSQK
KSYQLKET	DTELKSYK
AIFVVHL	IILIPLY
ITVVFEAYTLR	LIMIDVYT
ITVEAYTLR	LIIDVYT
ITVVYEATLR	LIMCIDVYAAQ
LIIVL	IFFPLVG
LVIIVL	IFFPLV
LIFVWFHIGL	IVIPLFGIM
IIGHKR	LLIQ
IILGHK	VFIGCD
IAIIHIR	LAQFATN
ILIGHAK	VFIGCD
IIIGGG	IYVE
IVH	LQF
IGVH	FLQ
PFMT	RWHMP
GQGKE	KEGGQ
NAYD	YDAN
LDEE	ELNSPR
NPRELS	DEEL
NPLS	DEEL
NSPEL	DNEEL
HNGS	VRQ
KDNY	GDST
RDGAY	RRN
IELEEILSLILNL	IRLSIKLMILLTLN
IRLILIKMLLL	IELEIELILLL
ILEEILLILRNL	IRLIKLMILLTL
IELEEILSLILRL	IRLSIKLMILLL
NLRL	MLT
TLM	SMGLRT
IRLIKLIMLLLT	IELEIELILLN
ILEEEILLILIA	IRLILMILLL
IELEEILSLILR	IRLIKLMILLL
IRLIKLIMLLL	IELEIELILLRL
EASE	SSLRK
EILEAEILLILR	SIRLIKLMILLL
TMGL	GRT
ILEEEILSILL	IRLIKLILL
ILEEEILSLILR	IRLIKLMILLL
IRLILIKMLLL	IELIELILLLN
ILEEILLILN	IRLIKLILLT
IELEEILSLILRN	IRLIKLMILLL
ILEEEILSLILRL	IRLIKLMILLL
IRLIKLILLN	IELEIELSILLL
LEEEILILLL	IRLILILLL
ILILL	ILILL
IELEEILSLILR	IRLIKLMIL
RILIKLILLLT	ELEIELSILLRLN
IELEILSLILRL	IRLSIKLMILLLN
EIELILLIL	SIRLILMI
ADILLF	HFLAS
NILLT	YHFL
NEGK	KE
DEGKN	KE
PVLRTGDVLGMIR	AAGGTATHHASAAPAR
PVLRTGVDLGIRM	AAGGTATHHASAAPAR
VRHE	TMDS
KTMD	VHRE
RQRV	RRFQGEDM
RRV	RRFQGEDM
RRV	RRQEDM
RR	RRFKGEA
RRV	RRKGEAM
RRKGE	R
RRV	RRFKGEAM
RR	RRAED
RRFAGE	R
RR	RRFAED
NIAGS	KE
ENIAG	KE
KEL	NIAS
RRQV	RRFQGEDM
RRV	RRQGEDM
FDAS	GSAK
RR	RRFAGED
AMSE	GRVR
LNDH	KVN
RQRV	RRQEDM
FGH	FPGN
KD	DAKK
PHGF	FGHPF
RRVQ	RRFQGSEDM
KNV	LNHD
KV	LNHD
KNV	NHD
LNHD	KVN
RRV	RHKEAM
RRVH	RHFKGSEAM
RRV	RHFKGEAM
RRV	RHFKGSEAM
RVHR	RHFKGSEAM
RRVH	RHFKGEAM
RVR	RHFKGSEAM
KALMDP	VKLASW
RR	RRFKGSEA
RRKV	RRKGSEEM
RRV	RRFKGSEAM
RKR	RRFKGEA
RKRV	RRFKGEAM
RVRKR	RRFKGSEAM
RRKV	RRFKGEAM
RKRV	RRFKEEAM
RRVR	RRFKEAM
RKVRR	RRFKGEEAM
RRVRK	RRFKGEAM
RRVRK	RRKGEAM
RRVRK	RRFKGSEAM
RVRKR	RRFKGEAM
RRV	VRRFKGEAM
RRV	RRFKGEEAM
ISSPR	PRN
RKRV	RRFKGEEAM
RRV	RRFKEAM
KGR	ENDNA
ENLDN	KGR
TH	TDF
THR	TDF
DTFG	PH
RAE	AER
RR	RRFQED
RR	RRQED
KE	YDTFTG
DERRQ	RVRQ
YPPERMS	NKAR
RANK	PERMPSY
YPVPERMS	NKAR
RANK	PERMPVSY
HN	EEIP
RQRV	VRRQGEDM
RRV	RRFQEDM
RQRV	RRFQEDM
RKR	RHKGES
RRV	RHFKGESM
RRV	RHKGESM
IYLTLFLER	YILTFLELR
IYLTLFLE	YILTFLEL
IYLTLFLR	YILTFLER
AKDNV	NVDKA
PQVVPDNNHD	VPQVPDNNDH
PQVVPDENNHD	VPQVPDNNDH
NEGRYQTTE	SNQTRYKLPY
STTRYGEK	NEKL
TPNG	QLTS
STTRYGEK	NEKLP
RTSR	LEEY
KSNK	SEEY
RILL	SLYL
TEDGY	FQH
VRTGLEEVGVMGH	HMGGVEVLEVRTG
VRTGELEVGVMGH	HMGGVEVLEVRTG
VRTGLEEVGVMGSH	HMGGVEVLEVRTGQ
VRTGLEEVGVMGH	HMGGVEVLEVRGQ
NSSDQ	TGP
FEMI	FEMI
VPEN	NVP
DKPN	ED
DE	SSAQ
TSIR	KLASEY
VPQN	NVP
FYSDE	LERY
ERYL	SDFY
ERYL	SDFEY
ERYL	SLDFY
VLS	LVS
NVE	NVP
EKIAEQV	VAEQIEKR
EKIAEQV	VAEQIEK
EKIQAEV	VAEQIEK
YSGP	SGPY
WNEW	ADRGT
GTRDA	WENW
PTTNILI	LYY
TTNIPLI	LYY
IH	CSSD
YTSQV	YTSV
APEMG	LLR
RMKKVRGP	NGRGDD
NSG	SNG
NGS	SNG
NSKD	NSKD
REQAA	ETERT
LSK	ILS
YWNTY	QTYYN
QKYDTND	WDNDQTYK
YTY	WDQK
KQYDTD	DNQYDK
TAF	TAF
DVASI	RQKKK
KEEFGIE	GIEIPDEQ
LAFRRQ	SLTVVMEIPDAE
QQSMVVRQ	VLTSMVMEIITPFQ
PGSVR	ESLPANT
PGSVQ	SLPANT
PGSVQ	ESLPAN
PGSVR	ENLPPNM
PRSVG	ENLPPNM
SNYS	RAELQ
NVK	NV
TQE	TQE
LYEKLE	YLLEEK
DEFFSLKA	FNVVALDMC
PDEFSLA	FNVVALDMC
PDEFLSA	FNVVALDMC
RKPE	REY
QLPSR	DNGAQG
NCKY	NCKY
NCYK	TLNTVA
IAIFL	FFV
FIILA	SILY
LLII	NLIIA
FLL	FFAPI
PAWSYS	FQTG
RNK	EEGKE
RE	TSDY
IAIKN	AIIKN
INAEGEKDL	DLKGEAEIN
KGDEYE	EYEGKD
LADK	ALKD
EEAKA	KAEAE
LKV	KLV
HGDL	KL
KDL	HGD
RAI	AAG
RAI	LAAG
DGGV	HE
RPLVIVKTV	TDLWVDRSEFY
PLRVIVKTKAV	DLWVDRSFYE
RPLVIVKTKAV	TDLWVDRSFYE
KFI	TPFL
DTGI	DVL
EADVDT	TADDVE
ESDVLG	RGVSLD
RESLDVG	EKNGVSL
KSEWRPE	DRRDT
KSERPE	DRRDT
QQRE	NE
QQRER	NE
DGLPH	PHGLD
DGLPH	HGLD
RLSY	EGKA
KEA	KEPT
NGVN	NGVN
YRISS	RIYSST
YRISST	RIYSST
DGMPN	NGMD
DGMNK	NGMD
YRISST	RIYSS
DGLPG	PGGLD
DGLPGK	PGGLD
WWDRFRE	WDRFER
NGVPN	PNGVN
DGLPG	GGLKD
DGIPH	PHGID
EGRV	RISY
YHRI	HRIY
NGVPN	NGVN
FVVVMGD	EDMGVVFV
FVVVMGED	EDMGVVFV
RES	IGES
RES	RIGES
RNG	RIEES
RRSA	SSF
GAERL	ERN
RN	RIGDS
GVVV	VVV
PQGHPQH	HWGQPHWGQ
PWHPWHPWHHPW	GQGQGQGGQ
MGPHHF	GMPHHF
GPTMT	TGPTM
TGPTM	TGPTM
TGPT	TGPTM
MGPHHF	SGMPHHF
MSGPHHF	GMPHHF
FLYILNELKQLTNLELKLQATQRQR	FLYILENLKQLTNELLKLTQRQE
HGTNS	DMT
NERAA	NEE
QEQEK	KQEE
EQEK	QTEKE
QEQEK	KQTEE
NTDE	DHIQ
THT	HTT
KRW	NQFDAQ
YDERG	NR
IWKQ	DF
IL	PYMD
EHNTN	NE
KRSD	REY
VFSEF	EFFSV
RNEGYH	NE
NEGY	NK
KN	NKEN
NE	DQR
FFEWKQRILKVILWIER	FWFEQRILKIEVLWIDE
FFEWQRILKVILWIE	FWFQREIELIVLI
FFEWQRILKVILWIE	FWFQEKRILKIEVLWIE
RED	REED
VFFEWQREILKVILWI	VFWFQEKRIELIVLWI
FFEWKQREILKVILWI	FWFREQIKELIVLWID
VFFEWKQRILKVILWI	VFWFREQILKIEVLWDI
HKEDENH	EAEKWPN
HKEDEN	EAEKWPN
KDERE	EKGDT
KDERE	EKGTD
KLS	KLS
NRQA	TENS
KYND	DKYN
KVF	KPLA
KNLAAGW	GSNG
LDRL	TVDQ
LGLG	FVNR
LRL	TVNQ
LNQL	VINPK
LNQL	INPVK
NET	KTCQK
KSKG	ETNL
WDGL	EFKWDG
WDGL	FKWDG
QEK	MKQN
LDKNGG	LDKNGG
K	FKKLA
QEK	KQN
KREVIVK	KVREIVD
DKPP	PR
DKPG	PR
DPP	PRF
DKPP	PPR
NRQ	RDEDR
TNEELR	RRLENE
LIERRVMAQ	VAQELRMI
LALETLEIDNFQLRNLHVLRL	LQLVRLSMRINFALRENELVQLML
LQLVRLSMIRNFALNLEVLQML	LALETLEMINFQLARNLHVLMRL
LALETLEIDNFLRNLHVLRML	LQLVRLSMERINFALNELVQLMEL
HHEFH	HHFHE
KRLGK	RGKKL
KRLGK	GKKRL
AKKGE	GEKAK
RTG	PVGG
FIKEY	CSYC
QNKTPED	KKEQ
AFKFV	KDQ
YSG	AG
YEE	VKREAAE
DGVPRN	RNPVDG
VQANQ	LR
ES	HTGT
EWLAHGH	WAGHH
AAAAR	RAAAA
QEGT	TGR
DRK	GIS
QEGT	TRG
EHQK	QEHE
EMD	GN
VRRI	GVM
VRI	GVM
VRRI	GMV
VRRI	GV
VRIE	GYA
VRIE	GAY
YLEN	WDE
LLEKN	LLPYAV
VYAPLL	NKELL
LLEKN	LLAPYV
LLEKNAD	LLPYAQV
LLEKNAD	LLAPQYV
PRA	NQSPA
FD	SIGN
EGNR	TLDP
ELRS	WRNVP
QDV	VRYY
NQQ	GRGR
NLE	ERT
RER	PDPRY
REER	PDPRY
LEGSEIRR	NLGYECY
KSKR	LHDLD
DHN	RSED
QRDNFRL	ESDSQR
VEH	RGII
KNKV	NKKV
DFYSYQ	SSADDDR
DYRSYY	SRFDEAR
DYRSYY	SRFEDAR
DYRSYY	SRFDEDR
RTYY	LAFDLARV
DYRSYY	SRFDER
SYRSFL	SGYDERY
SYRSFL	SGYDEARY
RQLNYI	IRDEG
DAFN	LAS
LV	LAKF
PPDR	QGRY
PPTDR	QQGRY
GGTS	YHK
RGLTLEQA	FWQALQ
LEQ	QLA
NLDD	KSSNK
R	FLENDD
R	FLEND
R	VETND
R	FFNND
R	FNNTD
ERGG	QRVD
DNDAN	RT
TR	NDNDA
NDA	SGSKS
DKKGY	QQDR
QD	KKLGY
EQAELK	KLQAGE
EQAELK	KELQAE
HQRRPQ	KNEN
KYND	DYK
KGNQMEKRW	DKYESKEE
GNQMEKRW	KDYESKEE
KNQMEKRW	KDYKESLEE
LVL	LAV
LAV	LVL
ISDL	KFK
TEKLRYLTVELVTRL	ETLLRKYTVLEVTLR
YVS	IQRQNRE
YVS	IQRQNR
NPVITNGQV	EPNVIVQNGT
HYSNA	WEG
NKRQ	NSSR
VYPD	TKT
QA	LKNKA
LKNKA	QA
QPLQAVAR	RALQVPQ
TRDQVPL	RPTAL
RDQVPL	RPTAL
GRL	RAE
GSR	AIGFD
LYQASL	LLRAY
NGG	GNG
EPNYR	QRR
EAQ	SFSN
FKSAQEKADQL	AQLKDAESQFK
FKSAQEKADQL	ADQLKAESQFK
FKSAQEKADQL	AAQLKDAQESFK
FKSAQEKAADQL	AQLKDAQESFK
FVKSLAQEKADQL	ADQLKAESQFVKL
RHFK	DQT
DEFYG	EDEGKFY
EYGK	KKY
TESGV	QQV
TESGV	QKQV
LTNSGV	QAV
TNSGV	QAV
TNSGV	Q
LTHSGV	QAV
LTHSGV	QDAV
LRRLNLKKY	WESLLVK
HDS	HDS
KK	WRTE
PFVL	PVFL
AYVTS	KHIEQGEK
EAATQ	EAATQ
EKGG	GKGE
EWNSNED	RYWR
CEK	PKKL
FERN	NREF
LISE	TSEGGK
WDDN	FTQRTK
NDDN	RQT
NDDNQ	RQT
NDDSN	RQ
WDNDDN	RQTL
YKEVILQK	LQVIKED
YKEVILQSK	LQVIKED
EPVIHSD	HDHSIVP
TY	TYG
QK	GRA
TSMM	SVNF
LSQT	LQRS
RIE	EIR
ARAS	SRA
PLQKVVG	QKVVGD
RRRE	EEY
DAR	KAG
TRYVQLLKNFVEFFVSFQNIQQILQEQQTLIALIRLL	HTKTYVLLKTTFVFFQVFQNIDQGIQLQQGLLILILNDEL
GTYVTHLLFVTKTFKFQVMFQNIDQGILQQQGLILLINLDLE	YVRGTQLLFVNKEFFVVSFQNIQQILEEQQTLIALIRLL
TRYVQLLKNFVEFFVSFQNIQQILEQQTLIALIRLL	HTKGTYVLLKTTFVFKFQVFSQNIQGIQLQQGLLILILNDEL
QL	VAPF
PSA	EAS
SNQQN	QNQNS
LRTVHTDE	HTDVTRLDK
DKLRTVHTDE	DTHEVTRL
MDIELEILVVRYYLIGLSKEGE	MRILYILTVDKLYRQ
MDIELEILVVRYYLIGLSKGE	MRILRYILTVDKLYQ
SKDSV	KSDSVY
SKDSV	KSDSV
QKDS	QKDS
QSKDS	QKSDSV
SKDS	KSDSVY
SQKDS	QDS
SQSKDS	KDS
RSD	REPP
NKSD	PED
PEDT	RL
YMNAGSVTL	QIGQTNQIPLNT
KGTRV	TRKG
KGTRV	TRG
EIKVVNQ	VVNQIKPE
EIKVVQ	VVIKEP
PEIKVVNQ	VVQIKEP
DTK	TDS
NEEKLIQVLQTLLSVVKENLKENLGYILM	ELKELIVQQLLTLSVVKNKELNELGIYL
ERLQET	QNQVKSE
QTTE	QTE
QTTE	LTQTT
NATIARA	DALARTIA
ISKL	DSV
IKRGPKGVE	FKKK
GSMD	RS
IKRGPKVE	FKKK
EHQGLW	KRLEYK
PENGGLE	RGGENP
GPVEF	EFVPG
GPVEF	EFNVPG
LQQAQL	ARQLQLQQ
HTFAAAQLQ	QQLAAAFATH
QLQQARQL	LARQQLQQ
HTFAARAQLQ	QQLRAAFATH
DEAR	EDAR
HTAFAAAQLQ	QQLAAFAT
QLFQQARQL	LARQQLQQ
QLQQARQL	LARQQFQL
DED	RK
NHV	PIFGPA
KGFN	DYEN
RNVNL	VNNRL
NAKEQK	RNNKET
DIL	IDL
VENLESYQLMEV	GENQSE
DASGQE	DGYFRKG
LEAGFAT	TAGFEAL
VATIM	VATM
DVA	ADV
VATM	VATM
REGRRE	PERRGRER
QIGGK	AETNHA
YLISGK	AESENP
VLG	RRN
VARLE	EK
YS	SGL
FA	VGM
DNA	NDA
PDNA	NPDA
SAG	KVQ
SAG	KVQQ
IPWRH	SNSCE
WVKQH	IDCS
YELRLSKLYRLQTILYRLQSRLKQIIRLVEL	IKLLNLEEYLEQTLYMQLEELQDIIILEVL
ILKLNLYELLQETLYQLEELQQKDIIILVEL	ELRLSKLYRLQQTILYRLSRLQKQIIRLVL
EILRLSKLYRLQTILQYRLQSLQKQIIRLVEL	ILKLNLEEYLEQTLQMYLEELQQDKIIILEVL
SKSIGRLMLEER	ELMLEGRKISS
YILRLSKLYRLQTILYRLSRLQKQIIRLVL	DREILKLNLYEELQETLMYQLEELQDKIIILEVL
ILKLNLYELLQETLYQLEELQKDIIILVEL	EILRLSKLYRLQQTILYRLSRLQKQIIRLV
YEILRLSLYRQTILYRLSRLKQIIRLV	EIKLLNLYELEQTLMYQLEELQKDIIILEVL
YPLPAF	WY
TKT	TKV
KT	KTT
RTKT	DTRTK
EETY	NGR
QDLL	DKW
RYLI	TTREW
VR	TKDE
SGRL	NKLVC
RNHA	HANR
DRQE	QERD
TDGS	YNSS
KTLA	EV
HLTDLKYLDRRF	HLNTDLYRFRLKD
HTDRLKYLDRRFN	HLTDLYRNFRLDRK
SKL	LSK
SLTKSQLEL	LEQLSLST
SLTSQLEL	LEQLSLST
TSKLL	LTSK
YVGTV	VYVTG
PDD	RTD
EQIPG	KEFQI
QACLIGVA	VGAICLAQ
QACLIGV	VGAICLAQ
ATL	DDRQ
AK	EAE
SESNR	RSNES
YPLL	YQL
YPPLP	HYKQL
YPPLPL	HYKQL
YPLL	HYKQL
MKLD	QN
EEEDGIMHNKL	GETE
EETEIMHNKL	WGEE
FAYRN	MKGAN
FAYRA	VKGAN
PLAKKQTVL	KTVLQAKL
PL	RFHI
AGFR	FYDNQQ
LFKD	LFDD
DEAWQ	KDRD
QTN	QNT
QNAQIND	NQIDNAQ
QNAQIN	NDQINAQ
TFLR	RYYLD
NYVH	YVHN
HLIDY	KEHLID
KEHLID	HLYE
QIVVV	SATGK
DDAQ	QDD
TKGSAY	IVQV
IVVVD	VVIQDA
QIVV	KSATYGT
DDAQ	QDDA
AVEL	ELAV
ELVEVEH	KIEQ
KIEQ	ELVEVEH
AVEL	EVLA
KIEQ	ELVEVE
RERNHK	RNHEMREA
LFSQLNFQA	FQANQLSLF
FCLALTFA	FAALTFCL
FCVGALTFT	FTTALFCV
FVGELTFLQ	FLTLEGFTV
FTVGELTFLQ	FQTLEGFVT
FLALTFA	FAALTFCL
LRTISLSFE	FLSESITLR
WER	GWSD
QCVDD	TPAMLRT
KRETASLF	YRRI
KRETAESLF	YRRI
RRVL	EEV
NKLPLR	PYR
VF	VGVA
LL	VGVP
SFK	VDVA
QAVFEK	EENNK
EKEG	QQ
DEMFSN	HFFLIQQ
RARTKAQQ	YSEFI
ARTKLQ	YLIF
KITQV	QVTIK
ETQT	KED
TETQT	KKDE
TETQT	KKED
TQTQ	KKDAE
TQQ	KKDAE
DRKD	HE
EKYNID	IYNDKLE
IALEETQ	TAK
ENEA	NP
AGPIEPG	RNV
HQA	DVR
IALEET	TKAG
AL	TKA
VGGPGHK	KTKALD
TIKA	GVQ
IALE	TAK
TKA	IALEAAT
TKA	GGPQ
LAAE	TKA
TERNH	DDTT
DDT	RTN
GGYL	QVV
NWGRE	GREN
NGRE	GREN
HLVERLL	LEHVLRL
YLLGKIN	INLKALA
IDEV	KR
GIITPK	TIIGPT
GII	TII
TPGI	KPTI
ITP	IIGP
GIIT	TII
PGIIT	PTIIG
EKRGL	EKRGL
LSEQ	GAK
ERPLFADLAILQNDT	QKQMALQKL
TATLWRY	HVSDG
TATPLWRY	KHVSGDR
ND	GNPVE
ELTADG	HQMD
ELTADG	HQMED
ELG	HMF
ELTADG	HQMNED
EVSPQGE	HNVK
EVSPQGEP	HNVK
VAL	LVA
DAGAE	GVLPL
GVLPL	DAAE
LSFEAMQ	YRFM
LFEAMQ	YFIM
LFEAMQ	YRFMQ
LFEAM	YFM
LFEAMQ	YRFM
FQNL	IT
ATHGE	REASE
KGQ	GQK
EGR	PVG
PVFSLV	LAAALM
PVFLV	LAAALM
PVFSLV	LAALFM
SLTNS	SLTNS
PDLGT	LNKVDS
KRE	GTA
GTA	KRE
GTFA	KRE
HEE	HE
RERRV	EHGAG
NGN	LPS
SNSL	NDL
DAKAR	RAAAKD
DAKAAR	RAAKD
DYNGR	NE
ERALN	KDVAT
QGK	MGEVPD
GK	TPED
TLEALENLHIKDEILKENLAV	LTANLHELIKDIKLNEELAA
NSSWKVARALALENLHIKDEILKENLAVAHVMA	NSSWKAVRELAALNHELIDIKKLNEELAAVVMH
ENPSQWKVAERALEALENLHEIKDILRENLVAHV	SKNWAVRELAANLHELIEKDIELRNELAVAV
QWKVAERALALENLHIKDEILRENLVAHV	NPSWKAVRELAALNHELIDIKRELNLAVAV
DKDE	KDSKE
EEVR	RPGYQK
LGVANY	ANIA
LGVANY	APNIA
LGVIANY	APNIA
LDEI	KRY
QEL	KSQG
EGVNDL	RVAVRGE
RVVRGAE	EGVND
RVVRGAE	EGVNDL
NKLS	SLKN
NKLSG	SLKGN
NVLT	TNVLG
NVLT	TNVL
VLT	TNVLG
QQEK	EQQF
NKQ	QVNK
NTVS	VSTN
NTVSG	STN
IRLDD	LRDDI
PPEG	HD
TVGVDPAEF	KSWWRGK
TVGVDPEAEF	WKSWRGK
TVGVDPAEF	WKSWRGK
RH	TATIE
HDK	GGGE
TGV	EGDT
NDSDK	NDSS
AAK	ADGC
AAK	ADG
DDSN	DG
TNHNKDT	KNDTNHVT
AKV	VAKK
ENYNSN	NSNNYE
ED	KRD
EDG	DGE
VVQL	EKGGP
WSEK	ITKT
IHHT	IHHT
MHHNA	AHNMH
IAL	IAL
VYYN	VYYN
TKYIR	HYD
SGSGPS	GLSG
SGSGPT	GLSG
SGSGPT	GLGS
SGGGF	GLGSA
KLKG	PDLN
SGGF	GLGSA
SGGGF	GLGS
KLKG	PDLNL
TGGC	GLSC
PGAGY	GLGSI
TGGCM	GLGS
TGAGCM	SGL
TGGCM	GLS
TGAGC	SGL
TGGAC	GGL
TGGACV	GGL
SGGSA	GLAG
RGGS	SR
SGAGPTL	GLRA
SGAGPT	GLRA
GPT	GGAM
SGSGPT	GMAG
NLDK	LDKN
NWS	GQEG
GPVEYLKALSEKVLMVNLSELLQEILQENL	ETLYLKLASEVKLMNVLSLELQIELQNREL
KCHS	SKR
IVTEILNLKK	NAEILMNE
WDIK	PGAYD
PGYD	WDIYK
WDIK	PGYD
PGYD	WDIK
WDYIK	PGYD
WEI	GPYSL
PGAYSL	EIW
WEI	GPAYSL
WDYIK	PGAYD
HEWQ	TTK
TTK	HEWQ
TTKH	HEWQ
GFPG	FPGG
GFPG	FPGGG
VAAAKYLEETEGKFLEY	YFLEEGKETKELVAAAYE
SGFPG	PSFGPG
PSNGFPG	SPFGPG
SGFPG	SFGPG
PSGFPG	SPFGPG
PKGYPA	KGPYPA
PKGYPA	KPYGPA
PKGYPA	KPYPGA
KRQP	RQP
KGYPA	PKYGPA
PKGYPA	KYGPA
EGFPA	EFGPA
EGGFPA	EPFGPA
TWWPIGGY	IGGWWY
TWWPIGGY	IGWWGY
WWIGGY	IGWWGY
SSSFDR	TEDVK
VLGDVA	NRL
SSFDR	TEDVK
SSSFDR	TDEVK
TDV	VTD
SSSFDRR	TDKIE
SSSFDR	TDKI
SSSFR	TDEKI
KH	ERNV
DEKMK	KKDEM
KG	SAYSR
GKKS	RTS
LK	DSHG
SSSFDR	DTEIK
VKH	REDI
SSSFDR	TDEIK
SSSFDR	TDEKI
GKSDQE	KQ
VKH	REDV
YSDR	AASS
DSHG	LH
AAY	AMSS
GKVN	HPF
VKH	RENV
VKQ	RGDI
VKQ	RDII
AQKA	DY
AQKA	DYS
TDV	VCTD
GKSDQ	KQ
GKKSF	RTES
TESR	SFGK
GKSF	RTES
SGAKSQ	KSSGAQ
VKQ	REDII
TEL	SAAK
DTEK	SRSD
SSDR	EDKT
TDCV	VDT
RVAD	VGVRDM
NDFQAR	SLFDHD
AFQAR	LFDD
AQAR	LDLDH
TIFK	SFKGTIL
SWIR	DE
TSSEDAR	RANY
HPR	TR
QRQ	AQLD
DNQR	RQE
GNRT	DR
FLRSLYFKQ	YFKQSLFLRN
FLRSLYFKQ	YFKQHSLFLRTA
DRFAYYKE	YYKEADRF
YGYR	YYGR
QSGK	SGKQ
IEF	IEF
PTHGPAAV	APAVTHGP
PTH	NKGYHYR
SERA	RSEA
SERA	RESA
EHA	HGEA
ELIFGVAGVITII	LEIGVIGAVTIII
LIGR	EIIE
PETLFAIGLLY	YLLAIGFTLP
EILI	LY
ELIGVIGVTII	LEIFGVIGAVTII
PELIFGVAGVTII	LEIGVGVTII
ELIGVAGVITIII	LEIFGVAGVTIIII
NPWAR	PNWAR
THVDGTSSF	RQDFQV
WEE	WEE
AWVGYR	RFS
RVLV	LRVV
RVLTL	LRVTL
RIPR	HV
WR	SVE
SRD	RSD
IGLLIFFAV	IGLLFIFAV
IGLLIFFAV	IGLLFIFAVL
IGLLIFFAVL	IGLLFIFAV
IGLLIFFAVL	IGLLFIFAVL
KYH	HKY
KYH	YHK
NKD	NDKA
AD	PTA
DNAIP	PNAIGD
ETAMG	KN
PLVREQ	VLPEQR
AED	RKH
DGN	SANR
NFT	NDN
HNY	HYN
DSFEISL	SFEDISL
KSGS	YDTGN
NGKK	LDT
KR	WSDTG
KQR	WSDTG
YKR	WSDTG
YKR	WSDTGS
CPNRGDY	NGCPDYR
CPNRGDY	NGCPDR
ISP	PSN
ATT	NPT
NDDR	DNDR
NDD	DNDR
NDD	DND
NDDR	DDNR
NDDR	DNRDS
NDDR	DND
NDDR	DNDRS
DDR	NDDR
NDDS	DNDR
NDDR	DNRD
NDDSR	DDNR
NDDR	DDNRS
NDDSR	DNDR
TAGKP	AVQS
RLRQR	GRRRLR
LSL	LSL
VLSL	LSL
TATTTPR	LPRTTATT
ETA	NAL
ETA	LAN
ETA	LA
ETA	NLA
DP	DDG
DGQ	QDG
LKYG	LREH
MA	QLKP
VDKK	TFAS
IRPY	HWIE
ED	KVEE
AQALQVR	YNSG
DTEV	KPAKY
KSSG	DSPKY
DRPE	DREAP
WSKN	KDHE
GLV	VGL
GRQE	QE
SLMENESMNVL	NLYGYV
RDH	VER
QNGPQN	AEVAK
GSTLT	STLGT
QNGPQ	QAEAE
QNGPQN	AEQAK
QNMGPQ	AEVA
DND	RKEII
TQNT	HST
QDPV	PDEH
YHIGL	YGLHI
QQLLGWP	QGWPLLQ
QQLLGWP	QGWQPLL
LLPFE	LLPFE
LLPFE	LPFLE
SKVFKK	KFKVSK
SKVFKK	KFKVK
ERVAD	HFTEEE
EKH	EKH
DAT	QHA
WED	EWD
KAGV	RP
WEQ	EWQ
SHK	HSK
SWEQ	ESWQ
SWEQ	EWQ
WEQ	ESWQ
KQN	EEGFS
APEWP	RPWEP
YPEWPR	RPWEPCA
EMVLKLP	KLPEMVL
PWG	VFDN
NQL	NQL
VFDN	PWG
GTT	TGT
PGTT	TKPGT
PGT	TGT
TTK	TGT
KGST	TGSGFK
LPQ	LPQ
REVE	EAAA
NDY	APG
RIQ	QIRGK
KNG	GIQ
TKN	QGI
R	KEQFGN
TPCVT	RLD
PG	CNTST
CNTST	PG
VITQA	QATIV
RKR	ALDL
RCK	LDDA
RCKR	DLDA
RCKR	LDDAL
RCKR	ALQ
RCK	LDA
TRCK	LDA
RCKR	LDAQ
HACV	QHM
ACKR	QLDE
ACKRR	QLDE
ACKRR	QLEL
ACKRR	QELLD
RCKRR	LDA
TRCKRR	QLALE
TRCKRR	QALLE
TRCKRR	QALLED
TRCK	LAD
TRC	LAD
TRC	LDA
TRCKRR	LAQL
TRCK	LA
TRCKRR	LAL
TRCKRR	QALDE
TRCKRR	QALLDE
TRCKRR	QALLD
AKRV	LAKD
TGAK	KAL
NVTH	HL
RCKR	ALL
AEIGGDHY	FNELTSIA
ATSIELFN	YDHGIGAE
AEIGGDHY	FNELTSA
ATSIELFN	YGDHIGAE
AEIGGDY	FNELTSA
ATSELFN	YGDHIGA
AIGGDY	FNELSTA
ATSELFN	YGDHIGAE
AIGGDY	FNELSTIA
YIIVGVRIA	WFIVVLRF
WFIVLVRF	YIIVGVIRA
IIVGVRI	WFIVLVR
NNSHSEE	SSNNYRE
WEIYTLILESQQQNELELWAW	LTWGLAHQNRAQLGQLIQLQLAATA
WDEIYTIHISQQEELLLDA	ASNNWLWLDNEQQEESQILI
LLGIQQLAIQLLTGLIRIVYL	LVQILLIQQLVTLQIIEVL
LIVQLLIQQLTVLIQILVELQL	ALLIGQQLAIQLLTGLIIRVYL
LLGIQQLAIQLLTGLIRIVYL	LVQILLIQQLVTLQIIEVLQ
GDETKTVEGNGTILVKGNVTIIVEGNADITVKGDATTLVEGNQTNTVNGNLSWKVAGTVDWDVGGDW	VEGNKGTILVKGNVTIIVEGNADITVKGDATTLVEGNQTNTVNGNLSWKVAGTVDWDVGGDWTEKMA
GDETKTVEGNGTILVKGNVTIIVEGNADITVKGDATTLVEGNQTNTVNGNLSWKVAGTVDWDVGGDW	EGNVKGTILVKGNVTIIVEGNADITVKGDATTLVEGNQTNTVNGNLSWKVAGTVDWDVGGDWTEKMA
GDETKTVEGNGTILVKGNVTIIVEGNADITVKGDATTLVEGNQTNTVNGNLSWKVAGTVDWDVGGDW	EGNVGKTILVKGNVTIIVEGNADITVKGDATTLVEGNQTNTVNGNLSWKVAGTVDWDVGGDWTEKMA
VN	GNL
GNADITVKGDATTLVEGNQTNTVNGNLSWKVAGTVDWDVGGDW	VKGDATTLVEGNQTNTVNGNLSWKVAGTVDWDVGGDWTEKMA
GNADITVKGDATTLVEGNQTNTVNGNLSWKVAGTVDWDVGGDW	VKGDATTLVEGNQTNTVNGNLSKWVAGTVDWDVGGDWTEKMA
GDETKTVEGNGTILVKGNVTIIVEGNADITVKGDATTLVEGNQTNTVNGNLSWKVAGTVDWDVGGDW	EGNKVGTILVKGNVTIIVEGNADITVKGDATTLVEGNQTNTVNGNLSWKVAGTVDWDVGGDWTEKMA
GDETKTVEGNGTILVKGNVTIIVEGNADITVKGDATTLVEGNQTNTVNGNLSWKVAGTVDWDVGGDW	EGNVGTILVKGNVTIIVEGNADITVKGDATTLVEGNQTNTVNGNLSWKVAGTVDWDVGGDWTEKMA
GDETKTVEGNGTILVKGVNTIIVEGNADITVKGDATTLVEGNQTNTVNGNLSWKVAGTVDWDVGGDW	EGNGTILVKGNVTIIVEGNADITVKGDATTLVEGNQTNTVNGNLSWKVAGTVDWDVGGDWTEKMA
GDETKTVEGNGTILVKGNVTIIVEGNADITVKGDATTLVEGNQTNTVNGNLSWKVAGTVDWDVGGDW	GNEGTILVKGNVTIIVEGNADITVKGDATTLVEGNQTNTVNGNLSWKVAGTVDWDVGGDWTEKMA
GDETKTVEGNGTILVKGNVTIIVEGNADITVKGDATTLVEGNQTNTVNGNLSWKVAGTVDWDVGGD	NGGTILVKGNVTIIVEGNADITVKGDATTLVEGNQTNTVNGNLSWKVAGTVDWDVGGDWTEKMA
GDETKTVEGNGTILVKGNVTIIVEGNADITVKGDATTLVEGNQTNTVNGNLSWKVAGTVDWDVGGDW	EGNKVGTILKVGNVTIIVEGNADITVKGDATTLVEGNQTNTVNGNLSWKVAGTVDWDVGGDWTEKMA
SGETWNLLKIQ	SNRFSTKIVIIA
GKLINMVDEIVEQILKKQLEAAP	QLLFEKLLQLKIETLKSREE
ERDDAV	KGDTKR
DRDDAHV	KDTNR
KDTRN	DRDDVAH
KDTNR	DRDDVAH
NHIL	DDMDY
DDDMY	NIHL
HNL	MDY
DMY	NIHL
NHL	DDMDY
DDMY	NIHL
DDMDY	NIHNL
NHNL	DMDY
HNINL	MDY
DDMY	NIHNL
DMY	NIHNL
NHINL	DMDY
DDDMY	NHL
DDMY	NHL
DDDMY	NIHNL
TLK	NWGL
KGFE	DEDK
KDE	EGFK
KGE	DEDK
RAGSKKT	NNYQTN
SKDNVVR	RTGSDK
RAGSTKK	NNYQTN
SKDNVVR	RGSDK
SKDNVVR	RGHSDK
RAGSKT	NNYQTN
EGK	KEG
KGDTRN	DRDDVAL
DRDDAV	KGDTNR
DREDDAVL	KKGDTNR
KGDTRNK	DRDDVAE
KGDTRNK	DRDDVALE
WGL	TDL
LEK	TDQE
NWGF	DTELKL
VFIGP	WFAH
WAEHLF	WVGPNFIH
KDTKN	DRDDVALK
NWGF	DTLKL
TLKL	NWGF
DTLKL	NWGF
SDL	DKL
DKL	SLD
DTLK	NFGL
NFGL	DTLK
EDWGF	TDLI
KDTRN	DRDDVAL
KGDTRN	DDDVAL
DRDDAVL	KGDTNR
KGDTRN	DRDDVA
DRDADV	KGDTNR
DRDADVL	KGDTNR
KDTRN	DRDDVA
DRDADV	KDTNR
DRDDAV	KDTNR
DRDDALV	KGDTNR
DRDADVL	KDTNR
DDDAVL	KGDTNR
KDTRN	DRDDVAE
KGDTRN	DDDVA
DDDAV	KDTNR
DDADVL	KDTNR
KDTRN	DDDVA
KIGL	DEKL
EKLD	IGLK
EKLD	GLK
ELKD	IGLK
EKLD	SIGLK
RRTV	SED
DSE	TRVR
DDSE	TRVR
NWGF	DTELL
DRDDAVL	KDTNR
KDTRN	DRDDVALH
KGDTNR	DRDDVAH
KGDTRN	DRDDVALH
KDTNR	DRDDVAL
KGDTNR	DRDDVAL
DRDDAHVL	KGDTNR
DRDDAHVL	KDTNR
DRDAHDV	KDTNR
DRDDAHV	KGDTNR
DRDAHDVL	KDTNR
KDTNR	DRDDVALH
RRTV	DSED
NWGF	TELKL
TELKL	NWGF
DTELKL	NWGF
WGNF	TELKL
WGF	TELKL
DRDDAVL	KGDTNK
KGDTNK	DRDDVAL
DRDDAKVL	KGDTNK
KGDTKN	DRDDVAL
HIK	TQSD
TQSD	HKI
LTQSD	HKI
HIK	LTQSD
KGDTNR	DRDDVA
KGDTRN	DRDDVAH
MEALA	LM
TLNFSQP	HQHLDL
HQ	PVSA
QNR	SPSAE
HEHEED	HKE
RD	LDT
RADGD	EKR
YYFK	YYK
NHVAGQ	QGVNHA
TNR	AAPVT
TNR	AAPT
ACDP	PACD
FEKT	EKFT
NED	NGKK
EKEA	KEDPKR
LQV	QLV
NTGNSSGD	RDG
ATPN	RQEN
KGYN	CRT
KNGY	CRT
CADGTILYQVDLEYLL	WNCPSGMLIVFRIKLL
DADGCLVHALLTPKCPD	WPFCWNTKCPSRL
PICTFLYVNSDLLIL	GCLQLEIRILRV
CADTTILYQVDLEL	WNCPSGMLIVFRIL
CADGTILYQVDLEYLL	WNCPSGMLIVFRIKLSL
PTITFLYVNSDLLIL	GCLQLEIRILRV
IDIQLYINNKILVELCPCQE	KHILNVQDLIKICGS
QLYNNKILVLEPCCQE	LLNVQDMLIKIGS
IIQLYNNKILVLECPCQEQ	KHILNVQDMLIKICGSC
LQYINNKILVELCPCQEQ	LNVQDMLIKICGSC
RVELEYRLE	ELRYEVELR
EDILQYNNKILVELCPCQE	LKILNVQDLIKICGS
ADIQLYINNILVELCPCQE	LKHLNVQDMLIKICGSC
IQLYNNKILVELCPCQE	HLNVQDMLIKICGS
DIQLYNNKILVLECPCQEQ	KHILNVQDLIKICGSC
IDIQLYINNKILVLECPCQEQ	KHILNVQDLIKICGSC
QILYNNKILVLECPCQQE	HILNVQDMLIKICGS
IDIQLYINNKILVLCPCQEQ	KHILNVQDLIKICGSC
ILQYNNKILVLCPCQE	ILNVQDMLIICGS
IHDIQLYINNKILVLCPCQE	KHILNVQDLIKICGS
ILQYINNKILVLCPCQE	ILNVQDMLIKICGS
TCADGILQVDLQE	WNCPSGMLIVFR
CPITFYVLL	GCLQLLQERIVLNV
ILDFYR	QLLE
CADGTILQVDLEL	WNCPSGMLIVFRIL
PTIFYVL	GLQLLERIRLNV
IDIQLYNNKILVELCPCQE	KHILNVQDLIKICGS
LQYNNKILVELCPCQE	LNVQDLIKICGS
DIQYNNKILVELCPCQE	KHILNVQDMLIKICGS
DIQLYINNKILVLEPCCQE	HILNVQDLIKIGS
RTDIQLYNNKILVELCPCQE	EKHILNVQDLIKICGS
YNNKILVLECPCQE	NVQDMLIKICGS
LILQYNNNKILVLEQCEPC	VILNVAQDMLIKSCGSC
AHDILQYNNNKILVELCPCQEQ	LKHILNVQDMLIKICGSC
EEADIYNINKILVLECQEPC	ILKILNVAQDMLIKISCGSC
KALDILYINNKILVLECPCQEQ	RLKHILNVQDMLIKICGSC
LILQYNNKILVLEQCEPCQ	VHILNVAQDMLIKISGSC
EAHDIQLYINNNKILVEQLPCCEQ	LKHILNVQDLIKIGSC
KEADIQLYINNNKILVELPCCQEQ	RLKHILNVQDLIKIGSC
IIQLYINNKILVLECPCQE	KHILNQDLIKICGSC
QYLNNKILVLECPCQE	ILLNVQDMLIKICGS
IDIQLYINNKILVLECPCQE	KHILNVQDLIKICGSC
LQYINNKILVLECPCQEQ	ILNVAQDMLIKICGSC
DIQLYINNKILVELCPCQE	KHILNVQDLIKICGS
YNNKILVELPCCQE	NVQDMLIKIGS
IYDILQYNNKILVLEPCCQE	LKHILNVQDLIKIGS
YEIDILQYINNKILVLEPCCQE	LKVKILNVQDMLIKIGS
IDILQYNNNKLVELPCCQE	VKHILNVQDLIKIGS
IYIDILQYNNIKLVELCPCQE	LVKHILNVQDMLIKICGS
YYINNKILVLECPCQE	LNVQDLIKICGS
HDIQLYINNKILVELCPCQE	KHILNVQDLIKICGS
YNNKILVELCPCQE	LQNVRQDMLIKICGSC
IQLYINNKILVLECPCQEQ	KHILNVQDLIKICGSC
IQLYINNKILVELCPCQE	HILNVQDLIKICGS
YYNNKILVLECPCQE	QNVQDLIKICGS
FTGIDPYCFSR	RFGSYCPTGF
IQYNNKILVELCEPCQ	ILNVQDMLIKICGS
QILYNNKILVLEQCPCE	HILNVQDLIKISCGS
ILQYNNKILVELPCCQE	ILNVQDLIKIGS
LMYEIDIQYINNKLVLECPCQE	DRLKVKHILNVQDLIKICGSC
IYNNKILVLECPCQE	INVQDMLIKICGS
LMKEIEYIDILYNKILVELPCCQE	DLRRILKVKHILNQDLIKIGS
ALEDQILYNNKILVLEPCCQE	VLKVKHLNVQDLIKIGS
ALEDIQLYINNIKLVLEPCCQE	VLKVKHILNVQDMLIKIGS
EIDIQLYINNKILVELCPCQE	LVKHILNVQDLIKICGS
DIQLYNNILVLEPCCQE	KHILNVQLIKGS
YNNKILVLECPCQEQ	LNVQDMLIKICGSC
DIQLYNNILKVLECPCQE	KHILNVQDLIKICGS
YNNKILVELPCCQE	LNVRQDMLIKIGS
YIR	HAD
QYREEWAGYS	YQRESEWAGY
RGDPVAYV	RGYVDPV
PGYVDRE	RGYVDPR
PGYVR	RGYVP
RPGYVDRE	ERGYVPAR
RPGYVDRE	ERGYVPR
SSWQEVK	WSQSEK
YLIHQ	KTNNSS
DAWQ	PFCH
GPNAR	RGNAPA
PVANGA	RGNAP
TLDE	ETLD
SQAL	RR
LKICPARAEKQLAL	LCIRAAEKQAL
LKICRAAEKQAL	LKCIRAAEKQAL
LKICPARAEKQAL	LCIRAAEKQAL
RELDILRKLEQTLFDVNALRVLKEILLH	ERLAILRLRELFRVRLEVLQILKH
LAIRLLERLFRVRLEVQLIKLH	LDILKLEQATLFVALKVLEILLH
LILNDLEQATLFVNAALKVLEILLH	LILRLRELFRVRLEVELQILKH
HSVSEILILIEVILISREAGELAALLELAAKQLLYDLMLDIEYRL	IIIILRVLELQLLKLESLERYLIQILQLIRETQNEYLLKLEIYL
RLVQLTKDVERELAIRDLLKMREAQLTFRVRALEVQKLIL	EMLRQVLTDKVEERLADILRKLEMQREAETLFDVNAARLEKVLIL
RSEEKDLLNDR	RVDTNARVNED
MLRVQLTKDVERELAIRDLLKMREQALTFRVRADNLEVKLILE	MLRQVLTDKVEERLADILRKLEMQRAETLFRDVNAARLEKVLEILK
MLRVQLTKDVEERLAIRDLLKMREAQLTFRVRALEVKLQIL	EMLRQVLTDKVERLADILRKLEMRAETLFRDVNASARLEKVLQEIL
LMRVQLTKQDVERELAIRDLLKMREALTFRVRALEVKLQIKEL	MLRQVLTDKVEERLADILRKLEMLQREAETLFDVNAARLEKVLQEILK
ALYQLRELLRLTSLERELALRDVLKTRELAELNYRAEATERLEIKLIRLEHLV	LAYQELLRRLLTSLEERLADLVRKLETRAENLYREAATRLEKILEILRHVL
MLAYQLRELLRLTSLERELALRDVLKTRELAELNYRAEATRLEIELIRLEHLV	HMLAYQELLRRLLTSLEERLADLVRKLETLRAENLYREADATRLEKILEEILRIHEVL
LYAQLRELLRLTSELRELALRDVLKTREALNYRAEATERLIKLIRLEHV	AYQELLRRLLTNSLEERLADLVRKLETNRAENLYREAATRLEKILEILRIHEVL
MLYAQLRELLRLTSELNRELALRDVLKTREALNYAEATERLEIKLIRLEHV	LAYQELLRRLLTNSLEERLADLVRKLETRAENLYREAATRLEKILEILRIHEVL
LQDLRKLLE	LLKRQLQDLH
LFLIVELNQLLLEL	LFLIKVFLEQNLLELL
YLNNLAAKSYRVLTVLK	YLNNALAKESYRVLTVL
SACEIERLLLKSELMEKMRIMQQLYDLLLKDIREYLL	ESACRILELLEKNSMLKEEMIRQMQLDYLLKLEIYRLL
DLYEERLVEELTKDEVRELAIDLRLKREEQALTFRVRANLEVKLIKLEHIELI	YEELRVLTDKRVEERLADILRKLEQRAETLFRDVNAARLEKVLQEILKLHEILQI
SEERKLDLNRD	RDTNARVND
HLGYRLVEQLTDKVERELAIDLRLKLREQALTFRVARNLEVLQIELKHI	HLGYEELRVLTKVEERLADILRKLEQRAETLFRDVAARLEVLQIKHEE
LYTEALNMVDRREE	CDAGTSLRQENENYR
NLEMQMEFYAQITLQRIKMEMEHLYELLLKIRYLL	LEMMEFAYQTILQEIMKEMHEYLLKLEIYRLL
REHDL	SERR
YLKMADIKAT	ERMREEFAVAANQD
NMER	VDALTN
MLYQLM	TLQEMF
NLEQMMEFAYQITLIKMMEHLYELLLDIRYLEL	LMMEFAYQTILEIMKEMHEYLLLEIYRL
YEEMRLVLTQKDVERELAIRDLLK	YEMLRQVLTDKVEERLADILRL
SACEIERLLLKSELMEKMREIMQQLYDLLLKDIREYLL	ESACRILELLEKNSMLKEEMIRQMQLDYLLKLEIYRLL
LRGYRLVEQLTKDEVRELAIDLRLKREQALTFRVRANLEVKLIKEHLEILQ	GYEELRQVLTDKRVEERLADILRKLEEQRAETLFRDVNAARLEKVLQEILKLHEILI
SDIC	SDCI
IQVKLLAIIQILVTVEILTRL	WIVTLLLIQIITLVRVIQLEIPV
DIVTLDLLIIIQTLVRVILIQ	IQVKLALIIIQLVTVIELIT
LLIIQILVTVEILILV	LLIQIITLVRVILIVL
IQVLKLAINIQILVTVEILHTIL	WIVTLLLIQIITLVRVIQLIV
DITVDLLLIIIQTLVRVILIVLE	IQVKLLIIIQLVTVIELILR
LLIIQILVTVEILTL	LLLIQIITLVRVILI
MSFVTLLVVQLIRLLGVMILM	FVVLLAVQTSLEITLELVMLM
FVLVLAVQTLEITELL	MSFVTLLVVQLRIL
HLLKYMVELTSMIPVDNGLLRS	RSLNGLPVDMTISLVEMKYLLH
MSFVTLLVVQLRILEGLVPMTLVCMYKL	FVVLLAVQTSLEITLELYAKSNCAVYDLEH
HLKMYVELTSMIDGVSN	SNGVDMTISLVEMKYLH
QASTQ	ETNKD
HHLYLVCANAISYD	ELKVYMAILNMVY
MSFVTLLVVQSLRIL	FVVLLAVQTSLEITLEL
FVVLLAVQQTSLEITELLYAKSNCAVDLEYH	MSFVTLLVVQSLRILEGLPVMTLVCMKYLL
ETKD	QSQ
LEAKR	TQQISS
MSFVTLLVVQLIRLLGVMILM	FVVLLAVQQTSLEITLELVMILM
SFVTLLVVQLIRLLGVMILM	FVVLLAVQTSLEITLELVMILM
FVVLLAVQTSLEITELL	SFVTLLVVQLRIL
YMLNIMAVLYEK	YDAKISNCAVYLLHH
SFVTLLVVQLRILEGLVPMTLVCMYKLL	FVVLLAVQTSLEITLELYAKSNCAVYDLEH
HLKMYVELTSIDMGVSN	SNGVDMTISLVEMKYLH
HLHYLVCANAISYDK	ELVYMAILNMYL
VTLLVVQLRIL	VVLLAVQTSLEITLEL
FVVLLAVVQQTSLEITELLYAKSNCAVDLEYH	MSFVTLLVVQLRILEGLPVMTLVCMKYL
SFVTLLVVQLIRLLGVMILM	FVVLLAVQTSLEITLELVMLM
MFVTLLVVQLRILLGVMILM	FVVLLAVQTSLEITLELVMLM
FVVLLAVVQTSLEITEL	SFVTLLVVQLRIL
HLLKYMVELSTIPVDMNGLLRS	RSLNGLPVDMTISLRVEMKYLLH
MSFVTLLVVQSLRILEGLVMILVCMYKL	FVVLLAVQTSLEITLELYAISNAVYDLEH
HLKYVEMLTSMIDGVSN	SNGVDMTISLVEMKYLH
QASTQ	TNKD
HLHYLVCANAISYD	ELVYMAILNMVY
MSFVTLLVVQLRIL	FVVLLAVQTSLEITLEL
FVVLLAVQTSLEITELLYAINVLDEH	MSFVTLLVVQSLRILEGLVMTVMKYL
ETNKPD	QASTQ
LEAKR	TQQIS
MSFVTLLVVQLIRLLGVMILM	FVVLLAVQTSLEITLELVMILM
MSFVTLLVVQSLRILLGVMILM	FVLLAVQTSLEITLELVMLM
FVLLAVVQTLEITELL	SFVTLLVVQLRIL
YMLNMAVLYEK	YDAISNVYLLHH
HLLKYVEMLTSMIPVDNGLLRS	RSLNGLPVDMTISLVEMKYLLH
LYMVLCNIVYDMAL	LVYMAILCMVYLHH
HLKYVEMRLTSMIDVSNG	SNGVDMTISLVEMKYLH
FVVLALVQTSLEITELLYAINVYDLEH	FVTLLVVQSLRILEGLVMTVMKYL
MFVTLLVVQLRILLGVMILM	FVVLLAVQTSLEITLELVMILM
VTLLQAAILRLLLITSMVILSMKYDL	VELLVATQNILELSLELIQMGILNCVYDE
LQLLLIMILMVYDLE	LQLLLIMILMVYLE
ELVLTVLTNSQILELSELLQIMGISNLCAVYDM	KVTLMLATRQAILRLTLSLIMVISLSEMKYL
VKTLLMATQRAILRLLTLISSMVILSSMYEKL	VELTLVTQNILELSLELIQMGISLNCAMVKYD
VTLLMAQAILRLLLISMVILMK	VLLVTQNILELSLELIQMGILNVD
TLLMATQNRAILRLLTSLIMVILSSMYEKLLH	ELTLVTQNILELSLELIQMISLNSCAMVKYD
LVLTSQNILELSELLQIGMILNVYD	VTLMLAQAILRLLSLIMVILM
VTLLMATQAILRLLLITSMILVSMK	LLVTQNILELSLELIQMGISLNVYD
TLLMAQAILRLLTSLIMVILSSMYEKL	ELTLVTQNILELSLESLIQGISLNCAMVKYD
VTLLMATQAILRLLLISMVILMKY	VLLVTQNILELSLELIQMGISLNVD
LQLLLIMLMVYDLE	LQLLLIMILMVAYD
EDTLVLVLTNQILELSELLKQIISNLAVDEYL	KVTLMLATRQNAILRLTLSLIMVISLSEMKYL
VTLLMTRQAAILRLLTSLIMVILSSMEKYLH	VELTLVTSQNILELSLELIQMGISLNCAMVYDLE
VLLMQRAILRLLLISMVILMYK	VLLVTQNILELSLELIQGISLNVYDE
RPVKL	RK
QEE	NQRQ
STAG	GATS
SK	KNGS
APVVVQN	YPETI
NQVG	TKSP
RAYGP	AYRG
RAYG	AYRG
EV	AIPG
SSE	TDG
SS	TDG
AMSTIQAA	LNPQLL
RSLLTQLSEQAAIQAGTNLA	VIDAIIDQRLVQFDTILKI
RSVLVNQLITAEQAGISN	LIDALVVRLIQFDIL
RSVLVNQLITAEQAGISNA	LIDALVVRLIQFDIL
LVFGLQLQW	TKILAGAMQ
GDQ	QQK
QKML	KQML
NRTSKGTLQMK	QMKLKGTSNR
QML	KMLK
NTGSKLQMK	QMKLKGTSN
NRTSKTLQMK	QMKLKGTTSNR
VGSP	PGSV
KTPV	PAK
IAPE	QH
IAPEFE	QHPIEEF
IARGVK	AGVTGQKH
AQGRGVKRV	TGQKHIE
GRVKRV	QKHIE
DGVK	DGVK
KLE	PPHTR
WGLFG	AETLT
WLFG	KIAETLT
WLFG	KIPAETLTE
WCGLF	KIAETTE
LF	TDSV
WGLF	RTDSV
WCFG	KNPADV
WLFGK	KEAETTVR
HFG	LEKE
QTHG	TQH
QHG	TQH
GNSPR	RGDTWE
SVHNGQTEEAE	EEAEQTGVSHN
R	KQDDSFS
KNG	TGN
QTMP	QS
EEE	APNMK
NYDFD	RNTLH
LDASL	LDASL
YWACY	WYYACD
FERPLL	PLRFLE
KFERPLL	YEPLRFLE
RRKAL	SEDDID
RRKL	EDDID
KDQ	ESEKDLD
NTLP	KFN
NTLP	KFNL
ANP	GHTPAR
DEQA	RKKDPAN
KTALI	LATKI
PFN	EIQ
HNLDQRV	DHRV
HDRV	NLDHRQV
APERD	EMPPSK
QQQVGI	ERQAV
ERQAV	QVGQI
VNAYSVQQEMELNVA	LIALAQQNMDIANL
TLKAL	KLELI
DFQY	SPEV
DFSQY	SPEV
DSFQY	PEV
DFQY	PEVK
EDIS	ENELK
NLEE	LVSIE
VEVDQR	VDVERQ
LSSCSQRD	NISSCSQDR
VQRF	RFVQ
LFSFSHFWQR	MFLLLHAWIGN
LLHLAW	SSHFW
SFSHFWQH	LLLHAGN
FSFSHFWHQ	FLSLLHAWIG
GPTEIHSKETMVEDNVHEDISI	KIEVLYEMVLNVLHIAIIGL
SSDVIIVSLGHWIR	SSDLVAAILHLWD
SSDVLAIHLLWD	SSVVSIGIHLWR
SSVIIVSLGHWIR	SSDLVAAILHLWD
LWI	PVAI
SSVIIVSGLHWIR	SSDLVAILHLWD
SSVIIVSLGHWIR	SSDLVAAIHLWD
SSVIIVSLGHWIR	SSDLVVAAILHLWD
SSVIIVSGLHWIR	SSDLVAIHLWD
VIVSIGLHWIR	LVAAILHLWD
DVLAIHALLWD	SVVSIGIHLWIR
IPVA	WIL
VSIIVGLHWIR	LVAILHLWD
VSIIVGLHWIR	LVAAILHLWD
LPA	LLD
DVSIIVGLHWIR	DLVAAILHLWD
VLAIHLLWD	VVSIGIHLWIR
SVSIIVGLHWR	DLVAAILHLWD
VSIIVGLHWR	LVAAILHLWD
VSIIVGLHWR	LVAILHLWD
SVSIIVGLHWR	SDLVAAILHLWD
VLAIHLLWD	VVSIGIHLWR
SSVSIIVGLHWIR	SDLVAAILHLWD
VLAIHALLWD	VVSIGIHLWIR
SVSIIVGLHWIR	DLVAAILHLWD
SSVIIVSGL	SSDLVAAI
SSDVLAAI	SSVVSIIL
SSVIIVSGL	SSDLVVAAI
AASGHIWLD	IHLIWIR
ILIIHWR	AASIGHLWD
ASGHIWLD	IHLIWIR
ILIIHWR	ASIGHAD
ASGHIAD	IHLIWIR
DVLAIHLWD	SVVSGIHLWR
SVSIVGLHWR	DLVAIHLWD
AVSAGILHWRLIYF	LAILHLWDIFGLK
DLIHLWDIFHG	DAVSGIHLWRLKIY
AVSAGILHWRLIY	LAILHWDSFGK
AVSGILWRLIKY	LILHWDSIFFGL
VVSGIFW	LVAILHAW
VVSGIHFWQN	LVAILHAWLN
VVGIWQ	LVIHAWIGL
VVASGHFWQGR	LVAILHAWIGLNK
LVAIHLAWINLQIKR	VVSIHFWHNQR
VVSIHFWQN	LVAILHAWIGLN
VVSGHFWHQ	LVAILHAWILN
VNVILHWIRK	LVAIHLWDK
VLAIHLWDK	VVNIHLWIRK
NVILHWIRK	LVAIHLWDK
NVILHWR	PLVAIHLWLD
VLPAIHLWDL	VVNIHLWR
NVVILHWR	PLVAIHLWD
NVVILHWR	PLVAIHLWLD
VSGILHWIR	LIHLWD
LIHLWD	VSGIHLWIR
VGILHWIR	LIHLWD
VVNIHLWRF	LVVANIHLWDYF
VNAGHWD	NIILWIR
NIILWIR	VANGHWD
VVSGILHWIRFIFY	LVAILHLWDFFFFHGL
SSVSIIV	SSDLVA
SSDVLAA	SSVVSII
LRI	PVAI
SSVIIVSLIWR	SSDLVAAGLHLD
SSVIIVS	SSDLVAA
SSDVLA	SSVVSII
SSDVIVSIAL	SSDLVAAI
SSDVLAIA	SSDVVSIAIL
SSDVIIVSAL	SSDLVAAI
SSVIVSIAL	SSDLVAAI
VSIIVALHWIR	LVAAILHLWD
VLAIHALLWD	VVSIAIHLWIR
VSIIVALHWIR	LVAAIALHLWD
MDSM	NL
NL	MDSM
DNT	RQK
KRD	MDSN
LQTV	NGL
MDS	NL
ALRDP	ADNGDAL
KNLE	QTE
LANKE	LEANK
LANKE	LEAN
LANKEHI	LEANKE
QFRAS	CNTGV
RIEHYLYANKE	EEARKTFQ
RQFTTE	EEARTFR
KRT	NED
EK	NRTK
RNSK	RNS
NRS	KRNS
NQDS	DNQS
ELSDK	KDLSE
RDDR	DRRD
PKSSVL	SVLPKS
KSPVLS	SVLPKS
VKAGGAP	QD
ESVAL	SEVAL
SQ	SQS
PQKNRYA	RYANPKQ
QSSFNN	SQSFNN
DNK	EFSR
EAEG	GEAE
RHASLVY	ARHSLVY
QDEQ	QTG
AQT	ALTQT
KHS	ESMI
KHQS	ESMID
NQRTS	WMM
DNRN	QW
RTY	EPKDSM
KHQS	ESMI
ITKN	TLERT
RRNQTS	EQWMMV
NQRTS	WM
DLSA	KFD
DLSA	KF
LYV	YV
HKVVVL	VLVVHK
SMKM	MKMS
EVLVN	NVSE
TNVK	KVE
NES	ENS
NEGS	ENS
NGK	PN
NGQ	PY
SA	GSN
RDNGP	KPY
NEKDCL	YTEKDC
TSV	VTS
HPTP	TPPH
YTA	YTA
TKS	SVTK
VVN	NVV
TAAGY	SNV
TAAGY	SNVN
SNGK	KPN
NGM	KG
TLK	APSQE
LNLLMML	KLTHAVKL
DDLSQLSLQL	YVTVKVISSQPP
DDLSQMLSLQL	YVTVKVISSQPAP
LNLLMML	KLTHAVL
HK	ESNED
TKKGH	ELDENM
CAPV	GKKCRRC
IEET	TNEH
GLV	SSG
LIREALQ	AERLLIQ
HFDNV	ESF
FDNV	SF
HFDNV	ENSF
DLGTLKT	LDETTERE
GDLGKGTV	LDETTYERE
EAHPDPD	SEAHDVE
FGTAPIV	ESEAPDVELH
FGTAPLEYVI	EPIPDVELSH
LGRD	PKSGPK
KTK	EDDE
KTKTNCLE	YDGVELAATKKKL
KTDKTCLPPE	YDGVSELAAETKAKKL
KTKTNCLPE	YDGVELAATKKKL
TKKTDCLE	DGVELAATKKTKL
KV	SPLS
KVLPP	LEKAHEDH
LPPVK	AEDDHD
PPVL	ADH
KVPP	LEKAEH
PVKLP	AHDDH
VKP	AHEH
VPP	KAHEDH
PVLP	EDH
PV	AHE
PVL	AHEDD
VPSLP	LEKADHD
VKPLPS	AHEDHD
LPPV	KADH
VPPKS	LEKADH
VKLP	EHD
PPV	AHED
VKPP	KAEDDH
VPPL	EDDHD
VKPLP	LEKADDH
VPLP	EEDDHD
VPKPL	EEEAH
VKLP	DEESE
VKPPSL	DEEEAHP
KVPLL	DDLDEEE
KVLLPPS	DDHDEESEAH
KVPPL	DEEEAP
VPKPL	DEEEA
PVKLPSHL	DEESEAHP
KPVPL	LDEELSEAH
VKPLP	DEEEA
KVPLP	DDLDSEESEI
HLP	DEEE
VKPLP	EEEAHP
VPKKLPS	LDSEEEA
KPVLHPSL	DDEEEAHPI
VPPL	EEEA
KPVKL	DDEEE
VKPPLS	DEESEAH
KVPLP	DEEEAH
KVPPLS	DLDSEEE
VKPL	DEEE
PVLHSP	DEESEA
KVPPL	DEELEA
SGKM	AMMRQ
TIVR	KSQ
PEK	KEPET
EKKPE	KEPE
SDTMTQ	DSQMTT
K	QVDSD
DSQ	SDSEK
KRE	EKR
ARREVL	EVEAR
LWNV	QWN
VREA	EVARLR
EPGGP	GPEE
RPSS	PIE
NRYAE	SAQR
ARSQR	YNAEE
RRSQ	YNARE
EQT	KKE
ELD	SRKG
KYVYGFLKRWAVLVV	TLSLVQADASQDVMIFGSVI
YGFLKRRAWKGVIVLV	LYQADASQDVNMIFGS
YGRAWKVGVLV	LQADAQDVNMIFGSV
MQL	DDSLG
EGKV	SPN
MEGKV	PN
LNSKAEK	PELQD
LTGAD	MAK
LTGN	MLG
IS	ATVYAEAK
LTGAE	MAK
LTGAPD	MAK
IMPSCG	TNYAA
TSSV	KR
NGSQ	QSNG
LRSHV	RISL
LHS	RISL
NSARQ	NQESR
SAQ	NQS
AVTKV	IYSI
VTE	VVKR
IIYS	VTVK
ITIK	TDTK
NLITAVLTTVLL	ILKITNVLQATLL
ILKINTVQLATL	LSITAVLTTVLL
ILITAVLTTVLL	ILKITNVLQATLL
ILITSAVLTTVLL	ILKITNVLQATLL
VQLSNYIETSLNVEKLI	AAMNSIATRAVEVEGRLAAI
VSQANAIMITSAVVGTLAVIHIM	LANAIMITNVVKTLAVIQIM
SLANAIINTVVKTLAVIQINL	SSQANAIMSITAVVGTLAVIHIMQ
QAVTQKVFNQKIA	SLVNLQTVISNLQVI
VQLSSNYIETSLNVEKLI	AAMNSIATRAVEVGRLIAAI
GSAVSNQAAIMITSAVVGTLAVIHIL	SLQANAIMKITNVVKTLAVIQIL
VISVQLSNYIETSLNVEKLI	QTAAMNSIATRAVEVGRLIAAI
VNNLLSFIKSKIVSIEF	EKISALSTKAVSLGVLKL
VNNLLSFISKQIVSIEFFLVP	EKISALSTKAVSLNGVLKLYQLI
LEVIALTAVLVLVLYILIV	LEVIKLTNVLSVLTVLKILLV
LDHISLINIVFDSFLP	KLLNVVSVSTVLKIDLVN
LEVIKLTNVLSVLTVLKILLV	LVIALTAVLVLVLYILIV
NLLSFISKIQVSIEFFVL	KISALSTKAVSLNGVLKLYQLI
LEVIALTAVLVLVLYILIV	LEVNIKLTNVLSVLTVLKILLV
LHISDLIVIFSDFLV	KLLNVVSVSTVLKIDKLV
EPFSDA	NENLAR
LLNSFIKSKIQVSEFFVL	KISALSTKAVSLGVLKLYQLI
VLNLSFISKIQVSEFFVL	EKISALSTKAVSLGVLKLYQLI
LVIEALTAVLVLVLYILIV	LEVNIKLTNVLSVLTVLKILLV
LHISDLIVIFSDFLVP	KLLNVVSVSTVLKIDKLVN
VNIKLTNVLSVLTVLKILLV	LEVIALTAVLVLVLYILIV
FPSDEA	NLAR
LLNSFISKIQVSIFFLV	KISALSTKAVSLNGVLKLYQI
EVIALTAVLVLVLYILIV	VIKLTNVLSVLTVLKILLV
VLDHISLIVIFSDFLVP	VKLLNVVSVSTVLKNIDLVN
VELNLSFIKSKIQVSEFFVL	EKISALSTKASLGVLKLYQLI
ASSQ	VN
QKQE	QEKQ
NLARI	FPSDEA
VLNLSFIKSKIQVSEFFLV	EKISALSTKAVSLNGVLKLYQLI
LHEVIALTAVLVLVLYIL	LEVIKLTNVLSVLTVLKILL
VLDHISLIVIFSDFLV	VKLLNVVSVSTVLKIDL
LEVIKLTNVLSVLTVLKILLVN	LVIALTAVLVLKVLYILI
FPSDE	NLAR
VNLLSFIKSKIQVSIEFFLV	EKISALSTKAVSLGVLKLYQLI
LEVIALTAVLVLKVLYILIV	LEVIKLTNVLSVLTVLKILLV
LHISDLIVIFSDFLV	KLLNVVSVSTVLKIDLV
VLLNSFIKSKIQVSIEFFVL	EKISALSTKAVSLGVLKLYQLI
NLAR	FPSDE
VNLNLSFIKSKIVSIEFFVL	HEKISALSTKAVSLGVLKLYQLI
LVIALTAVLVLVLYILIV	LEVIKLTNVLSVLTVLKILLV
NLVHISDLIVIFDSFLV	EKLLNVVSVSTVLKIDLV
LEVIKLTNVLSVLTVLKILLVN	LVIALTAVLVLVLYILIV
VNNLKLSFISKIQVSIEFFLV	EKISALSTKAVSLGVLKLYQLI
LVIALTAVLVLKVLYILIV	LEVIKLTNVLSVLTVLKILLV
NLHISDLIVINFSDFLV	EVKLLNVVSVSTVLKIDLVN
VNLNLSFIKSKIQVSEFFVL	EKISALSTKAVSLSGVLKLYQLI
NAILKITNVQLAVTL	NNILSITAVLTTVLL
NNILSITAVLTVLL	NAILKITNVLQATVLLQ
ANAILKITNVQLAVL	NNILSITAVLTTVLL
AKDT	KNR
RNK	TDAK
AALS	TKL
WPL	PKYGE
ANL	HSP
FAGK	GFAWE
NIIKE	TEKINI
AVG	GFQ
EHHQ	HNL
NK	ANEK
DYDFTRGY	YRGFTYDD
FLYVDGK	FYLKVDG
EQHKS	KQEH
DFSF	KW
QAEPR	QN
QRV	RDTNF
KSGII	EIISKG
EAVEKRK	RKVEEA
EVVTESL	LLSETVVE
EVVTESLL	LLSETVVE
VAVM	VVMA
NEQ	TKPGM
NEQ	TKPGMF
NEQ	TKKPGMF
LLYRSQ	YRLSLQ
LRSQ	RSLQ
FALQM	FLQNM
YLRLLQSQ	YRSLQ
YLRSQ	YLRLSLQ
VWGV	LQVW
NRN	SSN
NRN	DSS
NRND	DSS
LWQV	LVWV
ITTQAIRAQ	YPMQIQVA
TIQTAIRAQ	YPQIQVA
ITTFAQIQN	YPMIQVSAE
TITFAQIQN	YPMQIQVAE
LQTW	QTNAP
TLWQ	TNAP
TLGQRW	QTNA
LGQTRW	QTNA
LQTRW	QTNAP
QTLRW	TNAP
TLGQRW	QTNAP
NH	HNPP
IAQT	VG
QIAT	VG
GV	QIA
LPD	EPA
IAQ	VG
GNV	QIA
QAT	VG
IATQ	VG
AQ	VDYK
RLD	EVAA
NHPP	HNPP
VGTQGE	KTKP
IALEETAT	TKAP
VGVL	KAG
KA	DIAL
QGV	TKA
HV	HAG
TKAKQ	IALETQV
QGT	TKA
TKAP	IALE
VGP	RL
LGKA	QGHAR
GVQ	TKA
IALAEETAT	TIKAL
PGGV	PKTK
DTIA	KALG
TKAK	TCQ
GHGP	KTIK
TALKK	ALEQ
TAKK	IALEETQ
KPKT	GVG
VRA	PKTK
TKKAP	TIALAE
LA	ETVQKK
TKKAP	TIALETQGV
TIALE	TKA
TKAP	ALE
LRV	NVK
QNVAK	HKR
KATP	TAQGP
KATI	TQ
KTPK	TACQ
TALET	TKA
VQG	TKA
GVQ	TIKA
TIAK	IAL
WEVSM	EAEVW
TA	TACQ
KGALP	IAL
KALGP	TIA
GQT	TKAG
AKGP	ALETA
QGVT	TKA
KALGP	DTIA
TAKP	IALEETQ
GQ	TKA
GVGGPQ	TKA
KAT	TACQ
TIDA	TKA
KALT	QGVGH
TAK	ALEET
PGGVGQ	PDTIKA
WT	EVW
DTIALKPK	ILETACQ
QT	PKTK
ITAL	TIAL
QPTAC	PKTKA
IAL	TIA
KAPKT	QGPHKA
KAM	AAKM
KAAM	AKM
KAAM	AKAM
KACM	ACKM
KAAM	AAKM
ESV	SVE
KAM	AKM
KAM	AM
KAA	AGM
KAA	AGAK
KAAA	AGAM
KTD	KTD
KTD	KATD
KAA	AAK
KAA	AKA
KAAA	AAKA
KAAAM	AAKAM
FTLE	TNRK
ESVNT	SVENT
AA	AGM
KAA	GAM
KAA	AM
GYDS	DYG
ELDASQ	KNN
PAQ	ADSL
GLSG	LSGAG
AGLSG	LSGAG
AGLSG	LSGG
KKRR	ELE
NT	KNTV
TERKT	RPC
TERKT	RP
EEQ	HTH
YARPPPRRQ	WNEAMVYIKE
YRARPPPRR	WNEAMVYIKE
YRARPPPRR	WNEAMVYIKEF
VIHA	VHASI
VSF	FVA
VIHA	VHASM
VIHA	HASMV
VIAPRV	YWHEM
IVIAPR	MYWE
VIAPR	YWE
FADYLSVSQC	VSQSDYLFA
VEAQ	RSA
SSGK	PAGKKT
GAALEDQR	RKKS
RKKS	GAEADQR
DEA	RPA
FKNK	DNDLDE
EFKN	KNDLD
VWHH	RLLVP
EVDK	KSE
QPE	TGH
AQRR	DMD
AQR	DMD
HTPRH	Y
RVPYV	FRYQT
IKTPR	VGSD
IKTPR	VGS
KTPR	GSV
DSGP	GGEFV
SPSRDHL	SDEHLL
SPSRDHL	SDEL
MDII	DMH
MDH	DIM
MDI	DMH
MDH	DIMI
MDII	DM
LQ	ITP
KIRVCK	WVWISL
HFS	ITD
HMEG	LK
KQVT	EEY
EVIK	QAEN
EVIK	AEN
VQQSL	IADNYYQL
YSVQAL	IYSAKYLL
HFKIFAY	YFIFHKA
RN	NDF
RNF	NDF
RNF	DFG
RN	DFGN
FSHATNEN	KKRKDS
FSHATNEN	KKRMKDS
AFSHATNEN	KKRKDS
FSHATNEN	KMKRKDS
FSHATNEN	KMKRFKDS
MIK	LEQQ
VGIQR	ELAR
VGQR	ELAR
TTR	ALRNVE
FLHEVLQKVLKR	FLHEQVLVKLKE
FLWKLCHE	LCHLKFW
FWTLKH	KHWTF
KDTKEDQ	DKTKR
FLHEVLQKVLKE	FLHEQVLVKLKR
FWTLKH	KHWTLF
FLWKLCH	LCHLKFW
FLHEVLQKVLKEIL	FLHEVLQVKLKRI
HCR	CRYH
HCR	CRH
HCR	RHC
YLVIA	LYVIA
YLVIA	LYIVA
HELAD	NVQHK
NSVQH	HELA
SLE	LES
RGYK	YKG
YED	KRA
KT	KSAQ
RKGDR	SSDRDA
VY	VHSFDN
SSD	DSS
MEKGDQ	GKGRPP
KGD	DRAG
KGD	ADG
DM	GTGR
DM	GTTR
RADG	GDK
ADG	KGD
EPGRW	RGDA
RADG	EPRWG
TNR	NRT
LHIILEMN	MNLIELIH
LHIILEMN	LMNIEILH
NPE	PNED
CLWDD	RILR
SQD	IVSR
NAGA	NW
KPGQK	PQKG
RQE	DSNTM
FRRP	NKEE
EKN	RRF
FRR	NKE
EKEN	RRF
LD	ELHS
VNWI	VNWI
PPNV	NVPP
PVHSHNI	NHSHVP
RPG	RPG
DHGDYP	RPE
PGGE	KLRDG
NGTK	GFDVQE
DEAQ	KKAE
VSQ	VSQ
PVT	TVH
GNILL	LLILI
SAFG	GLT
DGVRD	MYPGE
GVRD	MYPGE
GVRGD	MYPGE
RGER	DGSPR
YERWGTGK	EYGTGWRK
YERWGTGK	EYGTGRWK
YERWGTGK	EYGTWGRK
YERWGTGK	ERYGTWGK
YERWGTG	EYGTGWR
YERWGTG	ERYGTWG
YERWGTG	EYGTWGRK
YERWGTGK	ERYGTWG
YERWGTGK	EYGTWGR
TCLSELAAECKTRAQQFVSTKINLD	FLNDIKTSVQQRKTAECAAELSL
TCLSELAAECKTRAQQFVSTKINLD	FLNDKITSVQQRKTAECAAAELSL
AAARE	KNRDR
DVVF	GLHLL
KYRQ	RSPT
KYY	YFI
LKYY	IYF
KYYN	YFIQ
ADK	HTD
NDT	NKNG
IYFKM	FGN
NPYRE	KEYPR
NPYREK	KEYRPN
NPYREK	YKERPN
PYREK	EYPRN
NPYREK	KEYPRN
TPFREQ	QEFPRT
TPYREQ	QEYPRT
TPYQEQ	QEYPQT
TPYQEQ	QEYQPT
TPYKEQ	QKEYPT
TPYEQ	QEYPT
TPYKEQ	QEYPT
DPIA	HLR
DPI	HLR
PD	AEGE
SFQQK	RDYP
SQF	RHD
QH	SQFGQK
DRQALKKQ	MYWELEEER
VISILQTLGF	QVISQLFI
QVIESIQF	VISQFG
KYFT	QTYF
NENSIL	LKIKSNE
ENSILK	ILSNEN
NYQ	TAE
PATA	TAPA
SQVER	QSVER
YK	YAHQ
NNFDK	DNCPN
PNN	TNKN
NNTK	TNNN
RDFGENKH	PQTTT
KTQ	DMN
QHGGALVPVYQTTFT	TPYFTTQVPAVLGGQ
HGGALVPPVYQTTFT	YFTTTQVPHGAVPLGQ
QHGGALVPPVYQTTFT	TYFTTQVPHGAVLGQ
PQHGGALVPPVYQTTFT	TYFFTTQVPHGAVPLGPQ
PQHGGALVPVYQTTFT	TPYFTTQVPHGAVLGPQ
EDVGHSTDR	STDHGVED
NSK	PGG
PRFM	KIALL
PKRIMI	IKLL
PDRFM	KIALL
FGYA	AGYF
VNI	RIVVL
VNI	RLVV
FVDI	KW
PFVDI	KWF
KTMGR	QFGL
MGER	MQE
TNAMPGFNR	NPKQSLGR
NGLSPKQ	TGNRPNAM
TNAMPGNR	NSPKQLG
TNGKNAMPGFNR	GNSPQRL
NGRLSPK	TGNRPAMN
ILFG	VVSLG
TLF	YLTTF
AITSIW	LIRIPG
ITW	LVIP
ITW	LVIPV
ITSIW	LIRI
RVIITALA	NYWAIAPVV
VISITALA	WNAIAPVV
RVIITALA	YWAIAPVV
RVIITALA	NYWAIAAPVV
RVIITALA	YWNAIAPVV
VIITALA	WNAIAPVVL
RVIITALA	YWANIAAPVV
RVIITALA	YWANIAPVV
PDSYAQ	AELT
DSYYAQ	AELT
PDYYAQEQR	DAKIN
PDYYAQEQ	DAKIN
PDYYQEQR	DAKIN
PDYYQER	DAKIN
PDYYQE	DAKI
PDYYQEQ	DAKIN
PDYYAQEQ	DAKINV
PDYYAQEQR	DAKINV
PDYYAQER	DAKIN
PNYF	SQD
PNEYFTE	SQDIR
PDYYQQ	DAKIN
PNEYFEQ	DSQIR
PNYFTEQ	DSQRI
PDYYER	IAINVK
PDYYQR	IDANINK
PDYYQR	IDAKNIV
PDSYYQ	DAKIN
PDSYYAQER	DAKINV
PDYYAQEQR	DAINVK
PDSYYQER	DAKIN
PNYFQ	DSQIR
PDSYYAQEQR	DAKIN
PDYYQEQR	DAKINV
PDYYQEQR	DAKINGV
RF	NSTI
RF	NSSL
HDHLNE	DHHLEN
HHLNK	DHLKN
DHLK	HHLN
HDHLK	DHHLN
HDIGQDD	DIVGHK
DN	PDKR
KK	DDEE
HDHLE	DHHLEN
RNAHQR	QNARRH
LKEQTK	HDPDHGIQD
HDHLE	DHLEH
KTNAQK	QKATN
TNAQK	AKQTN
NAQKD	NQADK
KPED	EPD
HDHLNEK	DHHLEN
HDHLNE	DHHLEKN
HDHLNEK	DHHLEKN
HDHLEK	DHHLEN
DNAAQ	KEGN
NEGK	ANAQD
DNAQ	KEGN
DNAAQ	KEN
NEK	ANQD
KDNQ	KSDSP
NEG	NQAK
PD	SDKP
KSPD	DP
KAT	KAT
NE	DHI
HHNE	ENHH
EDKK	KSD
HDHL	DHHL
TAY	ADG
WQI	WQI
PQCWAVALTWEHPYI	RVFPFVYGTFKESEW
PQCWVALTWEHPYI	RVFPFVYGTKEFSW
PQCWVALTWHPYI	RVFPFVYGTEFSW
PQCWAVALTWEHYI	RVFPFVYGTKESQFW
MRPQCWAVALTWEHYI	RCVFPFVYGTKESF
MRPQCWVALTWEHPYI	RVFPFVYGTKEFSW
MQSWLAALIWYPFI	RQVFFIYGTSFW
PQSLWLAALIWSFI	RQVFFIYGTFW
MRPQCWVALTWEYI	RVFPFYGKTFV
PQCWAVALTWEHYI	RVFPFVYGTKESFW
MRPQCWAVALTWEHPYI	RVFPFVYGTKESWF
MRPQCWAVALTWEHPYI	RCVFPFVYGTKESWF
RPQCWVALTWEHPYI	RVFPFVYGTKEFS
PTWLVALIWHPFI	RVFPFLYGTWEF
MPQCWVALTWEHPYI	RVFPFVYGTKEFSW
MRPQCWAVALTWEHPYI	RVFPFVYGTKEFSW
MPQCWAVALTWEHPYI	RVFPFVYGTKEFSW
MRPQCWVALTWEHYI	RVFPFVYGTKESFW
PQCWVALTWEHYI	RVFPFVYGTKESFW
PQCWAVALTWQEHPYI	RCVFPFVYGTFKESW
MPQCWVALTWEHYI	RCVFPFVYGTKESFW
MRPQCWAVALTWHPYI	RVFPFVYGTEFSW
MPQCWAVALTWHPYI	RVFPFVYGTEFSW
TQTWLVAIWHPFI	KQVFPALYGTEFLW
QTWLVALIWHPFI	QKVFPALYGTEFLW
TQTWLVALIWHPFI	KQVFPALYGTEFLW
PQTWLVALIWHPFI	KQVFPALYGTEFLW
MRPQCWVALTWHPYI	RVFPFVYGTEFSW
MRPQCWVALTWEHPYI	RVFPFVYGTFESW
MMRPQCWAVALTWHPYI	RVFPFVYGTWEF
MRPQCWAVALTWEHPYI	RVFPFVYGTFESW
YAIL	YAIL
YAIL	YALI
GFSYK	FSYKG
AGQRQ	QAGQR
AGQQ	GQAGQR
QAA	ATIP
NKERSGQ	AQAKAA
SLLS	AA
NKERS	AAQ
SQGYSYK	KSYYGSQ
IPQTM	MTQPAI
ETKVKD	SNVVDDA
KDKD	ETQ
KTYGKGGSS	DKKN
GVWGQI	SDAVVNN
DKN	KSND
WKFAG	PQPYQAV
YYRHSV	IAPPFQLS
WKFAG	PLPYQAV
YARHSV	FYAPPFQLS
YARHSV	FYAPFQSLS
WKFAG	PLPYQV
WKFAG	PLQPYQAV
YARHSV	FYAPFQRLS
YTRHSV	YAPPFQSLS
YTRHSV	YAPPFQL
YARHSV	FYAPFQLS
YARHSV	FAPFQLS
YARHSV	FYAPPFQSL
YARHSV	FYAPPFQL
WKFAG	PLGPYQAV
WFKAG	PLPYQAV
YARHSVL	FYAPFQRLSS
YRHSVL	FPPPFQLS
YARHSVL	FAPFQLSS
YARHSVL	FYAPFQLSS
YARHSVL	FYAPFQSLS
YARHSVL	FYAPFQRSLS
YRHSV	FRPPFQLS
YRHSVL	FPPFQLS
YYRHSV	IAPFQLS
WKFAG	PLIGPYQAV
YYRHSVL	IAPPFQLS
YYRHSVL	IAPPFQLSS
FLLLLTRL	AVAAGLATYRR
FLLLLTRL	AVAGLATYRR
MLLLMLTL	VVATGATY
FVLLLLTRL	VAAAGLATYRR
FVLLLLTRL	VAAAGLATYR
FLLLLTRL	VAAAGLATYRR
FLLLLTRL	VAAAGLATYR
FLLLLTR	VAAAGLATYRR
FVLLLLTRL	VAAATGLAYRR
FVLLLLTRL	VAAAGLATY
FVLLLLTL	VAAATGLAY
FLLLLT	AVAGLAT
KMLLVAMH	YGTVVTS
SG	HGKE
QAVG	NFVVG
KDS	YQGAK
GTKKE	TGADAK
LVGGALGVLA	VLGLATGVLA
LVGGALGVLA	VGLAGVLA
LVGGATLGVLA	VLGGATGVL
LVGGALGVLA	LVGGAGLVLA
PSGL	STDL
HVR	LSTD
PSG	TSD
SGL	STD
NGG	KPN
FNPGDA	DGAPNF
VALNY	LYVAN
QNI	NQD
ALY	YLA
ITLLVLIVVIYHESAMGAAIAVITIL	IVLLILAVIRAIMSIA
VLLVLNIVVIEHLSRALGAAIIDITIL	VVLLILAIVIRYSADSLMSAI
VTLLVLNIVVIEHLSRALGAAIAIDITIL	VVLLILAIVIRYSADSLMMSIA
VTLLVLNIVVIEHLSRALGAAIIDITIL	VVLLILAIVIRYSADSLMSIA
ITLLVLIVVIYHESRAMGAAIVITIL	IVLLILAVIRAIMSIA
VLLVLNIVVIGEHLSRALGAAIADTIL	VVLLILAIVRIADSLMMSA
VTLLVLIVVIEHLSRALGAAIAIDITIL	VVLLILAIVIRYSADSLMMSIA
FGY	GYF
FGYI	GYFI
FGY	GYFI
THVAA	HTVA
THVAA	HTVAA
THVA	HTVA
THVAA	HTV
THV	HTVAA
THVA	HTAV
RTF	FTR
FGYN	GYF
FGY	GYFN
FGYN	GYFN
GHGY	GKFG
FGY	FGY
TYK	YTE
RTFT	FTRT
QARM	GIDEA
MSHKD	RDALS
VLAS	VNI
VLA	VNI
HK	KAES
LRE	VSW
TIILFM	LFMIIT
TIILFM	LFMITI
GDP	DSHYD
DRRNSAI	PGIEGIAR
FFA	FVLQ
EEITLQDFAHVLVYGSRVWTWKF	HEQLINVLKAVMTLINIQNVFM
FRLIIFHVNILLVFSVLW	LEYLLSMALLDASILLLTFLV
IIAFLINNRLEVIGNFSVEWSFE	FAFLAEDNLFHMLSFRFSF
NVI	NGLSF
LIVW	AMLGHL
RLVFLLSI	TDVHLYNNLQM
LSIIVENEIMMNLNNMIEVAFQ	RQHSQQHNTLMQMLAWH
FVLMFHLFFLL	IMAMNTVTVLLWM
CVFP	LYEVT
FEFALAVALEMMFQHSESASY	HLLISILFPPTIFNLLSL
LTNQIL	WGLGSAR
INPEW	LRHV
KIVTRNMTVTNL	LISIDSFPINSTL
LQLLLTEMRAAERA	DCSSFLSSTVFGDL
CYL	CLE
LE	CYLE
KSTKRQN	SENV
TD	GYDR
EQP	TGA
HGK	GKH
KRDN	ERND
TGK	YPAETS
EYTSP	KTGT
ENRDP	KRDNI
GHTAA	HFY
CGAQ	QGAC
CGVQ	QGVC
CGAQ	QGACR
CGRQ	QGRC
CGKQ	QGKC
CGRQ	QGRCR
CGRRQ	QGRCR
RLPSTI	TISPRL
HRTRGDV	DGVRRTH
FSDA	LDN
LND	FDAS
FKEAL	LAEKF
NGKVQ	QVKNG
HRTRGDV	DGVRKRTH
EKQ	KEQ
RSFD	ADRSS
DRRD	GKV
PQGQ	GQQ
PQGQ	QGQ
RDM	DRM
DKQ	DKQ
PAAPL	LPAAP
LRL	LLRC
PAAAPL	LPAAAP
NT	FEHL
QKER	QRE
TNRAQ	KEDT
TRAQ	KEDT
QRR	ELD
ASFLWQYTVTLLFKLHR	HRKLLFLTTYVWQFLSS
VEVD	QRR
KAHPH	HA
HRD	DHER
LLAII	IILLA
AEQ	QAE
QLHGKKEA	NDKEA
AEKQ	QAE
EADN	KEHGKAQL
CAEQT	QAE
SLFNV	QLR
GEQ	KLQSKC
QEKRE	SNKAQIK
TNITLED	QEH
NITLED	QEH
TIGRL	ITLGR
TCAGRA	ATCARG
YIAGE	RAG
VEL	VL
GRLSGVLAL	LEGRV
ESGRL	RLG
GRL	GRESVL
RCATEVL	RCAEVLG
VESGRL	LRG
RCAVL	RCAEVLG
VCESGRL	LRG
RTE	TER
RCATRE	LGRES
HRY	GIM
IPACIA	YR
YRAT	SGR
YRATE	REST
RG	YNSS
DVT	GL
DVT	GLP
DVTK	KVDT
EA	ETDR
ETDR	EA
YWIVM	MVIYW
ATKMWS	WSATKM
PNYYNK	YYNPNY
LEND	NLEDA
IAASL	AISL
DNLMY	YKLID
EIAF	WLVKV
WENIAF	WLVKV
ENIAF	WLKVKV
KAA	DDL
ENAFQ	WVKL
WENIAFQ	WVKLEM
LHAREDL	LHAREDL
SVIF	LITGL
TGLINL	SSAFVIR
RVIF	NLIVGL
ITSTH	TISTH
MQDEEIGK	RK
ARNR	EAK
FYN	FYLN
QPD	GQER
ALPF	SGW
AEGSQY	AEFNY
AEGQY	AEFNY
QWDNNQGR	RQGWDNNGQ
WDNNQGR	QGWDNNGQ
KTIGYCESGMDVE	EDVSGMYCEGTIKV
SNPS	NPSS
KPNT	PNTK
SEHE	NER
YMD	RLVQ
TYM	RLQ
DYF	HY
GNS	SENARFD
LGNSS	ESNARFD
LGNSS	ESNARD
GNSS	SENARFD
GNSS	SENARD
TGNSS	ESNARD
VTDITANSI	RGESN
VTDITANSI	RGESNQ
QLLRQLAALKQLILAHVMVLKQAYKDFAERARLVKLQQLLQEF	RQLLLEQALAKQILLHMVVLAQYKFDRERHLVKLKQLQLQFE
MTIQDLMLRMYCDFERARIHEKLAQLL	MIQTLDTLMYCFDRREAIHKELALQLL
VKELSRRALRVLEQIYKDFERDRAQRILEKVLLV	VKLRESRAALVERLIQYKFDRREEDAIERLVKLLQ
QDLRMYCDFERARIHEKLAQLLL	TLQMLMYCFDRREAIHKELALQL
LQDLTLRMYCDFERARIHEKLAQLLLN	TLQEMDLLMYCFDERRAIHKELALQLN
RQLLRQLAALKQLILKAHVMVLKQAYKDFAERRLVKLQQLLQEFL	ERLLLQALAKQILLKHAMVVLKADYKFDRRHEEALVLKQLQLQFEL
LLRQLAALKQLILEAHVMVLKQAYKDFERHARLVKLQQLLQEFL	LLRLQALAKQILLKAKHQMVVTLKAQYKFDRREAALVLKQLQLQFELK
LLRQLAALKQLILEAHVMTVLKQAYKDFERARLVKLQQLLQEFLK	SLLRLQALAKQILLKAKHQMVVTKLAYKFDRREAALVLKQLKQLQFELK
RQLAEALKQLILKQHVMTVLKQAYKDFERRLVKKLQQLLQEFL	RQLALAQIKLLHAMVVTLKAQYKFDRREALVQLKLQLQFEL
LAALKVILKAHVMVLKQAYKDFERARLAKL	QLALAKQIVLKHAMVVLAQYKFDRREALAKLQL
LQLAALKQLILKAHVMTVLKAYKDFERARLVKLQLLEF	LLQALAKVQILLHAMVQVTLAYKFDRREALVKLQLLQFKEL
QLLKQLAALKQVILKAHNVMVLQAYKDFERRLAKLQQLLQEYL	LQLLQALAKQIVLKAHVMVLKAQYKFDRRELALKQLQQLYELK
EVEVYSDAE	HRLLR
KFR	LR
GSFADENRDW	DWRNEADSFG
NIAD	HRR
RRAS	FNM
ARRAS	FLNM
FDS	FGDN
TD	IHR
PIK	KEPI
EAY	KKR
LKF	YYGGSQ
KF	YGYGS
LKF	YYGGS
NRNT	RNN
KQ	DKNN
SSEEK	NEYP
VQLTRWHPRFN	MLIKDEYVEK
NSKT	QQFGG
TDE	TED
EKSM	KESM
WGNKREKLENGL	LENGLEKWNRG
SSTSD	ANSV
KWLRKWDKE	KEDRKLG
KLGRKDK	KDRKK
ALDKAMQ	YRAAVHT
ALDKAMQK	YRAVTAHGE
RRN	RGKK
RRN	RGK
QKQ	RDEDA
LRQN	LPQ
LRQN	PQL
QFK	LRDD
LRN	LPQL
REN	LPL
LRQNK	PQLLD
QRKAH	DLQ
QK	RDEDA
LRQN	PLQD
VLKRQG	VLLKQG
KY	DISFIR
Y	ISFDVR
Y	ISFDIR
KY	NDISFIR
KY	DISFVR
Y	ISFVV
KY	NDGISF
Y	ISFVDVR
KY	DISFV
SLVY	MEAAAY
KY	DGISFIR
Y	ISFDI
Y	ISFVDIR
KY	DISFVIR
KY	SDIFIR
GRTLY	RTVA
GRTLY	RTVLI
RSG	DEE
RSGL	DEE
VKK	LDF
R	ERDDQ
EKLPL	KEPLL
LPLL	LPLF
LR	EDAL
EKLPL	KLEPLL
PQL	LPL
EKLPL	ELL
EPLL	KLPL
EKLPL	EKLPL
EPLL	KELPL
PLL	LPL
QAEDK	DKH
NGYRRRF	KDFMEIDDF
DSGD	RKGN
QLLDSDFY	ASSTIST
DSGD	RKGK
DQNDT	HPD
GGH	GHG
EVGG	QYN
DTIEP	SSGSQ
DTIEP	SGSSQ
QLSNSKCEKSTLTNCDKSEVF	VDKSEVFGTTCTGSDGTTT
QLSNSKCEKSTLTNCVDKSEVF	VDKSEVFGTTCTGSDGTTTS
SNSKCEKSTLTNCYVDKSEV	KSEVYGTTCFTGSRDGTT
LSNSKCEKSLTNCYVDKSEV	KVSEYGTCTGSRFDGTT
HRQ	YDMP
RGTQ	KARG
DRESK	DSKDS
AVT	TPGK
DKSE	ESDK
HRD	RGR
KEHMTQ	RMEK
ETHL	VPE
GFSVNAE	AEVNFSG
HF	SSTH
LFRRQ	DLE
FRRQ	LED
FRRQ	LEA
FRRQ	EDALE
LFR	DEA
NHQLSR	KEALE
DYSGL	RGEVQ
DYSGL	ERGKVQ
IDSGL	REVHQ
DYSNMQ	KEKGRV
EQNN	RRGVDF
CYR	HPN
CYR	HPMN
YR	PHMN
LLIGIGANAAIMI	LLYAFTIMIA
LLIGIGANAAIMI	FLLYATIMI
IIASATL	LLASSA
IIASATLI	LLLASSQA
GRGLSP	SYAS
PERQR	EK
SEAN	IVG
PEQR	QE
SEAN	IVGE
FPL	IVPFL
DTAGLSAD	RLNTDE
TAGLAD	KTNLED
RPAYL	WQKNDG
SDPE	DP
DQNLAKN	ENETRT
DQNLAN	ENTR
TES	KAHW
FDPL	RG
QLF	QVMVYLK
WFE	FTQ
NPSY	YGVI
NTPS	YEIL
FI	LSDD
TPS	IYL
FI	LDSD
NTPS	YLI
IY	LSDD
PLGLENWF	RFFIY
PLGLEDENF	RFFVANR
LLEDENF	FRFSRV
PLGLEDENF	RFFANRI
PLGLDENY	RPFIVANRE
AGE	RD
GLSDSN	RDL
GLDS	RD
GLSDES	MRK
GLDES	MR
FLAFH	LLFVFF
VFLAFHK	LLFVFE
LMIY	LLT
KDEK	DEE
DEN	KDE
KRFVNG	NVGFKR
YYSEC	K
DCELA	DL
ELEAS	ASLNE
DCEL	CDLEA
EQN	KVARM
LSNNY	AESDEQ
SNNY	SEQ
LSNNY	SADEQ
HLSNNY	RAESEQ
VRDK	RDGE
KW	SFGDS
RSLSK	NDPD
AKLPD	AKL
PDND	SSKRL
AKLD	AKLD
VLQNPDL	RGGGQA
IIDNYTYNINIFTTIYKINAQNL	FKRQIQNER
IIDNYTYNINIFTTIYKINAQNL	FKRQIQNEELR
QEWD	RHEPA
QWD	RHEPA
EKTEN	QH
EKTENI	QH
NEKTEN	QH
NEKTEN	QHK
VEKTEN	QHK
KP	DDYTPME
DDYTPM	KP
KP	DDYTPM
KP	DDTPME
YIETKV	EAVKLR
RLFK	DK
PI	DSS
AKIQKQQKD	QKQKDQS
KDH	EAQQ
QKQQKD	QQIQKKK
NI	GDYK
QLLG	HSR
DAGVKD	AGVDKD
DPD	KRN
GER	RSG
QRREE	EER
IAQAF	IQAF
IAQAF	QAFIA
IAAF	FAI
IAAF	AFI
GQSEQ	REEL
QR	EAEN
LEVTMEVLQFLAYEQLKLTVE	LGKVMVLSRFIYQEMLRLV
LKVMVLFILYMQLRLV	LEVTEMVQLFLYEQLKLTEV
LEVTEVLQFYEQLKLTVE	LKVMVLSRFLYMQLRLV
LKVLSLLRFLEYTQMRLL	LEVELGLQLFLLYQLKSEL
LEVLGLLQFLLYQMKLSLE	LVLSLLRFLYTQMRLL
LKVLSLLRFLYTQMRLL	LEVLGLQLFLLYQMKLEL
LYQESVH	LYQVHSE
LYQDDSVH	LYQVHSDD
LYQDSVH	LYQVHSD
ELGFSLAAK	AKLAFSGLE
RRIFKI	YDLRPGL
VVGGSI	GSIGVV
NRFNLAV	LAVFRN
NRFLAV	LAVFNR
AVYAGFP	GFPAAVY
VYAGFP	GFPAAVY
DRFFVR	RDFFD
LERY	YRSEGLL
ALEHS	LLR
EAAVLY	YLAVEA
SIGCAFVDKREQNLVE	VELSNQERDKVASIGCF
SIGCAFVDKREQNLVES	VELSNQERDKVASIGCF
DAAGLAKA	AKGLADA
DAAGLAK	AKAGLADA
DAAGLAK	AKGLADA
DEAFAYA	AYKAAEFD
EVSFFRAV	AEFVRVSFE
KAID	DIAK
KAID	DEIAK
KADID	DDIAK
DLIKLTV	TVIKLDL
TETTVINRNS	IRNSVNTTTE
TETTVIRNS	IRNSVNTTTE
PDLH	TGD
TNAQ	TNAQ
TNASQ	TNAQS
TNAQ	TASQ
QPLNEY	YENQL
DPFGAQH	HAQGDPF
QHWIAEI	QHWAAI
PFGA	EGAPF
QHWTAEI	QHWAAI
AQHWAI	WQHAETI
PFGAQ	GAQPF
GEGGS	R
IRDF	RDI
IRD	IRD
KTE	NSR
EGK	PGLE
NIRAN	RANYNI
RLSAD	ADLR
DLADY	ADYLD
DLA	ALD
NLQAN	QANLN
QDRR	RYRN
QWRG	QTKQRDG
SAS	EEG
IEARKAQIS	ISQAARKIE
VYVL	VYVL
GER	ITG
LYQK	WTTGGA
LYQ	WTTGGA
DQKT	EGKD
SDTV	DST
TSYGP	SSGQ
TDL	SRPLK
GSDV	SDVG
DPQ	KSNG
RH	AEDN
VQKEEKVA	VAEKKEVQ
GKP	VGTDHP
NRDSEGK	GKAAN
VQKEEKVA	VAAEKKEVQ
SGPPGPPGPPGPPGARGQAGVMGFPGPPGPPGPPGRA	SGPPGPPGPPGPPGARGEPGNIGFPGPPGPPGPPGRDA
SGPPGPPGPPGPPGARGQAGVMGFPGPPGPPGPPGRAP	SGPPGPPGPPGPPGARGQAGVFMGPGPPGPPGPPGK
GPPGPPGPPGPPGARGEPGNIGFPGPPGPPGPPGRDAT	SGPPGPPGPPGPPGARGQAGVMGFPGPPGPPGPPGKE
GPPGPPGPPGPPGARGEPGNIGFPGPPGPPGPPGRA	SGPPGPPGPPGPPGARGQAGVMGFPGPPGPPGPPGRDA
GPPGPPGPPGPPGARGEPGNIGFPGPPGPPGPPGRAP	SGPPGPPGPPGPPGARGQAGVMGFPGPPGPPGPPGK
GPPGPPGPPGPPGARGQAGVMGFPGPPGPPGPPGRDAT	SGPPGPPGPPGPPGARGQAGVMGFPGPPGPPGPPGKE
SGPPGPPGPPGPPGARGQAGVMGFPGPPGPPGPPGRDAT	GSGPPGPPGPPGPPGARGQAGVMGFPGPPGPPGPPGKE
LQMELETNAALDVLLQEIFLTVCDA	APLQMLNRLVLRVQITKMLVCA
APMLLQTNLVRLRQVITLKVMAC	LMQLETREALVADLLQEILTVDACC
LQMRELETAALDVLLQQEIFLTVECDAC	APLQMLNTLRRVLVTQIKMLVGCA
APMLLQTNLQVRLRQVITLKVMACG	LMQLETREALVADLLQEILTDAC
LQMELETAALDVLLQQEIFLTVCDA	APLQLNTLRRVLVQITKMLVCAG
APMLLQNLVRLRQVITLKVMACG	LMQLEETALVADLLQEILFTVDACCE
APMLLQNLQVRLRQVITFLKVMACG	LMQLEETALVADLLQEILTVDAC
LQMRELETNAALDVLLQEIFLTVCDA	APLQMLNRLVLRVQITKMLVCA
APMLLQTNLVRLRQVITLKVMAC	LMQLETREAVADLLQEILTVDAC
LQMRELETNAALDVLLQEIFLTVCDA	APLQMLNRLRVLVQITKMLVCA
APMLLQTNLVRLRQVITLKVMAC	LMQLETREAVADLLQEILTVDACC
APMLLQTNLQVRLRQVITLKVMAC	DLMQLETEALVADLLQEILTVDAC
LQMRELETNAALDVLLQQEIFLTVCDAC	APLQMLNQRTLRVLVTQIKMLVCA
LQMELETNAALDVLLQQEIFLTVCDAC	APLQMLNQRTLRVLVTQIKMLVCA
APMLLQTNLVRLRQVITLKVMAC	LMQLETEALVADLLQEILTVDAC
K	GGALHPR
AKT	GGALGHPR
KT	ALGHPR
RAK	ALGPK
AK	AGLGPK
AK	AGGLGPK
RNKE	AGPK
RLVGR	YNAFVH
REW	YPAETT
LFQ	FYECG
EDSW	NQTPL
PLPP	GAMA
KEDK	DKKE
GLDK	DLGK
GKDEP	AEAIPDKG
DAKETEH	KEDTPEH
DGA	DGA
PFGGMN	ITGAGMY
FGIGMNFE	TAGYMLEW
GIGMNFEY	AGGYMELY
AGYGEY	GIMNGEY
DKDP	KK
QQKAFNMIVFTNITTSQLQVALNIQVNGNLNTLRFISIQY	WVLTLIINQTVQLLSANLEKILELNTQIYVEQLVG
QTNKD	QTNKD
IVIQILNVALNLLQLGK	LLLQLNALVNIQVIIN
NQIQFAITALLVVNALL	QIAFIITLLQVALLV
QIAFIILTLLQVLLVL	NQIQFAISTALLVVNALLL
ANFNIIQLTTSTLGQVNALNV	ILSLLAKNLNVIIVNQVASNI
IQFKAQIESTTAKLVQNATL	IESLNLVRLEIVNSVAIN
QIQFAISTALLVVNALL	QIAFIILTLLQVLLVL
INASVVNIQILNVAKLNSLIDL	LVNANQVLSGLTTTQIIFNAKN
QDR	KRENE
IQFKAQIESTTAKLVQNATLQLS	IESLLVNRLEIVNSVNAIISGD
NQIQFAISTALLVVNALLL	QIAFIILTLLQVLLVL
QKANFNIIQLTTSLGQVNALNV	LILSLDLAKNLNVIDIVNQVASNI
ISINASVVNIQIDLNVAKLNSLIL	VLSNALNQVLSGLTTQIIFNAKN
NQIQFAITALLVVNALLL	QIAFIITLLQVLLVL
INASVVNIQIDLNVAKLNSLIDL	VNALNQVLSGLTTQIIFNAKN
NIQFKAQIESTTAKLVQNATLQ	EILESLLVNRLEIVNSVAINSG
LLLNFIVLIRLKVV	LLVLFILLILDEVV
LLVLFILILLDVEV	LLNFIVLIRLVEV
LLLNFIVLIRLVEV	LLVLFILLILDEVV
ITALLVVNALLL	ITLLQVLLVL
ITLLQVLLVL	ITALLVVNALLL
SIQLTTSLGQVNALNVLS	ELLAKNVLIDIVNQVASNISI
ISTALLVVNALLL	ILTLLQVLLVL
IQLTTSLGQVNALNVLS	LLAKNVLIDIVNQVASNISIL
IQLTTSLGQVNALNVLS	LLAKNLNVIIVNQVASNISIG
SLIDLQLG	LESIDLEKYY
ESLIDLQEL	LDQLINSE
IQFKAQIESTTAKLVQNATLQLNAIVR	IESLLREVNLEIVNSVAINIGDLVS
GHTSVLIINVIQILNALNLLQLGKQIK	SHTSVIIIEILVLSLLLDEI
SHTSVIIIEILVLSLDLLEI	GHTSVLIINVIQILNALNLLQLGKQIK
MRLLESLEKRLIQKLNLLLERERLLEKLTLNLLEKARLERLTERLEKLAI	ALEMRLLSKRESSLIKQLNLLLEGRELERLLKTLLNRKELELERTRKDLELKA
LQR	LQKQ
PSGG	SGMDI
PSGG	GSMDI
PSGGG	GSMDI
GMDVR	QNN
GMDV	QNN
TGMDVR	QNN
GMDR	QNN
TGMDR	QNN
GMVR	QNN
IVGLDR	QNQ
IGLDAR	QNQ
VGMDVR	QNN
LAMVE	LLSFA
LAMVE	LLSA
TLVE	IIARG
GRL	MSEPI
GRL	MSPEI
GRL	MPSI
GRI	MSPI
NSD	TGGE
NSD	TGG
PM	PSN
PE	HVSG
YIL	HGAS
FFLWYV	LFLGLYL
FFLWYV	LFLGLY
FFLWYV	LFLGYLL
DWEK	RPGS
DWEK	RPGSC
DWEK	RPCGS
QATG	NVQQ
QATG	NQQ
QATG	NVAQQ
QATG	NAQQ
IPYH	GTFPE
IPYHH	GTFPE
IPYHH	GTFPRE
RKAGI	RW
KAGI	RW
HK	SFA
HQK	SFA
KWLTGFFFVRLL	TPTEIGVTSFAVLPWLYK
KWLTFGFFFVRLLK	TPTEIGVTSFAVLPWLYKS
KWLTFGFFFVRLL	TPTEIGVTSFAVLPWLYK
KWLTFGFFFRLLK	TPTEIGVTSFAVLPWYLKNS
KWLTFGFFFRLL	TPTEIGVTSFAVLPWYLKS
KWLTGFFFVRLLK	TPTEIGVTSFAVLPWLYS
KWLTGFFFRLL	TPTEIGVTSFAVLWYLS
KWLTGFFFRLLK	TPTEIGVTSFAVLPWYLKS
KWLTGFFFVRLL	TPTEIGVTSFAVLWLYKS
KWLTGFFFRLL	TPTEIGVTSFAVLPWYL
KWLTGFFFRLL	TPTEIGVTSFAVLWYLKK
KWLTGFFFVRLL	TPTEIGVTSFAVLPWLY
KWLTFGFFFVRLL	TPTEIGVTSFAVLPWLYKS
KWLTGFFFVRLLK	TPTEIGVTSFAVLPWLYKS
KWLTGFFFVRLL	TPTEIGVTSFAVLPWLYKK
KWLTGFFFVRLLK	TPTEIGVTSFAVLPWLYKKS
KWLTGFFFRLL	TPTEIGVTSFAVLPWYLK
KWLTFGFFFRLL	TPTEIGVTFSAVLPWYLKS
KWLTFGFFFRLL	TPTEIGVTSFAVLPWYLK
KWLTFGFFFRLL	TPTEIGVTFSAVLPWYLK
KWLTFGFFFVRLL	TPTEIGVTFSAVLPWLYKS
KWLTFGFFFRLL	TPTEIGVTFSAVLPWYLKNS
KWLTGFFFVRLL	TPTEIGVTSFAVLPWLYKS
KWLTGFFFRLL	TPTEIGVTSFAVLPWYLKS
KWLTFGFFFRLLK	TPTEIGVTSFAVLPWYLKS
KWLTFGFFFVRLL	TPTEIGVTFSAVLPWLYK
KWLTFGFFFVRLLK	TPTEIGVTFSAVLPWLYKS
ASMGGRV	GGRASM
TDSSQK	KTDSSQ
KIVG	QFE
S	EIGMEL
GSA	GIME
DT	GKNF
PDTK	GFKN
DT	GFKN
PDT	GFKN
PDK	GFKN
PDTK	GKNEELF
PDT	GKNF
PDTK	GKNF
EEKISKG	KSEI
EEKISKG	KSEIE
EEKISKG	KSEIEK
EEKISK	KSEIE
EEKISK	KSGEIEK
AAAM	AAM
NSVNE	SNN
NSVN	SNVNE
NSVN	SNVN
NSVNE	SNNV
KTA	TAK
AVK	AVE
AVEK	AVKE
KTA	TAKN
AVE	AVK
PRVD	RPDV
HIESIDSK	QYVVSNS
SNSVYV	DSKISEI
VMT	MVT
VTID	LT
TRV	RTADV
TES	STE
QKFQN	QDYL
KFQ	QDYL
QKFQN	QDLY
DQNLSSCK	RNSSLP
RELDE	DELER
HNL	DCDPS
RAKTR	NSNY
LKGLR	EPD
WEE	EEW
AKETR	NFSY
GVQEN	DT
TD	QENGV
LPAEAR	NGPVRY
REDTLKE	RQARMEE
KGL	LKG
RTLPVE	LPVERT
YLAF	YLAF
QVSN	QSVN
NL	SLAG
GHGF	GHFG
GGF	GFG
GHGF	GFTG
GGF	GHFG
RVHILLME	EELMLHIVR
FLFL	LAFL
RKK	QQY
YAQQ	KRK
EKAL	RPL
RNDERV	RRNDEV
SRNDERV	RDE
R	SRNDERV
SRNDERV	R
DAGR	GRDA
ITI	TII
VDGARR	VRRAGD
QQTLPPP	PPPTLQQ
ERVAGFIF	NLLLVG
RQHK	EQD
GRQK	QEDG
HAE	HEA
KNAE	TR
KNAE	TRK
NAE	TR
FNAE	TR
KNAE	TRKH
NAE	TRH
NAE	TRK
CIVQVILQLVAILEI	ISVFQVLILKLVRILAKI
SIVFQVLILKLVRIALKI	QCIVVILQLVAIILE
QQ	ATIPR
PAKRQ	SEEG
IERT	RE
R	VSRID
LG	EQS
LAMAT	LAATM
AMARTEMGEARN	NARMGETEAAR
FSAARTEMGARN	ENARMGETEAAMR
LAAT	LAAT
HFKIEVGSEIR	RSEIVGIEFKH
EFFI	EFFI
HFKIEVGSEIR	RSEIVGIEFK
YLGNT	PADRM
YGNT	PADRM
SGLSA	KSGLA
SGLA	KSGLA
RYLGN	SGALK
SGLSA	RSGLA
SGLSA	RSGLAS
FRYLGN	LSGAK
EKTG	GVC
EKTG	VGC
VCG	KTG
IIH	HII
WERA	RAWE
IIAL	IIAL
IKIATL	IKAIALT
IKIAL	IAIKL
GITTV	PRLQ
AGII	LGRP
GN	GST
GITTV	QPE
AGIV	LGQ
AGI	QLG
KAGI	GRLP
ELR	RNSDN
EELQR	QLNNP
YALDD	ELI
ISTGS	KR
RNLV	SSHH
NLV	SSHH
LECGR	ECGLR
IAR	VVRG
RGVV	ARI
IMPHP	MPHPI
VDSRVS	KR
ISMA	FS
IMA	FTL
QMDPA	QF
ISMA	FQ
ISMA	FSQ
HISMWA	QFW
HHAKGFLWWFWT	NLYLLMYLTVEP
GSKY	EET
SFEI	EFIS
QDEQ	QFNALDD
LLRLA	IL
TCSQSQFIGER	RTFIGESQQ
QSQTFIGER	FIGESQQTCS
ETCSQSQTFGE	RTFGESQQ
ETCSQSQTFIGER	RTFIGESQQTCS
QSQTFIGER	TFIFGESQQTCS
ETSQSQTFGE	RTFIGESQQ
RGNE	NGER
FEVFY	KRLFS
KNETCLQS	SNETVN
KYD	EQEL
TTR	LNQ
KNETCLQS	STVN
TTRK	LNP
KNETCLS	SNETVN
KNETCLS	STVN
KNTCLQ	SETVN
TTRK	LNQ
KNTCL	STVN
KNETCLQ	SNETVN
TTR	LLNQ
KNETCL	SNTV
KNETCL	STVN
DTTRK	QLN
QLKNETCLQ	FSNETVN
QLKNETCLQS	FSNETVN
LLP	QIN
MR	AIETG
TNVNCALSMAKL	PYRHNR
HG	HGLM
PH	FLIG
KQGYIE	ESYIM
EVRNQL	NPALV
NSK	SLSTS
NSK	SLST
IPAA	RDQ
EEKLAIFG	KYDIMMI
ITRN	VLIGS
ITRN	LVLIGS
LERTSV	LKNELRS
RSEKLLN	ETREL
RSEKLLN	TSVREEL
LERT	LKNEL
LERTE	LKNELSR
EKLLN	RTEL
LERT	LKEL
ELERTS	KLNELRS
QSELATTVNNTIQLRKLQ	LKRLQINTNTTSELQ
LERTE	LKNELRS
YTAPEYECVEQLD	YTATLTQFLTY
YTAPVYECVEQLD	YTATLTQFLTY
RFE	PSC
QHKY	EPEE
SQSE	IQWR
LQWK	SPS
ADDR	KRNQ
RLKLLLEVLSN	SLELVLLKLRQ
FTQS	YSPS
AKAP	HPT
ILLTLIIK	IRIKLLLLIT
RPEL	RRKM
IMLL	ELF
DRKDLILL	RLFL
RKDLILL	RELFL
QVGF	GFVQ
RELG	ERGLHN
NSVSA	VSASN
NSESA	VSASN
NSSA	VSASN
SGEN	SEGN
GFSE	SFE
VLHLLK	LFFS
GKPV	KT
IKYPEN	PEYNKI
KED	SEKQK
KRRYN	NTE
QDLRG	KR
QVDLG	KR
QDLYG	KAR
DASALRD	KVPGKLK
SNMIQ	QSNMI
NMIQ	SNMIQ
NMQ	SNMIQ
EP	RVFEA
QQISYENALTAS	TASALYENSQI
QQISYENALLTAS	LTASALYENSQQI
QQISKYENALLTAS	LTAALYENSQQI
QQISKYENALLTAS	LTASALYENSQQI
RRAA	EQT
FRLLALINR	LELTYLKK
IGIIESILE	LKQKKIKVS
IGIIESILE	LKQKKIK
VTRFI	ALIQVYAL
VTRFI	ALQVYIAEL
QVAI	VQAI
QNRLI	QNRILI
EVRPY	RE
EKALK	LKAEK
KDAR	VYLD
CAN	TVRR
DEAR	ERD
ADEMAQRQ	AQRLLTGA
DEMAQRQ	QRALLTGA
KELLD	YQGCV
PGR	VPAA
AAVP	RPG
AAVPG	RPGLE
PGWEYH	HEYWGHQP
RDGAV	EERGT
EMAP	SR
QDARE	AQR
EWA	TPIVP
QRHG	KCIE
LEKFR	LKFE
EI	TLDG
ETLDG	EE
DF	RGPIEH
DRFE	RGPIDEH
KEG	EKG
EKK	GER
KKR	EEGVDY
NQD	GQRVL
ADIDD	RLR
NQDE	GVQRL
AHQ	HAQ
LLKTDRTVN	VNTKTDLL
KN	KKSEV
SEVK	NK
KN	KSEV
DEAA	KRSLY
QGDV	NGQ
PDLPEE	EEPDLP
PDLPEE	PEELPD
TRDGLPVR	RDVPRLG
GDAR	RRAGD
DASR	RAGD
QSHRK	HRQK
QQG	GPQV
NQSGGH	SAGGHNQ
NQSGGH	SGGHNQ
KEQR	LRQN
KEQR	LRN
AHEQA	AQHEA
PE	AADLKH
PE	AADL
QSAGH	E
AADLK	PE
AALK	PE
PE	AAMK
PEWE	AADMLK
AAMLH	PE
EK	SLRF
EQAG	AQG
QAG	QAGE
NQSAGG	QSGGHN
ASP	SPR
EEQ	RRN
ENE	GH
GH	ENE
NQSAGGH	AGGHQSN
NQSAGGH	SGGHQN
SPGD	QL
AAV	AVA
ETKY	KYET
AAVKAD	VAAAKD
STAAT	KEQVY
AVTER	ETVAR
VTELR	TEVAR
VTELR	TEVR
RAVTELRE	ERTVA
AVTERE	ETVAR
VTEL	TEVR
VTELR	EVTR
AVTELRE	ETVLR
AVTELR	ETVAR
AVTP	PTVA
VTELR	TEVLR
AVTELR	ETLVAR
AVTE	ETLVA
AVTEL	ETVALR
LTK	TKL
AVTER	ETLVAR
TPWN	NPWT
TPWN	NPWFT
SWSE	SEW
NSDE	SDNE
HDHLWFIDV	TTGKY
HDHWFIDV	TTGKY
DFQKTKLDQKAQNQKAQSSRTKQVQNLQQSRVITN	NLEMQNIMQTIEIQTNQDQAYEMYQEKARASE
NELMQNEIMQTQEIIQTQNDQYAEMYQKEARAN	DFKQTKLQDQKANKQAQSSRTKVQNLQQSTVRIMN
DFQKTKLDQKANQKAQSSRTKQVQNLQQSRVIMT	NLEMQNIEMQTIEIQTNQDQAYEMYQEKARASE
FQKTQLDQKAQNQKAQSSRTKQVQNLQQSTRVITSK	NLEMQNIEMQTIEIQTNQDQAYEMYQEKARSAE
DFQKTQLDQKAQNQKAQSSRTKQVQNLQQSRVITS	NLEMQNIEQMTIEIQTNQDQVAYEMYQEKARSAE
FQKTQLDQKAQNQKAQSSRTKQVQNLQQSTRVITNL	NLEMQNIMQTIEIQTNQDQAYEMYQEKARASE
FQKTLDQKAENQKAQSSRTKQVQNLQQSRVIMN	NLQEMQNIEMQTIEIQTNQDQAYMEYQEKARN
DFQKTKLDQKANQKAQSSRTKQVQNLQQSRVITN	NLQEMQNIEMQTIEIQTNQDQAYEMYQEKARSE
DFQKTKQLDQKAQNQKAQSSRTKQVQNLQQSRVITN	NLEMQNIEMQTIEIQTNQDQAYEMYQEKARASE
DFQKTQLDQKAQNQKAQSSRTKVQNLQQSRVIT	NLQEMQNIEMQTIEIQTNQDQAYEMYQEKARAS
DFQKTKQLDQKAQNQKAQSSRTQVQNLQQSRVINTSKQQEIQTQTQYNIKMTVSEVDVHTQR	NLQQMNIEQMTIEIQTNQDQAYEMYQEKARSAENLNQSRQVMLMAQQAGQFTQDEMRKAELDQQN
DFQKTLDQKAQNQKAQSSRTKQVQNLQQSTRVIMNTSKQQEIQTQTQYNIKMTVSEVVHQTQR	GNLEQMNIEMQTQIEEIQTNQDQAYEMYQEKARSAENLNQQSRVMLMAQGAQFTQDEMKRAELDQQN
FQKTKQLDQKANQKAQSSRTKQVQNLQQSTRVIMNTSKQQEIQTQTQYNIKMTVSEVDVHT	NLQEMQNIEQMTQIEQTNIAQDQAYEMYQEKARSAENLNQQSRVMLMAQGQAQFTQDEMRKAELD
DFQKTLDQKAQNQKAQSSRTQVQNLQQSTRVIMNTSKQQEIQTQQTQYNIKMTVSEVDVHQTQR	NLMQNQIEQMTQIEIQTNQDQAYEMYQEKARSAENLNQQSRVMLMAQAGQFTQDEMRKAELQQND
NKSTE	RS
ARK	DEQS
GANR	DGES
DGS	GA
KLPGSQ	QLNS
LQPG	QLN
PG	KLQN
LGSSVL	TTELA
LGSSQVL	TTELA
EQWDLVKS	PRLILLK
RPILVIIKQL	PLVMYFQHL
RPILVIIKLH	PSLVMYFQLQ
RPILVIIKQLH	PSDLVMYFQHLQ
LTYNLQSEK	MIDHTKRGDI
VLV	FVET
QDH	EDRL
VGKQDP	RELLK
QA	RNDS
QAHR	HKN
SIQ	NTDS
NDMYNSFL	DDPVQFRAFLHY
KYLNMVVYSRSALL	DSTRYPQFIRLHVSAM
KIQAI	EEDD
NDVYLLSALLI	STFQRIHCIVS
DVNHDINNQLTTELIYNRSIADE	EQYDSFIRANHLYSMPEKTEKN
DVNHDINSNQKLTTNELIYNRSIADDE	QYDSEFIRANHLYMSPEKEKN
KFYTNQMVYAIRVANL	DTSPQFIRHCISA
TQMVYASRSAL	RQTLHICLH
TNMVYASLRVAL	TQYSRPFIHIS
TMVYSLRSVANL	TRQSFIHIS
FKTQMVYASRSVANL	RQYTFIHCIS
FVKFYTMVSRVANLN	QFILHVMY
VFYTMVSRVANLN	QFILHVMY
ASLQEFVKFYTNQMVYSLRSALNL	RQYTHFIHCISVMAPPYNELDS
SLQEFVKFYTNMVYSLRSVANN	RYTQHIHFCISMMAPPYESLD
SLQFVKFYTNQMVYSLRSALNL	RYTQFIRHCISVMAPPYESLDK
NMVIYINLSIAFDLIE	QDPFVDERIKFANLHEYL
TVTNDLMIYNLRSAFDL	DSEQYPFIRANHYLMS
DLMVYILFLI	SFEVRILHY
LKLDIYKKNQIQLDVLLPEFAFK	MTVITEHELKLLKSWLLN
LKLVYKKELPNIKLDVLLNPDEI	LIEIIEHELHTLNVWLL
VISLVIIFDDIE	LLVVLFKA
KNDQVVYLLIVLHI	DYTAITMVLYKA
NDVYLLIVHI	YIATMVVLKA
VLIVVHIN	TATIMVVL
YVDT	KTYAATNV
DNINAVNDM	YTALVVLFA
LTKMVAEYSIEE	ATSALEQVQLK
DNINLKAVNDM	YTALLVVLKA
NLTMVEYSKIEEK	TASALEQKVQLKE
EKNKEEKMPAN	DKEYELQKNSDNK
LIVLLI	EAENVKS
KNKKME	DELQKD
KNKAEEKEKN	DEKEQNKYN
LVLI	ATNVK
KNKAEEKELKN	DEKEQNSKNY
MVLIVLI	KTAATNMVK
NKAEEKELIKN	DKEEQKNK
KLELKNNKEEDKPLA	KDEEQNKSDN
KLELKNNKEEDKPLA	KDEEQNKSDNK
KLELKNNKEEDKPL	KEDEQNKSDN
QEFKAYLDV	DTYAMNVL
SCNEVKMLEAYNKVE	KTAETNQKVSKL
VLNDVL	IVLK
EVKAYLKNDVL	TTAMVVLKA
SCNEVMLKYNKVEEED	KTAEETNVKSLKA
CKNEVKMLAYNVEEED	TKAATEMNVKSLK
VIVRIIFDIE	TALVLVNVL
DMVILVIFDIE	YTALVLVVLFK
NLTKMVAEYSIEK	TAASLEQVLKQE
VVIIDE	TLLVK
VVIIDIE	TLLVLK
LLKLQSLKVVLDVIIHLLQVFL	GMEVLENWLKVMIIIQR
VVA	LMQV
LVVA	MLQWV
LVVA	MLWV
LMFGF	KIVA
LKQM	LMKQ
QDQ	DQQ
RHPLKQ	HPKRD
DNATQL	SMPG
DGFV	WNN
RI	RDCL
RIG	RCL
RIG	RDC
EKKGIWG	REK
QDEY	SDK
TEAV	TQPNK
ATRIQ	DAITQR
DATIQR	RAITQR
NATILE	NAITLR
VVLL	VLVL
EKP	EKP
TVTL	TVTL
AKGGVG	E
AHRSS	NRRWPLE
EKH	KHE
KTG	EGMGK
KTG	EMGGK
REG	EAGA
GST	TRVD
FNFAVEEYL	RKLFNG
EEG	NEL
DAD	DQI
RRGTIFVLFVWIMFIIAQTT	KAGRVILTAVLLAIAAPN
RRGRGYTAIFVLFVWIMFIIAT	AGRVVNILTAVLLAPIALAN
RRGYTIFVLFVWMFIAQQTT	ARNIVVLAVTLLALAVAN
LAAPIALLTALIVNRQGGKAM	TQIAFMVIFFLIVTGRGNGYRR
RRGRGYTIFVLFVIMFIIAQTTNL	AGRVNIVLAVLTIALAPAV
SCKIAK	SCKTIK
AAVA	TVPVSSG
YDVFVPK	KHLKYKTT
TNWGRSVPN	NTRSNWVPG
TQKDR	AERME
EAERM	RTQKD
TQKDR	AEMRE
YT	ELATNQ
NELILN	NLENLI
YYN	KLKNA
DNY	PRA
LLNVFTIQNDKFALH	LLFAFLFDKLAYNGNL
HKLNSN	LDNLGNKA
LLNTVFTIQFALH	LLLFAFLFDKLAYNG
RQLL	DRL
QLL	RLD
KTKSAS	HIRKPY
IGIWFR	FRRVDY
RTLF	TVYL
RFMEVK	IGGARHD
VRFVEVR	LIGARH
YNWAVTGQ	NQKRLQ
DTADYVSAK	TVEMLAV
TADYIS	TVEMLV
MTWFPI	REQD
TFPI	REQD
RIY	TAITG
NALKK	KFYQDHAT
GWR	VKE
GGWR	VKE
FRVLEM	PQVHKNI
FRVLEM	PVQHKNI
ARLR	RAL
EEM	ENHI
EDRRTER	RREDETR
QGF	AFDG
GSDK	RE
FAKLQ	FLVFE
VFAVLK	FFEFYEE
LFEFF	FALVV
VFAVK	FFFE
VFIAKVL	FFLEF
IGIGG	GGGII
IIGIGG	IGIGG
IIGIGG	GIGGI
IIGIGG	IGGGI
GFFR	YNY
YVVYNKQD	MFFGKER
YVYNKQD	MGFKER
ALKILLQLLIQQQLKEIL	LALQIQLIQLEQLQIKL
AQALKILLQLLIEQQQLKEEIL	AKALLQIQLILQQLQEIKL
SALKILLQLLIQQQLKEEIL	AALKLIQLIQLEQLQKEIL
QALKILQLLIEQQQLKEIL	ALKLIQLILQQLQKEI
QLQILDLQQ	YKLINCQL
EQQAEK	PSSCWD
QLQILDLQQQ	YKELINCQL
QLQILDLQQQ	YKELINCQLKN
QLQILDLQQQ	YKECLINQLNK
EQQAEK	PSCSW
QLQILDLQQQQ	YKELINCQLKN
NLTR	NSRLTN
SFLDP	RR
FEMRA	MLSFE
REERQTARQLDD	QLDDRTARQER
DFNLSEMRA	MLERSELNDF
REEQTARQLD	LDDRQTRQER
EDQKLL	EQVKLL
VEQKLL	QVEDKLL
YLVLQRLLDMMEIIKYKRILAI	KPIAIRLYIKIMELMLDLRVQ
FLLQRLLDMMEILRYKRILAMK	FKLALREYKIVKEQLELELFIAF
EILRQYTKRILAK	KIVKEQLELELFFS
FLLQRLLMMEILRYTKRILAMK	FKLALREYKIVKEQLELELFIQAF
VLQRLLDMMEIIRYQKRILAIK	LLARYFVKIKELELELFIQF
SAVRIITLAARV	SVNIAIGLIIAN
SAVRIITLAARV	SVNIAIGLIIAVNAI
SAVRIITLAARV	SVNIAGILIIAVN
SAVRIITLAARV	SVNIAIGLIIAVN
AN	TYKE
ER	SAGD
NLKM	LKMN
VAI	VIA
KSSAHLKLFE	KEERKY
ISQLIIVLF	WLIVLT
WLIVL	ISIQLIVILF
ILIIVLF	WIVLT
ISLIIVLFI	WIVLK
ISLIIVLF	WIVLT
ISQLIIVLF	WLIVL
ISLIIVLF	WIVL
ISQLIIVLF	WIVL
ISIQLIIVLF	WQLIVLT
IWLIVVLGTLGGSDLGASIKKKSDE	LIQIAVLFKKISLDSGFAMKSD
QEET	GQK
IPEK	EIP
MPVKA	TDMLQ
VKQ	MTHD
TRH	ATD
TTRH	DTA
ERG	RSLG
SREAILFRHN	FNRLEISRA
GTRGF	LAG
RH	ELNA
EKRQ	KQ
YPY	FFG
YPYQ	FFSG
YSYY	FFDSG
YPYQ	FFG
HFGYHS	RFISGGE
VQYQY	VDDVG
VQYY	VDDGV
RHNH	DRTAKN
NH	TDNA
NTEI	AGSLQ
SY	VSSRQVS
SY	SVQV
SYR	SVQVY
TAAG	TTSG
PMS	TSAKT
LQKQSLASKLKVLN	NLLKVKLASQSKLQ
REILE	ELEIR
EILE	LEIR
AEQR	RRE
AEQRT	EEK
EQR	EEE
AEQK	EKD
WGF	NASHLER
EFLKALSERRLEMLLEKLQQVEQNLAERCLINKLKVMNRLDEEMNALTKLEECLKILEL	FKMELLASERELRKMLLKQELVQQELNAERLCIKENLVNMLRNEEMLTKLEKLCIEDLET
REEMMKEFLKALSERLEKMLLEKLQQVEQNLARCLIKLEKVMNRLEEMNLTKLEECLKDILEL	REMEMKFKLLAERSLRMKLLKQELVQQELNAELCINLKVNMRLENEMLTLKEKLCIEDLE
YRLQL	PSLGWL
PMSLLELR	KLERLLSM
PLPF	PFLP
PLPF	PFPL
EFL	EFL
HR	QLNYL
HR	LYLN
EHR	LLYN
LDCPT	PY
LDCPT	Y
FPGCE	VVREW
PTL	ED
PTLV	DEF
KNPLALMW	EVSAIAAVLL
KPLALMW	ESVAIAAVLL
NLALMW	VASIAAVL
NLALMW	VVSVGAVLL
NLALMW	VVSVWAL
KNPLALMW	LVSVVWAL
NAKQE	LK
VLGHFY	HDHYMK
LGFY	DYHYVMK
HFSYPDPW	HDYHMK
FLQQSFSMWWIRFE	KTLTILMFLYF
FQQGELSMWWIRFDA	KIPFSICLLFYF
FQQGELSMWWIRFDA	KIPFSICVLLMFYF
KFYI	DGGTT
KFYV	STGDT
TLSLWYLQH	LHLTSFVYKY
TLSLWYLQH	LHLTFVYKY
TLSLWYLQH	LLTFVYKY
PEGGR	EPRGG
GLKTIK	GVYD
GEKGL	KGA
SQHK	EDGPNG
FGWK	GWKF
AALFR	RLFAA
ALFR	RLFAA
FGWK	GWF
LSR	LSR
DQKR	KQ
DQK	KQD
NRAS	NAR
EVKEE	EE
RQE	QE
PSD	SPD
ANKFL	TLNFA
MDDLE	KK
AVSF	FAKL
RND	DRNP
SHD	NQ
HDK	QNSHD
FEF	AV
VKRA	EFF
PTPT	SSDSRY
GADA	KA
HKD	RLD
EGEV	EGE
DNRSTN	QEE
LERENL	RTSEAS
QSE	ESQQ
QSQE	ESQ
VKQ	TFNRI
VKYQ	TFNIR
FVKYQ	FTNIR
FVYQH	FIRTN
VF	LATM
REGEN	QTLMDL
QQN	ERGLG
KDMFR	WYM
KDVFR	WLMY
WMIQAEQIAR	LMFSHTN
IQAEQPPSR	FLTHS
FLAQAAR	SISNMSN
FLAQPAAR	SSISNMSN
KRE	EGNN
AKGAP	LSYI
FNIS	NLNTL
RFNIS	NLNTL
RLF	QED
GKRLF	ELSPEQ
KRLF	ELSPREQ
KRLF	QELSPD
DFL	PLMW
SGYEQR	KLMDQ
GYKRR	EKMLEDV
GYKRR	EKLED
YHKG	NW
LQ	FDVK
IAIR	LIMKT
IAIR	LIMK
MMLM	AMTMKT
MML	AMM
INYHY	IYHYN
DKN	KNDT
NLMMLWTQERFEQSAKRL	NLMMLWTQKREFESKQALL
TLCENQLRAILLFQLFALVL	LTNRELIALLFQLKFAVLLG
RQKR	ERVAEST
RE	QAER
QAYD	DDNAAYQ
YERGH	AHKG
ILRNELTMEYKEEILFKEIRNKEAVLKIM	LILRENLTMYKEKEILKFNIERKAVKLIMK
NLRD	NR
RRNFRD	NR
RRFNLRD	NAR
RNRD	NR
RNFRD	NR
ESA	FHP
HFP	SAE
HTF	HSAE
EHSA	FHPT
HPTF	HSAE
EHSA	FH
THF	SSAE
PTHF	SSAE
ESAS	FHT
QNSILDSAN	TISPFD
ATAN	EHPA
QNSILSAS	TISPND
AARL	HTAA
AGRLA	HTAA
SPGA	SSG
SSG	SPGA
EDHG	GNN
R	TTGVE
AIFIE	SFKLTLA
YTNFG	FGYNT
FETIREK	EFTIREK
KNDQ	KQFQ
DRAK	AG
GIA	AIGP
IGPA	IGP
NGM	NGM
GTAE	REGGT
LKD	FAH
LRDRF	FH
RD	QKD
RD	AQKD
DFRD	RGV
DGLDFG	HGFGLD
AVAA	AVAA
AER	EAR
AKAAA	ARA
SVIS	TVVAA
SVIS	TVVKAA
KSEV	YP
VIIKELKVIS	ALETDYTF
SIVK	ALIAA
ISVK	LAA
AAGVT	DSISV
AGAVT	DSISV
LSG	LSVG
AKRK	NW
EDAA	TVYA
LAD	LLHR
MTAGADI	MRR
LAVD	QKKR
AVLKD	QKKR
TMGA	TKR
NTLC	QRK
AEQD	LLHR
EAQ	LLHR
FGSR	HKR
HPLYS	RDLH
NLTPDTDE	HALRQALK
TADMAGA	RKR
TAADMG	TKR
TAAMG	EK
TADMGA	TKR
TAAMGA	MTKR
LKDMAL	SRE
MGAT	KEA
MKAE	QKR
AQED	LHR
FDSGR	HKRG
TAGD	MLAGGV
TVS	DV
SQATL	VAAAK
IPPL	KTPPVL
PIP	KTPP
VPVEIM	KTPPY
VPVEIMDA	KTPPY
IPPLG	KTPPVLK
PIP	KTPPV
IPP	KTPPV
PIPL	KTPPL
AWITVRLDK	VVPSASALIKP
IPEPL	KTPPL
YVPQD	GIPPK
IPPLE	KTPPVLK
IPEVGN	KTPPK
KPILM	KTPPFL
PVIIKDAD	KTPSYK
IIPVP	KTPP
QLKVV	VVPL
PLMIG	KTPFLK
PVIMG	KFLK
AMVIP	KTPP
MVAIP	KTPP
IPL	KTPV
MVPAG	KTPY
PIA	KTPPYLKA
PIA	KTPYLK
PIAD	KTPYLK
IPVP	KTPP
PI	KTPPF
PKMLD	KTFK
PEIDA	KTPPY
VPEIA	KTPPY
VPAIGD	KTPPY
VPMAID	KTPPY
VPEMAID	KTPPYK
IPEFVG	KTPPVK
VPIDA	KTPPY
VPVEIDA	KTPPY
PIDA	KTPPY
IPP	KTP
IPIPL	KTPPVL
VPVEIA	KTPPY
IPPL	TPPVL
IPPL	TPPL
PVIVAMD	TPPASYR
IPPL	KTPPL
IPPLE	KTPPVKKSG
IIPPLE	KTPPVK
PIPL	KTPPV
VPVD	GVQ
IPVEIL	KTPPV
TVPVDMKAGQF	GVPPSQLKKGLE
IIL	KTPVL
PTLEK	KTVLK
PLPKG	KVLK
FTVVKIKEG	VVPSSITEPPR
PPL	KTPPL
WVCQTKLDG	VTSVASIRLKDKI
KPLIM	KTPPFL
IPP	KTPP
PVIP	KTPP
VPAID	KTPPYR
VPVEI	KTPP
VPVI	KTPP
VPVEIAD	KTPPY
VPVEAIM	KTPPY
VPVEAI	KTPPY
PVVP	KTP
PPLE	KTPLK
PVIPE	KTPPK
IPPLE	KTPPLK
PPLEK	KTPPLK
LRLGKE	MTGADE
EVQG	NK
R	AKPGRE
R	KPGRE
VQG	NK
TEIE	TLEDLKDVIK
VSETKLIEL	IEKLTVSEL
VSETKLIEL	IEKLTVSL
VSTKLIEL	IEKLTVSL
VSTLIELK	IEKLTVSL
MSVVA	VAMSV
SVL	KF
MSVAV	VAMSV
QRGL	RGHR
VRAA	KHRPW
RQAAR	KHRDW
VAQRA	KHRDWT
AAQRLW	KHKAEYT
RAAV	KHRPDW
AALW	KHKAY
AAQRLW	KHKAEY
AARQV	KHRPDWT
AQRL	KHKAEYT
VAAQR	KHRPDWT
RARFRLW	KHKAEY
RAQRFRLW	KHKAEY
AAQRL	KHKAY
ARQR	KHKAE
VAARL	KHRPDWT
AARLV	KHRPDWT
AAQRLV	KHRPDWT
AARV	KHRPDWT
RKG	YGY
RKG	YGYP
RKG	YSGYP
KG	TGHI
KGF	TGHI
RKY	GYQ
FPRVA	NTN
RWPG	GYP
FPRVAS	NTN
RKG	YSGY
RKG	YTGYQ
RKGK	YTGYQ
KGF	GHI
KKGF	GHI
RKGY	YGYQ
RKY	GY
KGY	SGRP
KRG	SGYP
WRPG	HGYP
RKG	GYP
KKF	TGHI
KKFG	TGHI
KKF	GHI
RKYVG	YTGYQG
RYKG	YGYQ
RYVK	YGYQGG
KRGY	SGYP
WHVMS	TAFNKT
WHVM	TAFNK
FRVAS	NTN
WMHV	TAFN
WMPHS	TAFN
KGRY	SGY
KRY	SGYPG
KKG	GHI
KKF	GHIG
KF	GHIG
KKGF	TGHI
KKFG	HI
KF	TGHI
FKG	HTGH
FKGK	GH
FK	HGHI
KFG	TGH
TRVST	NVN
FRVA	NTN
KGF	GHIG
KFGK	TGHIG
FKG	HTGHIG
KKFG	GHI
MHVW	NKTR
KGF	HI
MWVS	FNK
KF	GHI
KRG	GYP
WMHS	TAFN
MWHS	AFN
MYRV	LSNP
FRIT	WNHN
MWH	AFN
RYK	GYQ
GF	LNG
GFA	LNG
RIEL	PIL
RILE	PIL
RLE	PIL
YVR	MIK
RIL	PIL
YVR	VLN
YVR	MINQ
YRS	MVK
RILSE	PIL
KAMPTVTS	HRQNRNQEF
PMTS	NRNQ
KWT	QVTF
WTW	WVTF
WKTW	WQVTF
GVSRF	PDG
GVSR	PDG
GVSRF	PD
VRFGS	PDG
VSRG	PDG
EDGIT	PDG
GVSR	PD
VSRFG	PD
VSR	PD
SRG	PDG
DGVITE	PDG
VEDGI	RPDG
RVSG	PD
RGVSF	PD
RVSFG	PD
RVSFG	PDG
RVSG	PDG
EDGV	PDG
SDVG	RRPDG
VRFGS	PD
RFGVS	DG
RSVI	RRPDG
SVRG	RPDG
VS	PDG
RVSG	RPDG
RSVIG	RPDG
RVSG	RPD
RGVS	RPDG
VRS	PDG
GRTVS	PDG
GDE	RRPDGS
RVSI	DG
VGSRF	RPDG
VGSR	PDG
VDG	RPDGS
RFTGVS	DG
VDGS	RDGS
VSRG	PD
RVSIF	PD
RGVS	PDG
RFGVS	D
VSRFG	PDG
VRGS	PDG
RMKIR	HEL
RMKIR	KHEPL
KF	ALTD
RVFLVRASPYLR	GKYELQSDV
RVFLVRASPRL	GKYEELKQSDV
RVFLVRASPRL	GKYELQSDV
RVLVRASPRL	GKYEELQSDV
RVFLVRASPRL	GKYEELQSDV
RVFLVRASPYRG	GKYEELQSDV
RVFLVRASPYRL	GKYELQSDV
RVVRASPRL	GKYEELQSDV
RVFLVRASPRL	GKYELQDV
RVLVRASPRL	GKYELQSDV
RVFLVRIASPYRL	GKYELQSDV
RVFLVRASPRL	GKYEELQDV
RTVFVRASPRL	GKYEELQSDV
RVFLVRASPYRL	GKYEELQSDV
RVLVRASPYRL	GKYEELKQSDV
RVFLVRASPYRL	GKYELQDV
RVFLVRASPGLR	GKYELQSDV
RTVFLVRASPRL	GKYELQDV
RTVFLVRASPYLR	GKYELQSDV
RVLRVASPRL	GKYEELQSDV
VHFRIVEAPCFR	KYELKQDV
SPALG	QSDVL
VHIRGAPCRV	KYELKQSDV
IVKVITESPGFK	YEIKQSDA
RTVLVRRGSPLAR	KYELKQSDV
MKVRSMSLR	YELRQSDVR
NNAEEKRVSFTA	KYELKQSDV
MFLVRVVAPYG	RYELKQSDV
HVMRIAPCFR	KYELQDV
RVFLVRASPRGL	GKYEELQSDV
KLVIIKLVFER	MYELKD
RVFLVRIASPYGLR	GKYEELQSDV
FGG	PTGL
FGG	PTQGL
FG	PTQGL
FGG	PTQGEL
FG	PTQGEL
FGG	PTNQGEL
FGG	PTNQGL
FG	PTNQGL
GGF	PTQGEL
GGF	PTGL
GF	PTQGEL
FGG	PTGEL
YG	PVHHG
YGG	PVHHG
IGN	SKMMRI
IGN	SKRMMRI
IGN	SKMRI
IGN	SKQGRI
GNI	SKGRI
IGNG	SKQGRI
GNIG	SKGRI
GNI	SKQGRI
FG	PTQG
FGG	PTQGE
FG	PKQGK
FG	PTQGE
IGN	SKMI
IGN	SKRQGI
IGN	SKRQGRI
IGNG	SKRQGRI
IGNG	SKGRI
GNIG	SKGR
IGNSG	SKRRI
YQS	PKHQQ
KGY	PSK
GGF	PKSG
YGG	PVHHGVNQL
YQS	PKHQGQ
SGFGKQ	KPTG
GY	PNTAGRK
GF	PTGL
IGNN	SKQGRI
NVAL	GA
KLGST	PEVRMG
KLGST	PLEVRMGK
KLAGST	PLEVRKG
KLGST	EVKG
KLST	EVKG
KLHGST	LEVRGKGK
KLGST	EVRGKG
KLGST	LEVRGKGK
KLHGST	LEVRKG
KLGST	EVRKG
KLST	EVRGKG
KHKLT	LEVG
HKKGLAGT	EVRKG
KLGST	PLEVRKGK
KLST	PLEVRKGK
KHLGST	LEVRGKGK
KLHGST	LEVRGKG
KLGST	LEVRGKG
KKLGST	EVRGKGK
TGSS	QGG
KLGST	PLEVRMG
KLGT	PLEVRMG
KLST	LEVKG
KLGST	LEVRKG
KAHGGSS	AEKG
KAHGKVGSS	AETRKG
HKKGAGST	ETRSG
SSS	SGK
SASS	KTSG
KGLGST	PEVRMGK
KGLGST	PLEVRMGK
KGLGST	PEVRMG
KGLGT	PLEVRMGK
KLST	PEVRMG
KLGT	PLEVRMGK
KGT	VKGG
HKGT	EVKGG
HKKGT	EVRKGK
KKLGST	EMG
ALAST	VMG
KLGST	LEVKGK
KLHKGST	LEVRKG
KLGST	LEVRKGK
KHLGST	LEVRKGK
KHLGST	LEVRGKG
KGLGST	LEVRKGK
KGLGST	EVRKGK
KLGST	EVRKGK
KLHGST	LEVRKGK
KGLGST	LEVKGK
KHGLGST	LEVRKG
KHGLGST	LEVRKGK
KGLGST	LEVRKG
KGLGST	EMG
KKGLGST	PLEVRMG
GGHAST	KAVRKGK
HKKAAGG	AVRK
HKKAA	LAVRK
KAAHGG	AVRK
KLGST	PLEVRKG
KGLGST	EVMG
KGGST	EMG
KHGLST	LEVRMKGK
KLGST	LEVKG
KHLAST	LEVRKG
KKLGS	LEVK
KKGLGS	LEVRK
HKAGLGST	EVRKGK
HKGLATG	EVRKG
KHKLGST	LEVRKG
KKLAGST	LEVRKG
LGDRK	DVKR
RGE	ERRG
YRN	AERRG
YRNTK	AERRG
NRTK	ERR
QSDK	NR
RYN	AERRG
YRN	AERRGA
DKNK	NSR
EAPQA	KN
YTN	ERD
YTN	ERRD
YNY	ARRDG
NY	ERRDG
YRN	AERDG
YRN	AERG
TKNK	FRAGDN
RYN	ARRG
RYN	AERG
YNKK	FRAGDN
YTKNK	FAGN
NK	FRADN
NKK	FRAGDN
YNTKK	FGD
LP	GPGDG
TYTNKV	FG
YTNKK	FN
YN	ARRGA
YRN	AERGA
YRNLTK	AERRG
YTN	AERG
YRNTK	AERRRGA
YRNTK	AERRGA
YNRTK	AERR
YNRTK	AERRGA
YNRT	AERRGA
YRTN	ARDG
YNRTK	ARRDG
AVYHTC	RLKLAE
SHRK	KQGE
SHR	KQGE
VHR	LKQ
PHT	KLAE
AVYHTC	RLKLA
NVYRL	RMKLG
AVHTC	RLKLA
VHT	LKLA
HILQC	QIP
AVYHT	RLKLA
LMV	IYL
LMV	IYRL
LE	PYRLK
LL	VYL
RQTR	GIDH
DRIP	QDIY
RDPI	DNY
RD	DNY
RDPI	SDNVY
RDPI	DNVY
RDQNPI	KNPY
RDIP	DNVY
RDRPL	DDVY
RDF	DPNR
RDPI	DVY
RDF	TDPN
RDPL	DDVY
DRPI	DNVY
RDI	STNPY
TDRPI	TNVY
DRIP	DNVY
VFR	IVY
RKKN	KLQL
KNRKF	QL
KFR	KLQL
HAGA	REL
HGAA	RQEL
HAGAV	RQE
FHAG	RE
GAH	QEL
GANVG	E
LREE	LGIDH
NVQ	LV
LRE	LGIDH
LR	LGID
RNLAE	ELGIDH
RLAE	ELGIDH
RLE	ELIDH
TRIS	IQLQEQ
TRS	IQLQEQ
LRK	LDIE
RL	LIIE
TKR	FGST
TRSK	YR
KAY	TKSS
GH	RYRK
RGK	KVQYR
RK	KVQYR
RG	KVQYR
R	KVQYR
RRGSL	QRLL
YTH	GSA
HCVKDWFI	MKIKGRAR
KL	IEQPT
RVV	IKFT
KEFRQ	DLQAP
SIAL	GKYPT
KVKLS	IEQPT
KLS	IEQPIT
KRLVA	DVIKH
KRIQKVAS	QKYPLT
QR	KLRAP
VKQ	QPIT
VVTK	IKFP
KLRAA	DIKHPV
FRM	KLRA
KKLK	KEQPT
RSVVTG	IKFPLT
GQRIV	KYPT
KKAVL	EQPIT
RLRLAAATV	KHGQR
KAKK	VRPNG
KAKKKQ	VRPNG
KAKQ	VRPNG
KAKKK	VRPNG
KAK	VRPNG
KAKKQ	VRPNG
KAQK	IRPDG
KAQK	IRPDGE
KLAL	IPRG
KAKK	VPNG
KAQKK	IRPDGE
QAKK	VPNG
KAKKQ	IRPDE
QAKQR	IPD
AKKK	PNG
LAL	IPRG
KAKLKR	IRPDG
KAK	IRPDGE
AKRQ	PDG
AQ	PNGT
KIRK	LD
GHRSEH	TTESME
GHRH	TTESE
KGRKSAHR	VTEE
GHR	TTE
GHR	TTES
RESH	TSETE
DMRT	YRR
GRAS	KQDR
KN	SDRS
GAS	KQDR
GKYRN	RR
GRRM	KQPRR
DTM	SRR
NK	SDRS
RNRYK	SSDRR
NK	SDRR
RNM	NRR
NK	SARR
LPSET	VFLVTH
RLVSEYE	FIVNH
AVRK	QPSQ
RDLNP	IKIT
RD	IKAGV
LPETV	APAK
RPT	NQGQ
RRQGI	AGQQ
RNK	AAAGQL
YRSS	RKARKYE
TKAK	GRVDR
TAKK	GRVDR
STK	HM
RGK	YTTTK
NTGK	TTK
NTGRK	EYTTTK
NTGKR	EYTTTK
SGQK	TEK
GKSKQ	TEK
SQGKK	TEK
RTG	YYTK
WQK	TEK
WQ	TEK
LYSE	EIRFL
LYSE	IRFL
RLSE	ERL
LSE	EIRL
LESY	DKRL
IVYS	EMRFL
DYYEKD	RKKER
LRSEY	EVRL
EDDYY	KER
RLTSE	PREIRFL
IAEY	VRL
LMAVF	FMV
MALV	FMV
VWPAR	LMR
LKAV	FDMEV
LAWLT	IIL
PPLN	FCG
YLT	KAG
FNI	RGT
TS	RTG
QDS	MRKRR
AER	KASR
REAR	DK
EAR	ASR
KGTER	KRKRA
KGTE	KRKR
QKEIS	MVSQG
VNSG	NGVG
KADKGI	SGEG
IDGK	GVG
KIGD	NGG
IDGK	GVEG
KIGD	NGVG
KDGI	KGG
QAFELTIIQEGD	EGIQITLQAE
DKVAN	HSE
LIFK	RFQM
AMRG	TVL
GAMRG	ETVL
GFN	EM
NGF	YEM
KARVG	HFELR
YGK	RDSRE
YGK	RDSR
YG	RDSR
YG	RDSREH
YGK	RDSREH
YG	RDSRH
YGK	DSRH
YG	DSRH
VGLR	DRQ
VGRK	DAQ
VGLR	DAQ
FGK	KTWR
VGLRK	DAQ
YG	RDSRE
YGK	RDSEH
FGY	KTW
YG	RKDSREH
YGK	RKDREH
GY	KDREH
YGK	RKDSRH
GVR	KDARQ
YG	RDSEH
YG	RDSH
FGK	NTWR
FGR	ETY
YGK	RDSRH
YGK	RKDSE
YGKK	TRDSREH
GYK	KDSRE
YGK	RKDSREH
GYK	KDSR
VGLR	DAR
YGKK	RDSRE
YKK	DSRE
YGKK	DSRE
Y	RSREH
GVR	KDRQ
GVLRK	KDQ
YG	RKDSRH
YG	RKDSRE
VGLR	DQ
GLRV	DARDQ
GLV	DARDQ
GLV	DAR
VKGLRR	IDARQ
VGR	KDARDQ
GVLK	KDRQ
VGR	DARQ
GVLRK	KDAQ
GVLRK	KDARQ
GRKP	KQE
GVLR	KDAQ
VGLR	DARQ
YG	RKDSR
YGK	RKDSRE
Y	RDSRH
YGK	DSRE
YGKK	RDSRH
VGR	DAQ
GVR	DARQ
GLVR	DAQ
TVIPRKI	IPH
EEPFDNRIK	RNITITDT
DVPNEF	RNITNI
DVAR	ER
SER	RR
RTR	ARDS
RAN	YRYQ
NRA	YRYQ
RANE	YRY
GGGR	KT
AENR	YRYQ
EANK	FQ
EANK	RF
ANE	RFQ
NAR	YRY
NRA	YRTYQ
ANEK	FRRF
ANK	RF
ANEK	RF
EANK	FRF
EANK	FRT
NRA	YRY
AENK	FQ
KREKRFNRV	EVIILRKEK
NHFERY	RLIGCYRR
NHMFE	RLIGCYR
NHMFEPTRRY	RLIGCYRLR
NHFEY	RLIGCYRR
NVHFER	RLIGCY
HNMFEY	LIGCYR
NMHFETRY	RIGCYRR
NVHMFEYR	RLIGCYRR
NHMFEPRY	RLIGCYRRL
NMHFERRY	RLIGCYRRL
NMHFER	RIGCYR
NMHFERYR	RLIGCYRRL
NMHFERY	RIGCYRR
NHMFERY	RLIGCYRR
NMHFEYR	RIGCYRR
EMHFEY	LGCYRR
HMFEY	LLGCYRR
NHMFEPRR	RLIGCYRR
NMHFERR	RIGCYR
NHMFEPR	RLIGCYR
NMHFEPRYR	RIGCYRR
NHMFERYR	RLIGCYRR
NMHFEGRRY	RIGCYRRL
NHMFERR	RLIGCYR
NVMEFRG	RDICYRRGL
NMHFER	RIGCY
NHMFERR	RLIGCYRR
NMHFERRY	RIGCYRRL
NHMFER	RLIGCYR
NMHFERYR	RIGCYRR
EMHFERY	LGCYRR
HEMFEY	LLGCYRR
HMFERY	LLGCYRR
EHMFERY	RLLGCYRR
EHMFEY	RLLGCYRR
EHRMFEIYP	RLKIRAHRIRW
ERMHFEIYP	RKIRAHRRWL
ERMFHEIYP	RKIRAHRRW
ELRMFEIYP	RKIRAHRRW
ERMFHEIYP	RKIRAHRIRW
ERMHFEIYP	RKIRAHIRW
ELHRMFEIYP	RLKIRAHRRW
ELRMHFEIYP	RKIRAHRIRW
ELHRMFEIYP	RLKIRAHRIRW
ERMFHEIYP	RKIRAHRW
EHRMFEIYP	RLKIRAHRRW
ERMHFEIYP	RKIRAHRIRW
ERMFEIYP	RKIRAHRIRW
HREMFEIYP	LKIRAHRIRW
ERMHFEIYP	RKIRAHRRW
NHTMFE	RLIGCYR
HTMFEY	LLGCYRR
NHFERYR	RLIGCYRR
NHMFEYR	RLIGCYRR
NMHFERYR	RIGCYRRL
HEMEFGSIYPV	RLKIRAHLRW
ERMHFEGIY	RKIRSHRIR
NHMFEY	RLIGCYRR
NHMFEPY	RLIGCYRLR
NHMFERTYR	RLIGCYRR
ENMFERPYR	RIGCYLR
NHMFPERY	RLIGCYRR
NHMFEPTRYR	RLIGCYRR
HMFEPRY	LIGCYRR
NHMFEPRYR	RLIGCYRR
DRMVHFE	RLEIQCY
TEMFEPRY	LGCYRR
TMFEPRY	LGCYRR
AVMHFERFK	RIGCYR
NHFERY	RIGCYRR
NHFERY	RLIGCYR
NHFERYR	RLIGCYR
EYKMFEIYP	RLKMRLHRLRW
EMHFDKV	RMRMKL
AHFERF	RIGCYQR
AMHFEPRF	RIGCYLR
HEMFEMYL	LIRAHRVRY
NMHFEPRY	RIGCYRR
AVMHFERF	RIGCYQR
ELHRMFEIY	RLKKIRAHRIR
ELHRMFEIYPV	RLKIRAHRIRWR
EKMHFEIYPV	RKIRAHLRW
FE	RAHR
HKEMFEIY	LKIRAHRLR
KEMFEITY	KIHLRW
MHFERR	IGCYRR
NHMFEY	RLDIGCYR
NGHFEPTRR	RLDIGCYRR
NMHFEYR	RIGCYR
ENMHFEYR	RIGCYRR
EHGEFIYT	RAHRRWLHTKT
REHFEIY	KIRAHRR
REMFEIYP	KIRAHRIRW
REMFSEIYP	KIRAHRIRW
EMFEIYP	RIRAHRIRW
NMHFERYR	IGCYRR
NMHFERY	RIGCYR
MEFAPT	IY
NMER	RICYR
EMFAPEGY	RLGCYRR
EMHFERY	RLGCYRR
EHMFAER	RLLGCYR
EHMFER	RLLGCYR
EHMFERYR	RLLGCYRR
ETMHFAERY	RLGCYRR
NHFEY	RIGCYRR
NMFERR	RDIGCYRRL
NHMFERR	RLDIGCYR
DKMFEMY	RIKSHRLR
ETDMFEGPTRYR	KRDLGCYRLRRR
NHMFEPTRRY	RLDIGCYRLR
EMHFERY	RLGCYR
NHMFERRY	RLIGCYRLR
MHFERY	LGCYR
EVFMFPERY	RLGCYRLRRG
TEFMFPEY	RLGCYRLRG
EFMFEPY	RLGCYRLRRGL
NMFETYR	RGCYRR
EHFERY	LGCYRR
HFTMFPE	LLGCY
MHEF	LDLGCYR
VHMEFR	DLGCR
HFEY	LLGCYRL
EVHMERY	KRLGYR
EHTFMFE	RLDLGCYR
DEMVGHFERY	RLLCYRLRLP
HFERY	LLGCYRR
HFERY	LLGCYR
EHRMFEIY	RLKIRSHRIRW
NHTMFERR	RLDIGCYRRL
NHMFEPRR	RLDIGCYR
NHMFEGAPTRRY	RLDIGCYRLR
MHFERY	LGCYRR
EMFERY	RLGCYRR
EMFEPY	RLGCYRR
NHMFAEGPTRRY	RLIGCYRLR
NHMFEGPTRRY	RLIGCYRLR
MFEY	LGCYRR
NHMFERY	RLDIGCYRR
FHEPRR	IGCYRR
FEPR	GCY
NHMFER	RLIGCYRL
NHTMFER	RLIGCYRL
NHYMFER	RLIGCYRL
HTNMFE	LIGCYR
TNMHFERY	IGCYRLL
HFETYR	RIGCYRRL
MFEY	IGCYRL
FER	GCYR
FHEPTRY	IGCYRR
FEPR	IGCYRR
MFERY	IGCYRL
NMHFERR	RDIGCYR
EEHFSLGTYA	RKIRAHVRY
NMHFE	RIGCYR
NMHFERYR	RIGCYR
MHFERY	IGCYRR
HREMFSEIY	RLKIRAHRIRW
MFEPR	IGCYR
MFEPRR	IGCYRR
NHMFER	RLIGCY
MHFER	IGCYR
MHFEYR	IGCYRR
NMFER	RIGCYR
HNMFEY	LIGCYRR
NVMFERR	RIGCYRR
NHTMFER	RLIGCYRR
NHFERYR	RLIGCYRLR
NHMFAE	RLIGCYR
NHMFER	RLIGCYRR
NHMFAEY	RLIGCYRR
HNMFERY	LIGCYRR
NHYTMFERR	RLDIGCYRRL
NHYTMFERR	RDIGCYRR
FAE	GCYR
NVYITMFEPRRG	RIGCYRRGL
NVYTMFEAPRRG	RIGCYRRGLG
NVMFERPRG	RDIGCYRLLG
NMFERG	RDIGCYRL
NHTMFEPRRY	RLIGCYRLR
ETMHFERY	RLGCYRR
EHTMFERY	RLLGCYRR
EHTMFERYR	RLLGCYRR
NMHFER	RIGCYRR
IVGKEE	YSNA
IVGKEE	YSRNA
IVGKEE	YRNAA
IVGKE	YNA
IVGKE	YSNA
IVGKE	YRNA
IVGKEE	YSRNAA
IVGKEE	WRK
IVGKEE	YSRN
IVGKEE	YSN
IVGKE	YA
RDDH	SALYR
RDDH	AIPYR
RHDD	SAIPYR
RDDH	SIYR
RHDD	IPYR
RDDH	IPYR
RDDH	SIPYR
RHDD	IPYSR
RHDD	SIPYR
RDDH	SAIPYR
RDDH	AIYSR
RHDD	AIPYR
RDDH	SAIYSR
RDH	AIYR
RHDD	AIPYSR
RHD	IPYR
RDDH	AIYR
RDDH	SIYSR
RH	SALPYR
RDDH	LPY
RDDH	SALPYR
RDG	GSPT
RHDD	LPYR
RDDH	IPY
RDDH	ALPYR
DDH	FR
RDDH	TCY
RHDD	LPY
RDDH	IPYSR
RHDD	ALPYR
RDH	ALFR
RDG	GSKPPT
RHD	QSALPYR
FFVD	ADV
RDDH	TLYR
RDH	IPYR
RDDH	IYR
RDDH	ALPFR
RDDH	SAIYR
DVDH	AQR
PFILH	KT
PILHD	KTR
VANH	KLQS
ILD	KTL
FIDL	KLL
PIDL	KT
PIDL	KQTR
NET	RKY
VSSGQPI	KY
KW	QRVS
REEQ	QQPG
GAEEQ	QQPG
RGR	LYKV
RPGR	LYKV
RPGRY	LYGKV
RRGY	LYGKV
RRG	LYGK
RRG	LYGKV
RGR	LYGK
RPGR	LYK
YLRG	KGKF
LRPGY	YGKF
RPG	LYKV
RGRY	LYKV
RGR	LYK
YLG	KGKF
LRGY	GKF
YLPGR	KGKF
LPGRY	GKF
YLRPG	KYGKF
YLRPG	KGKF
LRGY	YGKF
LRPGY	GKF
KFNS	YNRY
RGRY	LYGKV
RRPG	LYGK
RGR	YKV
RRG	YGKV
RPGR	LYGKV
RRVGY	LYGKV
RRVPG	LYGKV
RRG	YGK
RRVG	YGK
RLGY	KYGKF
YLPG	KYGKF
LRGY	YGKI
LRGY	KRR
LRPGY	YGKI
LG	YGKI
RPGR	LYGK
RRVPG	HPLYGKVI
RLGY	KGKF
RPGRY	LYKV
RRY	LYGKV
RPG	LYGK
LRYG	KKF
RKPGR	HYGK
YLGR	KYGKF
YLG	KYGKF
LGY	YGKF
RPGR	YKV
RRPG	LYGKV
RYLG	KYGKF
YLG	KYGK
RLPG	KGK
RG	LYGK
LPGR	GKF
LRG	KRR
RRPGY	LYGKV
RRVPG	LYGK
RYLG	KGKF
RYPG	KKF
RYLPG	KYGKF
LRIGY	YGKF
GIRY	KF
RYLPG	KGKF
LGRY	GKFI
RLPGY	KGKF
LGRY	YGKF
RLG	YGKF
LRPG	GK
KEV	CHS
RGY	LYGKV
RG	LYKV
LPGRY	YGKF
RPGY	LYKV
RPGY	YKV
LGRY	GKF
LRY	YGKF
KRGH	KMEAM
TVEKKGKY	DNQSVKG
ALYR	RLGLL
YRLA	RYLSLL
LAY	GLL
CLRD	RH
GRME	KDVN
GSPLK	RDVA
NGSPKL	RDVA
NGSPLK	RDVA
KNGSPL	RDVA
NGSPKLE	RDVAA
VNGRPMR	KDVNQ
GRMKPEER	KDNQQ
NGRKPMR	KDVNQQ
NGRPMER	KDNQ
KNGPLQE	SRDPAQ
GNRKPMIE	TKDVNQQ
RGCP	KD
NGTKP	RE
KNGVPQ	KDVS
NGRPKMR	KDVNQ
GRP	KD
KNGRPMR	KDVNQ
NGRPKMER	KDVNQ
NGSPLE	RDVAA
RGPMEE	KDVNQQ
NGSPL	RDVA
SPM	KDVA
AFIL	DVN
QGRE	TVKIQHA
RPI	YDPGD
AKFIL	KDVN
GKNLK	KDVD
NGSLKPQ	RDVPAQ
NGSPLK	RDVP
NGSPMK	KDVA
NGSPKM	KDVA
FRVK	PLSYE
RRLT	QKLTER
VGSY	RRR
NYLWGFL	MEELYKI
NYLWLGFGN	MEELYVKNRIK
YLWLGY	YIKSRL
NYLWGFLN	MEELYVKIK
KNRLNK	QYG
QIRK	QFGG
QIK	QFGGG
QIRK	QFGGG
QIRK	FGGG
QVK	HFGGK
QRIN	QYG
QIIG	FS
QIT	FGG
QIR	QFG
QRIK	QFGG
QRIK	QFGGG
KQRI	QFG
KNRLNK	QYGGK
QII	FS
QRI	YFGS
KEERKIT	YKRYIPE
QINR	HFGGGK
QRINK	QYGK
KQI	QFGGGK
SERE	RD
RCEE	DSR
RCEE	DSRQ
DRS	PKY
DKRS	PKY
DKRS	PY
DCS	PKLY
DRSR	PKY
DCS	PKY
VDVSP	NVKGI
DAVV	ENDI
SDKVAG	RVD
PGT	PGT
RMVHD	HDMVR
RHS	NQSW
DREDAH	VEGE
ETQE	LQE
ILP	LPI
EQARS	QKSDK
RALGA	PQ
NLKQ	LQA
LQA	NLKQ
RSS	RASS
RSS	RSS
RASS	RSS
GKL	YGN
VLHM	INY
SRWP	WSRP
DTD	LHIRK
LHIRK	TDD
LNESELRD	RDELSLNE
LNESDELR	RDELSLNE
LSNEDELR	RDELSLNE
GEI	TTT
DGPD	PDD
QSKEL	EIQP
DDTWG	R
KDEQ	NK
KTMR	QEK
PSE	HAGE
EEITE	KH
TIVVHP	HPVVTI
RHL	LVI
GLRRD	LGF
GLRRD	GF
AKRK	LYDIL
AKRSK	LYDIL
QTY	NLVV
MSLVNLRYR	SYFVWLLGET
RSGK	LTK
IFKKP	YSGSVA
DRDL	KDDVD
PQLV	NRR
IRVTAEYNRDVC	CDRVNFYEARVTI
TIRVAEYNRDVC	CDRVNYEARVTI
RVTIAEYNRDVC	DRVNFYEARVTI
RYAV	NFYT
ATEKIDIDSAV	AVIDSDITEA
QNDC	DCQN
NVNFSQL	NFNVSQL
KDVQ	DQR
CNGD	GDCN
DVQR	NEN
KAQV	AQVK
ADQKKV	DAKQVK
QDE	ERRR
SNNN	QNS
NKKE	NSF
KRNKE	VDNSF
KRNK	VDNS
NRK	TTNS
RKSNK	DNS
QRNKK	DNSF
NR	TTDNS
NKRK	TDN
KRNK	VDNSF
NKRK	FTTDN
QRKNK	DNS
KRKQN	VDNSF
EHRR	HLEE
EHRDR	HLEE
DMV	NGDTP
QS	NDQQ
PVD	MGHL
GKR	RKG
EEKG	NDR
DDYS	HLE
RLRSA	FYSGDV
SGDVYF	SARRL
AL	KDYS
RLRSA	FAYSGDV
NDGA	DAK
DLMLEG	LEGMDL
LVMEDSHADVDD	LVDQFQILDR
GAK	RKG
KDN	KEKQG
EHPFAVILNSELHGA	HVVQNVRLVSARA
EHPFAVILHLGAQD	HVQLVRLVSARA
EHPFAVIELHLAQD	HVQLVLVARA
EHPFAVISELHLAQD	HVMQLVRLVSARA
EHPFAVIELHLAQD	HVMQLVRLVSARA
EHPFAVISELHLAQDS	HVQLVRLVARA
EHPFAIVSELLHGAQDS	HVVQNVLVSARA
VGTI	DH
ENGH	REH
LNGAD	LAVLVN
LKNGAD	AVELVN
KQ	LFGH
KH	MANG
GHQEFY	ERILAN
GEHQFY	EILN
NQGA	KY
KEYI	GKYEI
KEYKI	GKYEI
KYEI	GYEI
RGHN	LQNN
RSGP	KH
LPC	LPC
GKLLRE	DDGKR
LEGGTDE	KAMEGLGTDD
TR	FQRE
GPSFL	FRR
LQIRQAANVMQ	LQRIQNMER
KEKI	QL
QQQ	DEFS
MV	MVD
MV	MVDD
MVD	MV
KHFLIL	KVLGLLIQL
KHFLIL	KLGLLIQL
MVDD	MV
ERP	ATD
SECN	MV
TAD	PEP
EPP	ATD
TAD	REP
TAD	RPEP
ERPP	ATD
LTRFD	AQYTD
LTRFDH	AQYTD
RFTHHSEK	PACSILTAQ
RFTHHSE	PACSILTAQY
IINT	LNRA
RNAL	NITI
IIN	TNRA
IINT	TNRA
IINT	TLNRA
RWR	DQL
QTPE	DNRME
NQR	QEKR
YQQ	QPKR
HQRN	QEKRM
HQR	QEKR
YCQQ	QPKR
YQQ	QPEKR
FGVRL	EHPTW
YQHQ	QPEKR
HLIKN	IKNH
RDSPGRP	RNYFYH
RDSGRKP	RNYFYH
RNYKLR	SERGLD
YASLLVKQLNRELLENLEHLM	ASYLLQVLKENLRELNSHLLEA
EHP	KFD
VVLDK	VKDVL
NQL	LRK
AQRLRVQQLELQQLLYKHEYLQEALAQDANANEVLDLREVLELE	LLLEEELVELVDNNAADLAQEALEHYDYLKQQLLQLVQLA
AQRQLRVLELQQQLLYKDHEYLEAALQADLAVNLDLEREVLELELE	LRELLEELVELVDNLAADLAQEALQEHYDYLKQQLLQLVEQLARQR
LAQMQVQLELQDFQYYEEQLVEALQVNRAVNLELEEILELALES	SLLLAEERLIELVENRVANLVQEALEEYQEYFKQQLDELVQMAQQL
RPG	DGE
MKEVLFSLKTI	SFTDKMKELQ
CVSLK	QPA
PCVLAKE	GTQPA
AP	AKEPC
EFLY	KFYFL
EPCVSKA	ELGTQ
EPCAKV	TQAT
VESKE	QPA
TQPA	AKE
PCA	TQPA
AKE	QPA
AKECVE	QPA
EPCAK	ELGTQ
EKPA	GTQAT
PESK	LQPA
PCEVSFQTVGMYLVKPELQKFAEAYSEKLQLIKALLF	EVSFQVTYGKLMVPEEASYKSKQLPLKTEYF
PCEVSFQTVGMYLVKPELQKFAEAYSEKKLQLIKALLF	EVSFQVTGKLMVPEEASYKSKQLPLKTEYF
KLVWT	KLEFTLKEL
VGATGVMLAFQNR	FLVAQMLLKKVV
VGATGVLAFMQNRR	FLVAQMLLKKVV
VGATFV	FLVAML
VGAGTVLAF	FLVAML
VGATGVLAFMRRNQV	FLVLAMLLKQVA
VGAGTVLAFMRNRDVP	FLVLAQMLLKQKVA
VGATGVLAFMRNRD	FLVLAMLLKQKE
VLVTLLGYAAQRK	VMIIVMLQLMIKQ
VTLLGYAQKPNL	VMIIMQLIKQEA
VVTLLGYAQKPNEL	VMIIVMQLIKQEA
IVGIATMFLSWGRS	PILFVLQVVLKK
LTIAVW	MLLL
LTIAV	MLL
LTAV	MLLL
QDK	KNKN
NE	HFGY
ENATPL	RPTGR
ATPL	PTGR
NATPLE	ANGR
NATPL	PTGR
NATPL	PTG
ATPLE	PTGR
APTL	PTGR
GIDKPC	PCGID
GIDPC	PCGIDK
VSDA	HD
YRGC	PGN
HKGR	KGRH
HERE	DRWR
WRG	ERE
VGRG	GRGV
SVNSMEG	EMSVNS
QP	KEGR
DRRESVR	RDRERSV
QRSNGEE	ENGRSQ
QRSNGEE	EENGRSQ
DLR	ALPSPV
ELDELRS	RNGRQIQDKPSP
LNAER	AKG
VGTV	VT
VGT	VGTV
VTV	AVGT
VGTV	VGT
VGT	VTV
FSGAL	FSGEAVF
GAAL	FM
FM	GAAL
FSGEAVF	FSGAL
TLNM	AWGGS
HSDA	YNAL
QTLRY	RYTLQ
QLRYT	RYTLQ
RHWYIQ	AEHIRQ
PKTV	TKPTI
EKR	KER
RD	QDLPNA
RD	KQDLPNA
RERKE	DHR
GERG	KN
HK	IDAP
HPKS	IDAPA
VFTD	QLAAH
YIVFTD	QLAAH
DNDLYRNVPK	KRSSLGCHLD
HLDSKRSLGC	VPKDDLYNNR
NSRE	RENS
RNSRE	RENS
RQT	RDA
TSQV	SQTV
TASQV	SQTV
GYPTNVKVHLK	KHLVKVPTNGSY
GYPVVKK	KLVKVGY
NNG	TSN
HALN	QR
AALN	QR
LGELLV	NAGA
EQNQ	NEQQ
TKSTD	KVDAGE
TTQS	EVK
GEN	GNE
ENN	SEE
GQPA	QLSSP
QSS	VQS
PVQS	QSS
HKGD	KGD
VRP	TED
HKS	NEDQ
ESE	NNE
DAG	DAG
PAVQ	QS
QKE	LLSSP
EENS	HAH
ENS	HAH
PEILHV	SFYITHN
QE	KMGS
QMPQT	QWR
QEK	TR
ANRQ	YQQ
KHKSGITQ	TQISGKHK
KEK	KEE
QEAVAKGAKLLHNKEIQEAK	NQKLEQSEKQKEQELE
QEAVAGAKLLHNIQAQEAK	NKQKLEEQSEQKQLE
QE	RVTD
ADLS	TLR
QQTCKQS	WSQQCKQT
QTKCQQS	SQQCKQT
QQTKCQS	WSQQCKQT
QK	TGMN
NTGM	ETQ
NFL	NFL
WAQND	PAHNDK
WAQNDSI	PAHNDK
WAQNDI	PAHNDK
SH	QEISD
SSH	QISD
RDQ	GGTN
YTLGRQK	PRVTRFN
YTLGRQK	PRVTRFH
YTLGRRQK	NPRVTRFH
YTLGRQ	PRVTRF
YTLGRKQR	PRVTRFH
YTLGRK	PRVTRFH
YTLRGQK	PRVTRFH
YTLGRRQK	KPRVTRFA
YTLQGRR	PRVTRF
YTLGRQKR	PRVTRFH
YTLPRK	PRVTRN
NND	NND
VWGEGY	HSSL
VGWEGY	HSSL
ADTSD	QTH
ADSD	QTH
YSNEW	WNESY
GVY	HSL
ESKDS	ESSK
GPE	QNK
TEAKADSKM	AKTEMKASDL
EAE	SS
KSE	DKNR
IPP	VIY
IKHG	NAVD
KHG	NAVD
NAV	AV
REV	FEAR
KGGA	KAGG
ER	LALD
ER	LAED
RSLDAEL	SAALST
AEQWLFSR	LFAESGR
YY	AAGT
ESSR	ERDY
REDY	SSER
RESS	SERD
YQGLV	LGQYV
KVLERD	DRKVLE
ENKE	NEKE
TTENKE	TTNEKE
KQ	PREK
KGQ	PRE
TENKE	TNEKE
HYI	TLKS
YHI	TKSD
YHPI	QTLKSD
QDV	RDF
ATPSK	KGKD
NSA	KGD
EDTD	RRAH
RADEE	ERRL
PEHDY	LPAP
ERAPRP	KESGA
GIPSAAGR	EIAL
REAPRP	ESGA
VGIPSAAGR	EEIAL
EAPRP	EGNA
REAPPR	ESGAA
VGIPSAGR	EEIGAL
REAPPR	EAGA
REAPPRR	EAGA
ERAPRP	QEAGA
ERAPPR	QEGA
REAPP	DGS
EAPRRP	DGSS
EAPRP	DGS
ERPPR	KESGA
REAPRP	EGA
VSAMG	EIAL
REAPP	ESGA
AVGIPSAGR	EEIGAL
REAPPRR	ESGAA
AVGIPSAGR	EEIAL
AVGIPSGR	EEIAL
REAPRP	ESGAA
VGPSAIAGR	EEIGAL
SAIPGR	IGAL
REAPR	ESGA
AVGIPS	EEIGA
IPSA	IGA
REAPP	DTGS
REAP	DTG
VIPSA	EIGA
ERAPRP	KESGAA
VGIPSAAGR	EEIGAL
AVGIPSGR	EEIGAL
EPGRAR	ELIIAL
VGIPSAGR	EEIAL
REAPPRR	ESGA
VIPSAAGR	EIAL
ERAPP	KESGA
VGPSAI	EEIGA
ERAPP	KEGA
ERAPPRR	KESGAA
REAPRP	DTGS
VPSAI	EIGA
REAPR	DGSS
VGIPS	EIGA
AVGPSM	EIA
AVGMPS	EIA
AVGPSM	EEIA
AVGPM	EIA
EAGRPR	ELIS
REAPRP	DGS
REAYP	DTG
AVPSIR	EIGA
AFGIPS	EIGA
EPGRAR	ELIIGA
ISAP	IGA
GREAYPPRR	DITGSS
REAPRP	EGAA
AVGPSIAGR	EEIGAL
ERAP	KESG
AVIPS	EIGA
RAFD	KTIVRK
PQR	SWDY
RNS	GKFE
RNS	GKE
VKVIKITTSGS	FLVTFKETGDAV
KVVIKTIGTSS	FLVTFKEVPTFGD
VKVIKIGTSS	FLVTFKETFGD
VVKKIITSGS	FLVTFKEVGTFGDA
TTF	RSVT
DASAVF	RRKSNI
EREG	NKNEMK
EREGK	NAKNEMK
SILGAL	GTP
LFM	NIAG
SIL	GTP
FPILAFL	AGTLLLI
FPIMLALAFL	PAGTLLLIL
FPIMLALFL	PAGTLLLI
FPILALAFL	AGTLLLIL
FPIMLLAAF	PAGTLLL
AESL	FLIF
AEAI	LIL
TFGDMGVLF	SSKSLRGNYALIL
KYSEYVIT	LPHSF
AQELK	ELGY
RAQL	AEMGY
RQEL	ELGY
AQLEK	LGY
AQEKL	AKGIY
AQEL	AKGIY
RQSEL	FSKGF
AQL	ELGY
AQEL	ELGY
AQL	ELGIY
AQLK	ELGY
AQL	LGY
AQEL	LGY
RAQEL	ELGY
RAQLK	ELGY
LAQ	SEL
QAKL	LGY
AQRET	QSLG
ARLQ	ELG
KLARQ	AELY
KARQL	AELGY
MDA	PPGAR
MA	PGA
MA	PPGA
MDA	PPGA
MDA	PGA
MA	PPGN
MG	PPGN
FGV	PTIER
GFEV	NDPE
EEF	PTIE
FEV	PTIEL
FEQ	PTIL
FV	PTIEL
KLE	ER
GRPSG	RGIE
RGPS	GIE
STI	EEG
RARS	TG
ARS	TGA
RS	QEFERTG
RQAEREA	QEVAFD
GRDAKQ	EAFDDT
KADFTRQ	AAFQFLDT
KADFTRQ	AAFQFLDST
TVC	DLE
PCTV	DL
CTV	DLET
KVVS	GET
KMAAS	E
KEI	TVEF
KIE	TVEF
KIEI	TVEF
DRILSKQVKSGDTSSVEKQLEEQANAVMRAARIESLAMKKETEVELKRIGKELEQALLKIILQSASDIVV	RILNTIRNSEELRGKAIEQLEKARARLKKVEMDADQFRGYIEEKMLITYLFEKNTIEAVRVFQALA
GD	AILAVA
LQIE	NRQFL
QE	LDIVLP
IALGAVGLIASGPGVGQGTGAQEVAIQPEGKGARITLLAFEALTILVAL	AAGAVLASIGPGVGQTAAQAGIRQAEGKIRGTLLSAFMALTYGVAAL
IGLGLIGVSGTGAEVA	AALAGPGQTAQGQAILL
IGLGLISGVQGTGAVEAPEGRLLALMEAITLVAL	AAVLASGPGQTAQAGIAKTLSFMALTYGVAL
IALAVGLIGSGVGQGTGAQVEA	AAAVGLASIGPGVGQTAQAG
IALAVGLISGPGVGGTGQAVEGAR	AAVGLASIGPGVGQTAAQAEGIRQA
IGAAGGSGITVLS	IGATVAGAGTGII
LGVCAAMMGNAGA	GLAGMGAGVVN
GVCAAMMGNAGA	GLAGMGAGVVN
GVCAAMMGNGA	GLAGGAGVVN
GVCAAMGNGA	GLAGGAGVVN
GVCAAMMGNAGA	GLAGGAGVVN
VGGLAGV	GALAGTA
LGVARI	GAGQAGA
VGGLVAGVA	GALAGA
VGLGLAGVAA	GLALAGARI
VGLGVALGVAAG	GLALAGVARI
VGLGLAGVAAG	GLALAGTARI
VGLGVALGVAQGA	GLALAGTVARI
GAQAG	GVARI
VGGLAVGAA	GLALAGTARI
GLGVALGVAQAG	GLALAGTVARI
VLGLLGVAAA	MALAGTAIG
LGVARI	GAGVAGA
VGGVLAGVA	GLALAGTA
VGLGALGVAAG	GLALAGTARI
VGLGVALGVQAAG	GLALAGTARI
VGLGLVGA	GMAVLAGAI
VGLGVALGVAQGAV	GMLALAGTVARIA
VGLGLAVGAA	GLALAGTARI
GAQGA	LGVARI
VGGLAVGAA	GALAGTARIA
GGVALGVAAG	GLALAGTARI
GLLAGVRAA	ALAGTAI
AIGIGGAGIVA	AAITILTGIAAN
AIITTLGIAANS	GIAGGAGIVAN
IGIAGGAGIVA	AITILTGIAAN
GSSLAAAVIAG	ALGVVAWFSIG
LGLGCLGYGDR	GAAMLSGAGKSG
LGLGGLVGFGIDGRS	GSAFTGAYGKSICP
IAILISAYA	LGSLSAAA
LGLGLGGFGIDGVR	GSAFTGAYGKSGT
IAILAYSAVCG	GSAAAIVAGG
LGLGGLVGFGIDGVR	GSAFTGAYGKSGIT
AILIAYSAVACC	GSLSAAAIVAGL
LGLGVGLGFGIDGR	GSAFTGAYGKSG
IAILISAYAVGC	GSLSAAAIVGG
LGLGGLVGFGIDGR	GSAFTGAYGKSG
ASILSAYAACV	GSLSAAAVAG
LGLGVGLGFGDGR	GSAFTGAGKSG
IAILISAA	GSLSAAAV
LGLGVLGGFGDR	GSAFTGAGKSG
IAILISAAVC	GSLSAAAIVG
LGLGCLVGYGDGR	GAAMLSGAGKSG
LGLGGLVGFGIDGVRS	GSAFTGAYGKSVICP
IASILIAYSA	LGSLSAAAV
LGLGGLVGFGIDGVRS	GSAFTGAYGKSGT
IAILSAYAVC	GSLSAAAIAG
LGLGVGLGFGIDGVR	GSAFTGAYGKSGIT
IAILAYSAVAV	GSLAAAIVAQ
LGLGLVGGFIGDGR	GSAFTGAGKSG
IAILISAYAVCG	GSLSAAAIVAGG
LGLGLGGFGID	GSAFTGAYGKSG
IAILSAYAACV	GSLSAAAG
LGLGVGLGFIGDGR	GSAFTGAGKSG
IAILISAAC	GSLSAAAVG
LGLGLCGYGDGR	GAALSGAGKSG
LGLGLGGFGDGRVS	GSAFTGAGKSVICA
AILISAYA	GSLSAAA
LGLGLGGFGD	GSAFTGAGKS
IAILAYSAVAC	GSLSAAAIVAG
IAILIAYSAVACVC	GSLSAAAIVAGL
AILISAYAVCAG	GSLSAAAIVAGG
LGLGLVGLGFGDRS	GSAFTGAGKSGR
AILAYA	GSLAA
LGLGVLGGFIGDGR	GSAFTGAGKSG
LGLGVLGGFGDGR	GSAFTGAGKSG
IAILIAYSAVCAGV	GSLSAAAIVAGG
VGGLAGVAA	GALAGARI
GMALLAGTARI	VGLGALGVAGA
VGLGLAGVAAG	GLALAGTVARI
VGLGLAGVAA	GMALAGTARI
VGGLAGVAQAG	GLALAGTVARI
VGGLGVAAG	GALAGVARI
VGLGLAGVAQAG	GLALAGTVARI
VGLGLAGVAAG	GMALAGVARI
VGGLAGVAQAG	GALAGVARI
VGGLAGVAAG	GALAGARI
VGGALGVAAG	GLALAGARI
LGAGVA	LAGAI
VGLGLAGVAAG	GLALAGARI
GGALGVAQ	GLALAGVARI
VGLGVALGVAQAG	GLALAGTVARIA
LGAGVAQAG	LAGVARI
VGLGLLAGVAAG	GMLALAGARI
VGLGLVAGVAA	GLALAGTARI
GLAGVA	LAGTVAI
VGLGLAGVAAG	GMALAGARI
GGLAGVAA	ALAGARIA
ALGAI	GLGVA
VGLGLAGVA	GALAGTAI
VGLGLGVAA	GMLALAGARI
VGAAG	GARI
LGAGVAAG	LAGARI
GLGVLAGVAQA	GLALAGVARI
GGLAGVAQA	GLAGTVARI
GLGVLAGVAAG	GLALAGTARIA
IGAAGAGSGITVLSG	IGATVAGAGTGIIA
AFG	RN
AHV	RNPS
VHTGLNA	SRNPAL
HLGEN	SRNPA
ELAG	SRNP
VHLAN	SRN
MGVE	RNP
VLHAN	SRN
MGE	RNP
AHGP	RQPDL
EEG	ARQ
LGE	RQPD
GEE	ARQ
AGHP	RQPD
GL	RQPD
NHVVLA	RNPS
AGNHTLP	ARQPEA
APTNH	RQ
VHLNA	SRNPSI
RISG	SR
VLH	ARNPS
VHTN	SRNP
HVNGL	SRNP
RAKSG	SR
TG	AEDR
LVR	AGVG
RRGT	GAE
VQ	AGA
GGRF	ED
GVVG	SGA
VGG	SSGA
QQT	IGAG
NGG	DA
TQQF	IGIG
ARV	AGAE
VNY	VLR
QDSS	AR
NIGKY	RQ
IYLHF	VAVL
DQSSYH	RGSQ
GDME	RTIK
PGDEE	RK
EGMEE	ELVK
RRGVR	ELIVK
RRGGVR	YERTIN
MPGEE	RKV
RRGGVPR	YERTIN
DEGMEE	ERTIK
EGMEE	ELV
RVR	EVLIVK
RRGPGV	YERT
EAEMEE	QRFKK
EGPSEM	QERRI
QADMPG	DRYK
RRPGV	LERLV
DQGPAGGE	LERK
ADQMP	RYK
QGMPAGE	DEFLKQ
RGRGV	LERLV
RRPGGV	ERLV
QGMPAG	EELERLKV
PGEE	RIK
RVRR	EVLIVK
DEGMPGEE	ERVIK
EGME	ELV
RRGGVP	YYERT
EGMPEE	QERTKK
EGPASEE	QRERR
EGMPASEE	QREFRR
GFLA	AEI
FDLQAFE	KELKR
QF	LAIA
FASQ	DYQA
FASQ	DQA
FASDQ	DYQA
FSDQ	DYQA
GYAL	RL
NAT	TNAF
EVKRLVR	MNTFP
VWVRMEHKQMMVYSNDRHVRVRT	DKEYTKPVDAEYDLLLKMYGDMNTFNFTFED
LFD	NTF
LFDKFLVK	NTFFFD
EDTAK	FNFTD
EVDKA	FPNFTD
KLFKFLVK	NTFFFD
QFPSLIIFLMTFFVPY	RFTIYFGVYMSASFDRN
QFPSLIIFLMT	RFTPIYFGVYMSA
QFPSLIIFLTMF	RFTPIYFGVYMSA
QFPSLIIFLTFM	RFTPIYFGVYMSA
QFPSLIIFLM	RFPTPIYFGVYMSA
VEV	FPT
VEKV	FPT
IIVL	LVII
VIL	LVI
SSYDAP	DVSSY
QR	KDENA
PFTR	ERAW
LT	KAWV
NGF	TRWV
TSYR	VHKL
EFRTKA	KLWLR
PRTS	MRRH
DQ	PWEGDD
DQT	PWEG
VGPVR	LFD
NSGQ	QGSN
TSNEI	NRI
IN	SNT
TTSNEI	NESTIKE
KAE	WEK
QDNGD	RF
QPVYDK	QPVKDY
EPTLES	KPDFDKK
SVVGPC	PSVPCC
GSDSVEI	QEHY
PNNEER	QKDD
PDLIH	IHPLD
PLCIH	ICPLD
LQRFYLHE	ELQGVTLRQ
FTLRR	VAVFED
FTLR	VAVFE
REARNKEQQN	YFTRLREARN
SR	RHL
DNRET	QTI
PDIN	GAPD
ANDQ	LDIVQ
QRN	STHK
KSTH	RNQI
TLAAGRFEVEW	MLLSGTIKRNA
MLSLKGTRIN	TLAAGEVEWF
MLSLKGTRIN	TLAGEVEWF
TLAAGFEVEW	MLLSKGTIRN
MLFSLKGTRIN	TLAAGEVEWF
EAEEAK	KEVEAK
RRTGRNPI	EAENQ
RRRPQMSVF	EETNQEVSI
TRD	RRD
MTLFI	MALGSM
MTLFI	GMALS
MTFI	MMGSA
TFI	MALGS
NCR	PYQ
RNC	YEPYQ
RPN	YYERPYQ
ERRE	REDAGED
DDAGEE	ERR
SEQRHRM	RMHSEQR
RE	AGEDD
RRE	EAGEDD
SEQRHRM	RMHEQR
RRE	AEGEDD
DDAGE	ER
LKY	QAS
LKY	QSG
LK	QSG
NEVF	NEFLV
NEVFL	NEFV
NEVF	NEFV
GDYVLGLVK	KLVGYVLGD
YVLGLVK	LKVGYVLGD
TKKG	KTKGG
GFLL	REAR
SSKP	RLR
NTLN	QRRT
LNTLN	RQTR
LNTLN	RQRT
LNTLN	RQR
FQVTVLP	PVLFVT
QSEH	HQSE
QKLRTSLSAQVMMKELSD	LSDEVMKQLASSLTKQ
QKLRTSLSAQVMKELS	LSEVMKQLASSLTKQ
LENLKDLLKELTKKLAEQVMRLTEYLLH	NKELLDLKLKETLKAVQMRSLTYELLH
ENLKDLLKELTKKLAQVMRSLTEYLLH	NKLELLDLKLKETLKAEVRQMLTYELLH
LDPANRSGE	DPLNGERSA
LDPANRSGE	DPLGERA
PG	RTG
ER	DGCN
ER	DNGC
LRRRSD	RLRRSD
GIN	ING
KTINQE	GMKTAR
KTINQE	KGMTAR
TAGMRK	INKTEK
TINQE	GMTAR
KTINQE	KGMTAQR
KKTINQE	KGMTAR
TAGMR	INQTE
KTINE	GMKTAR
HETAF	DRG
WKQ	DVG
DRRYDSET	RRYDSET
NHTA	NHAT
YQEQNER	YQENQRE
DGVN	KLD
NHETAF	DGVH
ELR	RLRY
RQDDFRY	RRDRQD
RQDDRRY	RYFRDQD
ERGWR	RDSD
VKQ	VGRD
VDGVR	KQRV
TGSQR	QGR
RILNELMIVVRVDMSDNWGRAYF	YFIEWILPEAIQRGDN
VSLTFPNINISDNWGRLII	FRILVPVEAMRGDN
QRNET	RE
MIINEFDIIDTDTGRSIF	FIRWLIEAIQRNGD
SEKNLSY	RQDLAYE
KSN	KPA
GEQEK	SGDQEE
EPDSE	RRRQ
SVGDEQE	GQEKER
RRQ	QDKP
NQNI	KNQN
EM	QLKL
DKLL	KNLLDD
KLLD	DLKLD
DKLLDN	LKLD
RRREIE	YAK
MDDGTV	KATKNF
AENPTLNKREF	TNRLLCG
DCGSK	GS
FAEDIIL	FFLV
DCGS	GSN
HHQKLVFFAEDVGSNKGAIIGLMVGGVVIA	HHQEKLVFFAEDVGSNKGAIIGLMVGGVVIA
GVI	IVGG
GGVI	IVG
GYEVHHQKLVFFAEDSNKGAIIGLMVGGV	EGYVHHQKLVFFAEDSNKGAIIGLMVGGVV
IIGMG	MGIIG
GYEVHHQKLVFFAEDVSGAIIGLMVGGVV	GYEVHHQKLVFFAEDVGKGAIIGLMVGGVV
LFAED	VILK
YEVHHQKLVFFAEDVKAIIGLMVGGV	GYEVHHQKLVFFAENKGSAIIGLMVGGVV
LFDVSN	VILKNG
LFEDVGSN	VILK
IIGMGV	MGIIGG
NIIGMGGVV	GMGIIGGKSN
EVHHQKLVFFAEDGSNKGAIIGLMVGGV	EVHHQKLVFFAEDVSNKGAIIGLMVGGVV
FDV	LVKA
EVHHQKLVFFAEDVGSNKGAIIGLMVGGV	EVHHQKLVFFAEDVGSAKGIIGLMVGGV
QFADS	VLVIK
FAD	ILVK
EVHHQKLVFFAEDVNKGAIIGLMVGG	EVHHQKLVFFAEDGSNKGAIIGLMVGV
KILV	EDFL
IIGLMG	MGLGII
IIGLMG	MGII
GYVHHQKLVFFAEDVGSNKGAIIGLMVGGVV	GYEVHHKLVFFAEDVGSNKGAIIGLMVGGVV
KILV	EDVFL
IIGLMGV	MGLGII
YEVHHQKLVFFAEDNKGAIIGLMVGGVV	YVHEHQKLVFFAEDGSVNKGAIIGLMVGGV
IIGMG	MIIG
YVHHQKLVFFAEDVKAIIGLMVGGVV	GYEVHHQKLVFFAEDVSAGIIGLMVGGV
KILVV	DVGFLH
IIGMG	MGLIIG
YEVHHQKLVFFAEDVGSNKAIIGLMVGGVV	GVEHHQKLVFFAEDVGNGASIKIGLMVGGVV
IIGMGG	MGGIIG
IIGMVG	MGGIIGG
EVHHQKLVFFAEDVKGAIIGLMVGGV	EVHHQKLVFFAEDGSNKGAIIGLMVGGVV
KAILV	DVFL
YEVHHQKLVFFAEDVGKGAIIGLMVGGVV	YEVHHQKLVFFAEDVSGGAIIGLMVGGVV
EVHHQKLVFFAEDVGSNKGAIIGLMVGGVV	VEHHQKLVFFAEDVGSNAKGIIGLMVGGV
NKILV	AEDVGNFL
NKI	AEDF
YEVHHQKLVFFAEDVKGAIIGLMVGGV	HEVHQKLVFFAEDVNKGAIIGLMVGGVV
KAILV	DFFL
EVHHQKLVFFAEDSNKGAIIGLMVG	YEVHHQKLVFFAEDVAGGIIGLMVG
HQLF	VVGIL
HHQLF	VLV
IIG	GVVG
VHHQKLVFFADVGSNKGAIIGLMVGGVV	EVHHQKLVFFAEDVSNKGAIIGLMVGGVV
HHQLF	VGVIL
YEVHHQKLVFFAEDNKGAIIGLMVGGVV	YVHHQKLVFFAEGDVSNGAIKIGLMVGVV
HQLF	VVGLI
HQLF	VMVGL
HQLF	VVVGIL
KGI	VVG
GVV	IGK
HHQLFAEVS	VGVILKA
HHQF	VGL
HQLFA	VVLIA
HQF	VMGL
HHQLF	VVGIL
QLF	MGLV
HQLFD	VVVILGA
QLF	MVGL
HQLFD	VVVGLIG
VHHQKLVFFAEDVNKGAIIGLMVGGVV	VHHQKLVFFAEDGSNKGAIIGLMVGVV
AILVGV	AFQLHH
GYEVHHQKLVFFAEDVGSNKGAIIGLMVGGVV	GYEVHHQKLVFFAEDVKGSNGAIIGLMVGGVV
GEVHHQKLVFFAEDVGSNKGAIIGLMVGGVV	GYEVHHQKLVFFAEDVGSNKGAIIGLMVGGVV
ILVGV	FLQH
GVV	IGA
EVHHQKLVFFAEDVGSNAIIGLMVGGVV	VHEHQKLVFFAEDVGSGAIIGLMVGVGV
ILVGV	FLQHH
YVHHQKLVFFADVGSNKGAIIGLMVVV	GEVHHQKLVFFAEDVNGAIIGLMVGVV
GYEVHHQKLVFFAEDSNKGAIIGLMVGGVV	YEVHHQKLVFFAEKDVSGAIIGLMVGGVV
GAIVGV	AEFQLH
GYEVHHQKLVFFAEDVGSNKGAIIGLMVGGVV	YEVHHKLVFFAEDVGSNKGAIIGLMVGGVV
YEVHHQKLVFFAEDVGSNKAIIGLMVGGVV	GYEVHHQKLVFFAEDVGSNKGAIIGLMVGVV
YEVHHQKLVFFAEDVGSNAIIGLMVGGVV	GYEVHHQKLVFFAEDVGSGAIIGLMVGGVV
NAILVGV	DFQLH
GVV	IKGA
YEVHHQKLVFFADVSNKGAIIGLMVGGVV	GEVHHQKLVFFAEDVKGAIIGLMVGGVV
GYEVHHQKLVFFAEDVSNKGAIIGLMVGGVV	GYEVHHQKLVFFAEVGKSNGDAIIGLMVGGVV
GYEVHHQKLVFFAEDSNKGAIIGLMVGGVV	GYEVHHQKLVFFAEDVGKSNGAIIGLMVGVV
EVHHQKLVFFADVNGAIIGLMVGGVV	EVHHQKLVFFAEVGDSNKGAIIGLMVGVV
YEVHHQKLVFFAEDVSNKGAIIGLMVGGVV	YVEHHQKLVFFAEVDGSGAIIGLMVGGVV
ILVGVV	FLQHH
GYEVHHQKLVFFAEDVGSNKGAIIGLMVGGVV	EVHHQKLVFFAEDAGKIIGLMVGGVV
IMGVIA	IMGVIA
IMGVA	IMGVA
KGAI	VGV
QKLVFFAENVGSNKGAIIGLMVGGVV	QKLVFFAENAVGSNKGIIGLMVGGVV
KGI	VGV
EVHHQKLVFFAEDVGSNKGAIIGLMVGGVVIA	EVHHQKLVFFAEDVGSNKGAIIGLMVVGGVIA
PDE	QKYPT
QKYPT	PDE
QKPT	PDE
QKYPTD	PDE
QWEAR	TDAR
QWAR	TDAR
RPEE	ER
LGGPGGA	GGPGGLA
KILESFRPE	ERPFSVLIK
AGFPAD	ADPGFA
AGFPAD	ADPAGF
KAGFPAD	DPAGFA
LGGPGGA	GGGPGLA
EK	TQKQ
IPGDPR	ETAR
ETRA	IDPRP
SYRAEE	QAQAQG
SGDT	RS
KILESFRPE	ERPFSELIK
KVLESFRPE	ERPFSELVK
AFPAD	PADFA
AFPAD	ADPFA
SDIRSI	IQPVQ
AGFPAD	ADPFAG
AGFPAD	ADPFA
AFPAD	ADPGFA
AGFPAD	PADAGF
AFPAD	APFAG
NDE	NDE
SGI	KDL
SGIP	KDLF
ELVVYLKVLRNKLQRLEVVLM	KSLTVLVLENMDSLEALLVVM
DHWAIT	ITGADWH
DHWAITG	ITGADWH
DKAMI	MIAKD
DKAMI	MIADK
DKAMM	MMADK
AAVAE	AEAAV
NRNGWK	KRNGWN
NRNGWK	KNGWR
RNGWK	RNGWN
EPNG	KSD
PNG	SKKD
NRV	RDSVY
ENRVL	RYDSVY
RVTDLIMG	IVDLRR
RRVTDLIG	IVDLRR
QSRE	EDE
QRGY	FTPGR
SQRGYE	TRFRGAT
QRGY	FTPGRRA
YSQRG	RRYRDR
QKG	ELRER
QKGY	ELRER
SQKG	RELYER
QRG	QHTD
SQKY	RLR
EGIPDSQDKNHPY	RWMNSKKR
YEVLELLKAFLFRCYVQLQLAEEKLNLLAIKLTRLLE	YKVLLKELADFRFYVLQLQAKELNLLAILKLERL
VLLLKFLRFYQVLNQLAEKLNLLAQKLTL	EVTLKELLFDTFRCYQVLLQAKELLLAKLTRL
VTLRELLKFLRFYQVLNQLAEEKLNLLAQKLTL	EIVTLKELFLFRCYVLLQAKELLLAKQLTRL
GNQKN	QNKGN
KSGEI	DTD
SGEI	TD
QLKAINVGC	LCQVNGIA
LKADINVGLCLQ	LQVLCNGAIKLT
LKAINVGLCLQ	LQVLCNGAILK
LKADINIGLCLQ	LQCIGAINLKD
PQVRLQLDLAHLS	LSALLQDLVRPQV
PGKL	PGLK
PGKL	GPLK
LEK	SDE
KSDE	ELK
KPSD	EGLKK
KPSE	ELKK
GEGK	KLEA
ALEK	KEGDG
SL	SLL
HFPNFL	AMHDCK
LEKKGLTDWEQKWY	IQEPAV
MSSFVVSER	IVLNRRE
MSYSTFPER	IVLNKAE
Y	LVYAL
HLHKK	FEDLYD
HLHK	FEDLY
HLHKK	FEDLD
ND	YSPDGR
EFEFL	RFLFKW
KLFYE	YIFDQ
IFY	LFYKK
EKLFY	KYIF
ERGEV	ERVR
ERV	RVEVG
EQRER	RQER
GAY	LQGR
AY	QAGRL
SVGA	GE
YNAN	YGNA
YGAN	YNNA
GEL	AYG
SQGEL	YA
SQAGEL	YAG
GAY	LGE
FLSHAILGIIGRRL	FLHSAIGLIIYGRT
FLSHAILGIIGRLT	FLHSAIGLIIYGLRT
SSTG	DKT
VMPTA	PKV
EN	KESE
KESE	ENK
NKDQT	LRNK
KINEA	EIN
NE	KVN
PQCRCSDMRLNS	DFITDCFQCPA
PPQCRCSDMRLNS	FIDTCCVDFCQPA
PQCRCSDLRLNS	TDFICVDFQCPP
PQCQCTDVREKC	DITFYDCRQC
QCRCSDMRLN	ITDCCVDFCQPA
PQCSCEDRINS	DFTNDRCQCGQP
PPTCRCVDEVK	FGPSYDCIVRSRRRS
QCRCSDMRLN	ITDFCCVDFCQPA
PQCQCTDVRE	DITFRYDCCQCP
PQCHC	NFIADRC
PQCRCDLRLDS	DFIDDCVQCPA
QYIGN	QYIGNAY
EKT	KLGR
VIY	IYV
VIYF	IYV
VIYF	IYFV
VIY	IYFV
TITVETIAGKKTFSGDVS	KQTTVGDEITFAGKKT
NVVETIAGKKTFTGNVE	HKTVVGDETIAFGKKTT
GNVVDETIAGKKTFTGNVE	KHTVVGDETIAFGKKTT
NVVETIAGKKTFTGNVE	HKTVVGDEITAFGKKTT
NNN	ETD
DLIHATRITDK	KITDTRAIHLD
KHH	HHK
DRKR	DRKR
PGDAVQS	DKIKTF
PESIAR	ESPIASE
NARKSP	K
NARS	LK
VKYEIRF	LEKNFA
LKYNKY	KCLKYNY
TYR	RMTYN
QLHFQ	LQHFQ
QHR	QHR
QDDSE	QN
RSLNDEK	RDNKSE
QLHR	QHRL
QLHR	HRLQ
LKYNKY	LKKYN
NTYIPV	YNTIPV
QEWQD	KTSRY
QEWQD	KTKRSRY
LKYNK	LKCKYN
CLKYNAK	KLCKYN
SVDNK	RNRE
EMH	NSE
KNRDR	SHAGHD
LKYNK	LKKYN
LKYNKY	KLKYN
QLHQ	HQQ
KAKDLE	ETKK
RDTQ	DTRQ
LHQLEY	FANTQK
KTKSKE	FQPDL
QLL	RQLL
FKNP	QD
ESLRS	PELAESLL
KLE	FPSH
KDT	DKT
EWQD	SRT
EWQD	TSR
PVSLKLK	EAQGKR
RVKK	YIYNP
VPYK	WQSK
KIKN	QAVCN
DKIK	QAVNC
DKIK	QAVCN
FTPVY	AAG
AGLKD	RD
CTVLSLEKVLEEILNKLASEV	VTLLSKEVLIKELNLKAVE
ATC	DKL
LD	TAAC
CTVLSLEKVLEEILNLAV	VTLLSKEVLEIKELKLSV
LDK	TAC
AATC	DLK
GFVEQANTVLMSLEKVLEILNKLAV	FGVEAQVTLMLSKEVLINELLKAVE
CRGLVCRTHLQLAQFVEA	FEQLAQTLTVCRLCGN
NACGAVCVTLLEEAGDVQ	QGDVEAELVLCAGVACSE
ARGLVARTHLQLTAQFE	FVEQLAQTLTRHVALAGR
ARGLVARTHLQLTAQFVE	FEQLAQTLTRHVALAGR
QEATH	HAEFQ
NHASAAQKE	RLNLQEEK
ARGLVARTHLQLTAQFVE	FVEQQLAQTLTRVALAGR
EAAGAVEAVTLLELEAGVQ	QGFDVEAELLVLAAVEGAAE
QTQQAATHAASAKKEEGTTK	RHQQQEAHALASDAAKQE
RHQQTQKQD	QDKTQQEQHR
EAADGAVAVTLLELEAGVQ	QGFVAEELVATAVEGAA
ARGLVARTHLQLTAQFVE	FEQLAQTTLARHVLAGER
RTHQQTQKQDAH	QTQQAATHAE
ARGLVARTLQLTAQFVE	FVEQLAQTLTRHVALAGR
EAAGAVAVTLELEAGFDVQ	QGDVAEELLVATAVEGDAA
EAAGAVAVTLLELEAGFDVQ	QGVEAELLVLATAVEGDAAE
ARGLVARTHLQLTAQFVE	FVEQLAQTLTRHVALAGER
RGLVARTHLQLTAQF	EFQLAQTLTRHVALG
RGLVARTHLQLTAQF	EFQQLAQTLTRHVALG
SCRGLVCRTHLQLTAQFE	EFQLAQTLTCRHVLCGSR
AQTTLQQLTQSLAEQATVLQSLKVQAQQRILEEVLNELLR	QGATCTLQLQTQLSAEAQVCTLQLSVKQQALQIELVRELNLREL
NACGAVCVTLLEEAGDVQ	QGDVAEELVLCAGVACSE
TAS	SAT
QQL	QQL
HTKFS	LLNE
LKCLN	HTKF
LQV	LQV
TQK	ARTF
EDH	QRVCSS
RILEKVLKQNLATALRQVL	EILVRKLKNQLAATLRVQLK
ILVLKQNSLATALRVLV	ILVLKNQLAARTLVLV
RILEKVLKQNLATALRQVLKV	ERILVKLKNQLAALRVLKV
CRRRLTLQETQLEEKLEILQEKL	KIRLEVLNKKQLARTALVQLKV
ACRRRLTDLQETQLEEKLEEILQEKLE	AKIRLVKLNKQLAARTLVQLKV
ACRRRLTLQETQLEEKLEEILQEKL	RKACRIRLEVKLNKQLAARTLVKQLV
ACRNRRLTLQETQLEEKLEEILQEKL	AKIRLEVKKLNQLAARTLVQLKV
NAARNRDQADQEE	EAQDDRRAARN
ACRRLTLQETQLEEKLEEILQEKLE	AKIRLEVKLNKQLAARTLVQLKV
AACRRRLTLQETQLEEKLEILQEKLE	ARKACRILEVKLNKQLAARTLVQLKV
RLTLQETLEEKLEILQEKL	IRLEVKKLNQLAARTLVKQLV
LTLQETLEEKLEILQEKLE	IRLEVKKLNQLAARTLVKQLV
LTLQETLEEKLEILQEKL	IRLEVKLNKQLAARTLVKQLV
YVLERVLEQNLIELLY	VYLEVERLNQLILELY
LTLQETLEEKLEILLEKK	IRLEVKKLNQLAARTLVQL
RILEVLKQNLATALRQVLKV	EVLALSNQLVLRVLKLL
KYVLERVLEQNLIELLKYH	KVLVELNRQLILELLS
YLLERVLENLERLLQENLRIL	LYLEVERLKNLELRLQNRELLI
RRLTDLQETLEEKLQEILLEKLIL	KIRLEVKKLNQLARTALVKQLVK
DQATDED	RRRK
RRK	DQDDE
LTLQETLEEKLEILLEKLEIL	IRLEVKKLNQLARTALVKQLVK
KHLLEQVLKLHTTENLRKVLEEL	ELEHLVKQLHLTTNRELVKLELEL
HLLEVLKLHTTENLRKVLEEL	LEHLVQLKHLTNRELVKLEL
KRILEKVLKQNLATANLRV	RTQLLTEELKELIELLE
YQLTECLEKNLKRALAIK	RRNTQVLTNKEELQVSLE
TLQETLEEKLEILLEKLEL	LKEKLIVQLKVELAREYKS
NTQKVLTENRLQKVLS	NTQVKLTNEQLVKLS
NTQKVLTENLQKVL	NQTVKLTNELQVRKLS
NTQKVELTDNDLRRVLS	NTQVLNTRDLVSRL
LEKVLLKNLEEVLK	LEVLLNKLEVKEL
NTQKVLTENLQKVLS	NTQVRKLTNLQVKLS
NTQKVLTENERLQKVLS	NTQVRKLTNQELVRLS
RNTQKVELTENRLQKVL	QNTVKLNTELQVKLS
NTQKVLTENLQVLS	NTQVLTNELQVRLS
RNTQKVLTENRLQKVLS	QNTVLTNQLVKLS
QKLEEKLIQVLEVLAERYKSLA	KQLEKELIVKQLVELAREYKKSLA
QKLEQKLQEVLAENELLR	KQLEKQLQVLANLLR
EKLIQVLKEVLAERYKKS	KELIVKLVELAREYKK
EKLIQVLKEVLAERYKS	KELIVKQLVELAREYKKS
LEEKLQQVLKEVLARYKKY	LEKLQVLKVELARYKYK
VPCG	ICP
DRCPLP	EPR
HTKTFSIC	NHTTKFSI
KPD	KWM
AECRSGERSTR	RSTRESRGCAE
ENE	QIKK
GR	MGE
TGAR	KYG
TGAR	KY
ALDMGG	KL
AMGGT	PK
Q	LSLIEE
LSLIE	Q
Q	LSLIE
RE	ADD
RE	EDD
RE	LDA
RE	EDS
RE	LDE
VGTP	TPVG
RE	PDS
DETK	RDS
DET	RDS
RE	ADE
YEQI	RSD
RE	QDE
RE	PDQ
RE	ADS
RE	DPTD
QFLFILVGR	RLVGIFLFQ
RE	ADDT
HPDV	TREGLP
DLDV	KRESD
GTQ	REE
ADI	RREGSA
SDI	REA
DPDVS	KREGK
LDI	REKGRR
LDAG	REQP
PDVT	RG
TRPE	DAK
ESQELK	REQLSKET
RESQELK	EQLSKE
LSNN	NYE
MAG	MSIA
NQETPRT	NYFR
NQETPRT	NFYR
TDVIRPF	RYSYTDNAL
ESAP	SEAP
TSQK	KGQ
EPVI	KGKN
FFKIEFII	IIEIFSKFF
PQDR	ALWNR
DMP	MPD
PRLKQEI	IELKQRP
HKD	HKD
HKD	HDFK
QDK	QDK
HKD	HDK
HKDE	HKDFE
GQ	QGRT
HKDE	DKEH
HKD	DKEH
QDKAD	KQDT
QDK	DQK
HKDF	DKH
HKDF	HDK
HKDE	DKH
QD	DKQ
QDK	DDQ
HKDE	HDK
TQDKA	KQD
KKKYSSE	SEYSKKK
PTQQR	KNSE
HDR	HDR
NATDR	KREE
SEKN	TQQRPE
HEDR	RRSGS
PTQQR	NES
PTQQ	NESK
SRRD	HRE
SSRR	REH
PTRTSR	TELE
EELT	TRTRSP
PTRTR	TELE
EELT	TRTRP
EEER	SRKSC
EDEER	SRKSC
PTRTR	TELKE
TNPR	QAE
YRDEDL	QKEK
RQAQDYR	ADYQQR
RQAQDYR	ADYQQRR
STKGMMAE	ATLRDAR
TLSGNRD	ALTRDAR
TLSGNRD	ATLRDR
NVLAK	ELQN
RDRATL	SRDGNTL
TLSNRD	TLRDAR
RDRATL	DGNRSTL
RDRATL	SDNRGTL
TRDRATL	RSDNLGT
KNQNM	QNMKN
NGN	NGN
LWLTH	HWLT
WLTHI	LHWT
WLTHI	LHWTI
LWLTHI	HWLTI
WLTHI	HWTI
LWLTHI	HLWTIL
VLQAQFR	LLLE
REERE	DREEER
LQAQF	LLL
INNAF	LAES
KTINNAF	SEVDY
QL	DKG
TLRG	KDRDL
TLLEL	LLETL
TG	TGR
TGR	TG
SI	YRRI
NHR	KIE
FDLDTKL	HSFEYL
FDLDKL	HSFGEY
FDLDKL	HSFGEL
FDLDKL	HSFE
FDLDKL	HSFEYL
FDLDKL	HSFGE
NRR	EIE
NSR	AIE
YK	NGIK
VLGR	RVLG
LILAIS	IAVVF
HN	IDGNDA
FGHGKES	FSGP
RY	DRT
LIQVSILQKMKIILLGIKLEAIVLTINILLT	LIQEVIELDQMSDIIALLISNSLVILLICNEIAL
LIQVSILQKMKIILLIKLAIVLTINILLK	LIQEVIEDQMSDIIALLQISNSLVILLICNEIALE
LIQVSILQKIILLNILAIVLTINILL	LIQEVIEDQSMDIIALLQNISLVILLICNEIAL
LIQVSILQMKIILLGQNIKLAIVLTINILLT	LIEVIELDQMDIIALLQNITSLVILLICNEIAL
YWIVM	MVYWI
IVM	VIYW