R-L	DY
R-N	Y-Q-S
NKG	GH-F-Y
PK	T-S
P-K	AY
G-T-K-D	S-GGS-Y
Y-K-Y-L-F-KG	D-YGDYVGR
K-T	SDY
T-E-T-E	GHGF-R
N-E-L	GYG
TL-QN-E-M-E	TITSGGTY-Y
L-T-Y-E-T	SLAGN
G-M-K-A	SGY-Y
F-R	L-N-ES
L-G-F	GYS-T
R-L	GY
S-R-G-W-F	DYYDST-Y
R-MSI	H-D-Y-N
A-S	L-Y
M-A	A-N-E
SIR	Q-TNED-Y
Y-R-I	DDF-H
NA-S	YGV-A
R-E-HD	HSN-Y
H-F-AE-D	GSRVPL
F-D-R-D	H-YWD-D-R-P
H-G-DS	R-R-YE-N
N-E-A	W-N-P
S-A	N-H
PS-NK-E	AIY-N-DTS
N-S-S	S-Y-W
Q-R	FWS
GK	GY
D-G	WGD
Y-T-N	RDYR
SV-I	SV-SY-Y
I-K-P-E	YHSY
H-F	SYY
T-AG-NV	W-Y-S-NTE
H-A	SED
V-A-F	Y-D-Y-H
F-L	F-L-Y
F-AE	S-ST-V-W
D-L-F	RYSMS
F-ED	Q-NS-S
FF	AS
F-LK	G-DY
KL	W-D-F
QV-L	T-A-H
F-L	IISY-KKY
VQ-R-L	SIAAAR
R-K	W-D-W
E-R	FT-S
H-E-R	SYSMN
R-D-E-LV	SISSSSSY-Y
R-F-Q	Q-GA-W
L-N-W	QSNRA-A
S-P-T	GTY-H
SR-Y-R-W-R	YPAGGATYY-K
L-VF-S	WWAWP
N-G-D	W-ST-I
K-I-D	HYSP-W
L-I-T	NYG
T-K	W-NTN-E
I-NT-W-K-I	EDNFSL
Y-T-S	S-SH
SR	I-Y
K-S-KK	WSTF
D-KK	Y-YIN
SRS-K	YDGS
A-N-K	GQSF
G-N	T-T
S-D	SSW
T-D-S	E-HN-H
DS-T	YG-Y
Y-H-E	V-NH
H-QR	WSGNPW
Y-S	R-T
N-Y-Q-R	T-SGG-H-YY
S-SN	GDG
A-E-H	RSNW
AG	TY
S-R-Y-E-Q	IIF-K-H
D-AA-S-H	SGSPF
E-Q-D	GTWL
QK-N	A-TSLAD
L-W	F-L
Q-I-H-VD-T	PKGYFPYDY
HT-Y-L	S-FLYS
R-F-E	EV-FS-G
E-F	KS
E-LD-R	RLALVR-W-Y
DS	SR
R-AS	SD-ST
R-WG-G-KA-D-R-Y	R-YYDST-YYPDS
QD-H	GYNY
TH	Y-DIH
A-V	S-A-Y
V-D-P	HYS-N-Y
H-LF-T-C	RLRT-RN
YIIQ	HYSTPW
K-I	SYA
I-F-WD-E	TISSGGSYTSY-K
I-Y	QDY
N-T-A	Y-EF
NA-G-I-G-D-G-E	W-KRWGAVSYARQ-Q
K-K-K-N-A	ARDYYNW
HH-PL	QVISNY
Q-IH-Q	YENL
H-N	S-Y
PS-Q	Y-S-GAS
N-A-I-P-K-Q	GTFYYYF
E-H	Y-Y
A-T-N	DIQ
T-G-A	F-EE
N-G-D-I-GS-DG-N-R	W-NRHGAVNYPRR-Q
KA-N	DDW
N-GH	Q-GDN
Y-N	Y-Q
YN-R-S	SNSW-Y
N-L-K	SDY
DGN-R	Y-SYSGS-Y
S-K	WD
T-AG-I	SNRWPF
Y-Y-R	S-W-H
G-Y-R-P	E-ISY-R-N-E
R-YP-T	ERGDG
Q-LR	TGL-H
RL-T-T	Y-TYY
RL-G	EYY-YT
Q-P-Q	RLHA
SV-T-D	EV-GYS
M-T-N	SGY
N-A-KD-S	EYYSVTDY
DE	EI
E-E	Q-Y
WED-R	SLSASY
F-KM-V	SGGYY
R-V-D-N	Y-Y-S-N-Y
V-R-NK	LDGYT
N-TN	YNNW-W
A-DG-I-G-AG-S	Y-ANGRPDYAG-R
D-T	RK
K-N-T-A-T	GTAGSLL
R-Q	H-Y
AN	Y-T
N-V-A-G	RDYR
EL-P-L	YDCN-CH
GL	PMN
L-E	GIG-S-N-W
GLL	GLYN-YT
E-H	R-SQ
Q-E-K	GTD
R-T	SN-D-Y
A-P-R	SYW
T-A-L-G	M-H-E-R
R-P-G	L-PGGT
N-GG	Y-EF
NA-G-I-D-G-G-S-T-D	W-KRGGAVNYARP-Q
D-V-T	RVY
K-KAN	DYNW
VI	N-F
P-W	YDKL-P
E-L	Y-S-YTN
Y-W	FW-G
G-SP	NY-F
W-S	SKEV-L
W-SGG-P	T-SSGG-N-Y
P-D	L-Y-Y
SK-H	S-Y-Y
T-S	T-T
S-P-V	DYT
V-H-T-F-T	NPNSG-SIY-Q
H-G-K-Q-L	VRSK-R
HN-K-L	LGPSYD
G-K	GNN
K-N	Y-Q
Y-G-R-S	SNSW-Y
W-L-K	SAY
R-G-W-D	Y-SYSGS-Y
KK	WD
I-Q-R	EKY-Y
FY	T-GGTFF
RK	SYW
F-RK	F-Y-D-D-R
IR	L-ANRGGG
V-A	Y-N-K-Y
N-K	W-S
DQ	SSS-SY
D-K-G-I	PRAT-YS
D-T	Q-Y
P-PG	FSKL-Y
L-K	A-S
K-L-G	RYD
K-P	SG-Y
A-L-L	GLLYY
R-V-F	SLYA
G-Y-A	YINY
Y-L-L-Y	TRDTSK-F
F-GL	GVDYF
I-Q	DY
Q-H-K	FVFFLPY
S-I-Q	TYR
S-TF-N-NR	YPGN-DTT
I-GD	EGIPQL
WG	H-D-Y-E
W-L	F-GS-V-P
LN	T-A
F-EN-L	TISSGGSYTY
W-NL-L	HPPTVGDAM
T-P	D-K
HA-T	EV-GS-R
D-F	RNY
T-A	YS-GS
VP-Q-NP-H	TVWYYTS-T-YDH
V-NR	AGYDVH
R-N-N	QSYDRSSG
N-GY-N	Y-GGS-Y
K-R-G	EGRGD
N-I	Q-Y
I-NS	YGST-L
Q-H-V	GD-Y
SV-L-Q-E-K	Y-YYS-STD
S-L-K-I	IFGVG
IGS	Y-L-R
I-Y	Y-IS
H-PI	YW-N
I-K	M-E
I-I-S-A	HF-DY
V-V	Y-Y-N
G-V-G	LQGTHYPV
I-V	AYY
G-V-V-I	LYSL
P-M-T-EH-V	SVSSTY
E-R-Q-N-S	GASSR-T
R-E	GSG
E-VI	YGSS-R
T-N	SYS
E-L-Q-Y	DPIAA-Y
L-E-S-H-E-R	S-YYSG-KNL
E-R	GI-Y
E-E-S-R	Y-YNS-GTD
E-K-V	RDYGTY
H-A-T	H-IGL-R
PD	GHY
P-P-D-KA-YA	E-K-SPNYHP-K
P-P-F-P	NWPYL
K-E	D-Q
K-N	R-D
T-N-E	QY-ET
N-N-G-G-I-S-D-G-N-G	W-NTNGAVNYAWY
G-G	RRS
K-D	RSEW
MR	SIE-W
M-L-G-P-A	H-AGYS
CA	Y-D
T-S	DN
R-V-F	NNYA
A-F-E	Y-NY
F-GL-A	GYDYF
RP-V	DIGNY
Q-W	Y-R
VPE	GGTN-W
S-H	T-G
E-S-D-A	WGD-N
H-VV	NYYG
R-D	D-D-Y-N
DA-R	WQGTHF-R
FE	GMS
EF	SIR-Y
FR-D	Y-GSS
DD	S-S
R-E	SYS
H-D-R	Y-YTSY-K
D-D-E	YWRW
M-P	Y-Y
P-P	YTSSS
A-E	SYW
P-R-S-H	W-SYN-N
P-CH	EGDG
Y-T-S	S-SH
SR	I-Y
RW	SG
K-KK	WSTF
R-D	YDW
K-H-K	Y-YIN
G-S-S	YDGS
FI	Y-H
IF	F-L-Y
T-Y-M	NYA-N
F-M	EG-D
I-S	L-Y
S-ID	TLHS
P-E	T-T
P-T	GFW
L-C	GN
R-Q-T	KS-R
C-W-D-I	YSN-VD
P-K-SD-N-G	YSTNQ-Y
GP-S-S	YYSY-R
QN-S	SYV-H
S-N-L-SP-G-T	Y-NYN-GTD-K
S-NQ-Q-G	E-NYAT-A
N-L-E	T-TI-F
T-P	W-S
I-V-NT	L-N-NGGTS
Y-V-T-E	RYGR
I-I	NG-Y
A-G-G	Y-PYV
R-P	W-S
R-P	N-Y
P-RK-IHI	E-YD-LEYYYDYY-M
K-KD-A	N-GSYY
K-K	ED
T-KN	YDD-F
T-S-D	Q-RSK-Y
T-K-D-N	YPFY
Q-HA	GY-Y
T-A	Y-IH
A-F-V	GA-Y
PT	H-S-N-Y
FL-E-T-D-H	RLRT-RN
H-F	GT-W-W
R-F	DYDMS
F-D-R-T	GILGG-ER-Y
S-G-P	H-SPGYT
M-A-R-SL	TSSY-Y
R-F	Y-SN
R-S-Q-D	SWGI-R
DH-R-E-F	NDY-ITN-K
DH-R-R	WISDF-D
N-L-WL	D-GIS
N-L-QA	HNSA-Y
A-Q-NR-T	RN-NYQ-Y
NQW	ESYYG
V-S	NFP
E-D-S	SD-GGN-Y
I-G	DSY-F
G-R	NNED-P
R-F	R-CYE-S
R-G-F-P	E-HMYT
F-D-S-P	QV-GYS-S
P-I	TY
P-K	L-S-N
K-I	N-R
I-P-F	T-R-WF-Y
KD-K	ASDY
KK	ED
V-LF	Y-S-W
D-Y	S-W
F-D-K-L	I-YGD-D-K
FY-H-K-V	L-YYHDSSGYY
Q-PT-V-N-I-H	QS-LYKS-K-Y
H-T-S	YYSI-R
GS-SP	ADDYD
S-G-N	SGN-H-Y
NN	FWS
G-Y	K-S
Y-N	S-W
NQS	E-F-S-N-N
E-Y-I-V-S-N-N	R-FYSYG-YY
H-T	L-Y
DE-M	Y-IRYT
F-M-P-N-I-K-N	EVQL-SGFK-K
YF-D	DTS-H
K-I-F	SSN-L
YF-L	S-HF
IGD	LGS
D-A	SRSG
IR-H	YGM-F-E
N-AG	Y-EF
N-T-W-N-D-I-G-R-GG-S	W-KRLGAVSYARQ-Q
K-N-K-K-N-A	ARDYYNW
TI-C-C	TS-Y-F
I-GP-V	SREL-W
I-S-H	Y-N-Y
H-Q-P-P	HRGN
R-E	TSS-Y
RN-R	SWEIP
N-W-L-P-E-G-G	WWSASKYY-K
S-ET	Y-GGY
E-SD	VHSN-Y
H-EA-F	GSHV-L
FR	H-WWD-D-S
HD	R-HT-D
VG	NY
M-V-P	HSYSSG-I
VD	NYG
G-D	SISAG-DK-Y
A-V-D-AM	TSRVYF
E-LQ	DSIGK
K-FK	LGSYF
R-K	DD
F-PK	FTHNS-V
F-I-K	Y-L-YY-D-K
F-R	WYGG
SY	W-S
PT-H	WN-GS
N-K	N-D
E-DK	YDEF-L
K-F	T-T
K-E	D-N-H
M-W-Y-L	Y-YYN-G
E-A-W-H-E	R-YRYD-F
IR-I	YGV-SF-E
RY-H	SVSSY
H-N-G	RSNW-Y
YD	GPS-F
H-E-H-R	E-NDA
N-E-F	YANY-W
F-E-N-Y-L-D	W-NTHSGV
LG-R	LTS
F-N-L	I-YGNN-V
DPN-R	N-RT-Y-T
RT	Y-L-Y
RL-L-T	Q-NYNY-L
V-Q-E	D-Y-H
E-T-V-E	R-DP-N-YTK
R-AK	Y-SY-DD
WF	R-R
K-W	N-W
F-G-W	R-T-GE-S-D
W-W-KI-T-F	KYYDFWSGYPPG-E
E-H	VHSN-Y
F-A	ASLV-L
F-D-R-E	H-YWD-D-R
H-S	R-R-YE-N
SL	L-N
IP	HWNY-L
R-F	DD
I-ES	WGGGS-Y
SS-Y-H	DGHET
S-T-N-H-D-R-D	ES-DSYGHSF
TH-N-I	GNEV-F
S-L-T	D-Y-Y
E-KL-R-T	SDGGSYTY
TH	Y-YD
K-D	DTD-Y-N
IK-S-I-N-I-I-N	RGHFYGSG-W
V-T	N-K
LI	L-I
I-T-L	W-M-V
C-GS	DYY
S-I-G-IW-L	DDGYYDR-YY-VD
E-S-DR	SGN-K-Y
KD	DYTY-L
Y-D-S	TYW
S-L-TR	LPGS-S
K-K-VF	SGYYGN
AP-D-R	H-N-K-Y-E
R-D	Y-Y
RP-P	F-GS-V-W
AP	Y-N-N-Y
A-RT	QYYGF
KA	LLIY
KP-L	NRAT
ES-D	IT-S
DP	NSG
P-P	IWY
PD-K-L	ND-DY
Q-A	T-T
A-G-R	NYG-N
R-D-N	EGG-N
L-Y-F-C	YRYS-R
D-S-L-E	NYA-H
L-E-K-ER-K	GISRS-GDID
E-C	GGFGS
H-PA-A	GNTLPR
APY	Y-Y-K-K
HW	GSY
K-Q	LGDKY
Q-K	QD
F-A	W-N
F-L	GFI-F-TAM
L-QYF	PLSRG-Y
LK-FE	YGNF
E-R-DH	VHSN-Y
FE	SSHV-L
FR	H-WWD-D-Y
HD-R	R-T-D
K-N	D-S-Y
K-I	L-Y
S-E-QK	Y-RLHS
S-W	GNTL-R
Y-R-W	SYT
WE-L	T-SSGGSY-Y
W-Y-V-K	DGND-D
E-Q	S-Y
Y-Q-I	SVMI-M
Q-E-D	TFS
I-D-S-S	Y-SRTSKT-Y
D-Q-P-E	GRF-D
WE-D	NSY
D-Y	SYA
DY-S-GD	IIF-T-S
R-W-DG-E	VG-C-TSCNR
QY-E	SNT-H
M-R	L-Y
A-Q	W-D
H-W	T-S
P-P-A	ITF-N
E-Y	E-Q
YM-Y-A-Y-R	GPIVGAPDY
K-V	H-N-Y
KG	HLEY-Y
VD-D	SYW
S-SEH	R-DT-I-Y
K-I-G-LT-Q-V	YLKYDGSTYR
Y-P	T-Y
R-LV	YY-SRP
G-I-D-V	YRQ-Y
G-R-V-D	YNYDD
RGP-F	PLQS-Y
P-H-Y	V-Y-D-S-F
RG-Y	DYGSD
Y-H-G-P-N	SYGYTY
L-LH-Y	MVYPH
F-PA	SYSS-L
L-F	DYA-N
G-L	Y-Y
LD-F	GGTGF
M-H-N	H-D-N-Y
NW	TTHV-P
M-A-W	NYW-E
W-M	E-RL-H
MH-N	GGAVGA
Q-R	VHNN-Y
Q-DP-R-Q	F-SDLAYT-Y
E-T-T	YIG
T-N	Q-ITRH
T-N	L-E
T-W-D-I-G-N-R-G-D	W-RGGGVNYARQ-Q
G-V-G	RVY
R-E-H-A-N	RRHCN-ADCFNW
EE	NKQT-L
EA	R-G
WF	R-R
S-W	N-W
F-S-N	R-T-PGE-S-D
S-W-RI-W-F-T	KYYFWSGYPPGEE
E-K-FE	AGYS
EQ	KS
PE	Y-S-S
R-I-K-N	SGS-Y
YQ-D	HGS-H
Y-I-IKE	LLTTV
F-HD	H-N-N-Y
H-F	GSHV-L
FR	H-WWD-D-S
HD-R	R-HT-D
QH	HYG
Q-Q-I-H	WINTYT-T
HIGE-E-Y-Q	YPYYYGTSHW
RH-Y-F	IYNMPI
AD-F	SYAMS
F-A-GYE	AINA-RTYYAD-K
D-RF	GKGYVF
E-Q-T	SY-Y
Q-Q	S-N
L-G	R-Y-R
Q-G	DAW
G-SQ-G	E-RS-VN
Q-T-P	WS-L
E-T	SDY
S-CD-N-H-V	GNGNYDL-Y
A-T	N-Y
A-S	L-H
L-DS	Y-TLQP
T-K-T-S	YD-L-R
S-K-N	DYS
T-N	WINTE
Y-R-S	N-RN-K-Y
P-T	SY
S-I-R-Q	WSGGN
T-VA	VGIYYEGA
NNT-G	YNNW-W
D-I-G-G-S-D-AG	SGGRTDYAG
G-G	RK
K-L-N-E-T-N	GTAGSLL
T-G-A	F-EF
N-GN-G-I-S-DG-E-A-R	W-NQWGQVNYART-Q
D-T	RVY
K-N	D-EW
N-S-P	D-N-Y
R-G	SFSY-P
K-R	D-S
R-KP-E-G-V-P-S	V-W-D-TN-Q-QG
DR	E-RS
RL-P	D-RL-F
GD	LGS
N-V	SRRPT
IR-H-T-I	YGV-AFKE
Q-R-S	NNY
R-L	DASK
D-P-C-P	YLQY
PE	SYT
CH-G-C-P-S	W-KRW-AAH
DN	GSFW
V-NK	NYGMN
KNN	WINTY
K-V	D-YGSTYP-Y
SG-Y	YNSY-Y
N-K-L	SYW
K-L-L-S-GS-Y-T	E-LEIGMTN
NT-G	DYS
N-G-R-K	Q-GNN
N-T	A-Q
R-G-S	SNSW-Y
K-L	SDY
DG-W-N	Y-SYSGS-Y
L-F-P	Y-N-K-Y
Q-L-PE	YYRTP
P-QE	VNHITI
T-I	T-N
V-I	IF
K-D	NYYY
Q-N-N	T-Y-Y
N-F	SWEI-Y
K-N-Y	D-Y-Y
Y-S-N-N	T-DG-SY-Y
Y-K-CS-K-N	D-NGKDGGD
V-K-F	L-SN
F-E	S-N
D-Q	Q-T
R-Q-P	SYN
R-G	Y-N
P-E-V-W-F	E-LGALR
N-GA	Y-EF
NA-W-I-D-GS-D-G-E	W-KRWGAVNYARQ-Q
K-E-KA	ARDYYNW
L-Q	H-Y
Q-R	FWS
GK	GY
TG	WGD
G-VQ-N	RDYR
Y-Y	R-Y
AF-L	YRYS-R
D-C-L	NYA-H
LC-D-E-Y-N-K	GISRS-GDID
E-A	GGVGS
KG	SDVY
Y-R	E-RRPS
GS	W-W
TR-E-H	QV-VSGIS
R-N	I-GH-GTD
E-K	KS-R
N-I-K-K-S-K	HFYTY-DV
R-YT	ES-DSY-N-F
GD	SNED-L
H-D	T-S
H-L	T-SS-Y-Y
L-V-TT	RAFDSD
K-NL	YGN
KF	L-Y
V-K-K-K	R-SLES
D-K	GF-K
S-V-E	DTY
KE	DAN
K-E-V-Q	DYEG-AY
V-G-RP	TYTID
RRP	VGDT-QFY
E-P	SYG-H
R-E	WSG
PYE	YYRY
RH-D	DSD-Y-N
DA-RH-E	WQGTHFPR
A-FR-D	Y-H-GSS
VT-N-L-L	TVSFHY-H
Y-Q	L-Y
Q-F-Y	A-SNLAS
D-V	YS
TS	RYA
S-W-LY	E-TY-D
E-IW	H-D-Y-Y
W-LY	NVEL-R
Y-D	NYW
Y-Y	E-RL
W-K	PM-D
K-E	RN
R-N	LYS
E-Y	W-V
N-F-M	V-GFN-S
D-N	VY
I-P-E-K	YYS-Y-Y
E-D-H-E	YVYH-Y
K-Q	DSS
Q-A	A-SS
I-NK-K	W-SIG
Q-K-Q-N	SYGGGN-Y-K
Y-K-YQ-Q-I	RDCLLCAD
N-PA	W-N-P
PS-K-E	AIY-DTSY
N-E	V-Y-W
GEF-R	SRF-S
Y-W	GYD
W-K	WGDG
F-S-C	YYYG
Q-GR	FWS
KG	GAG
TG	WGD
N-N-Q-G	RDYR
FL	NYG
F-Y-F	W-NTY-T
R-L	Y-Y
WSG	NNVD-W
N-I	Y-Y-TY-R
W-L	I-T-Y
P-D-T-N	Q-SNY
N-GN-A	DFTL
TN-S-K-A	YGN-DTS
I-N	YYD
P-S	W-Y
HP-R	Y-S-YTD
HP-K-E-P	E-F-NR-WY
KC-R	ASYY
R-K	ED
M-C-P	R-Y-RSK-F-D
MG	VF-Y
K-Q	LGDKYV
Y-H	WDSSA
LF	VI
F-L-L-A	GFI-F-TAM
LG-F-Q	LSRG-Y
R-GS-L	GYTL
S-Y-K	SYW
K-Y-HR-IN	E-DSD-Y-NY
R-D-L-R	Y-YGTSY
L-E	Y-Y
R-K	YN
D-F	SNS
F-MD	WGD-D
FI-E	LIGSWY
A-T	DI
T-N	Q-S
N-G	F-QW
N-T-G-W-I-G-S-D-G-G-T-G	L-KVFGAVNYARQ-Q
D-G	RIY
K-N	DDLKW
NW-K-N-V	YADY-W
W-R-N-T	TA-D-Y-K
P-P-D-W-D	Y-PTGHY
P-T-D	Q-S-Y
N-NG	DFTL
NT-S-K-S	YGN-DTS
I-A-N	YYD
W-T-R	HNY
S-E	N-D
K-N-G-L-D	FWST-R
H-Q	V-GYT-T
RH-T-L	SYW-H
S-N-L	D-N-S
K-R-R-S-H	DDGYR-Y
K-D	D-R
R-P-IG	W-SSSD
N-H	DYH
A-LG-H-R	W-HNS-D-N
V-S-S-Y-D-T-A	RSVDYYYY
D-L-S	N-R-Y
S-L-K	F-I-E
W-N	I-T
WN	DYSV
L-KW	GW-L
D-V-L	S-SSA
A-QE-G	SASS
D-L	YF
EG-GD	SWSYA
L-N-Y	QSNRAPA
S-V-T	GTY-H
SR-YK-I-RD	YPAGGATY-K
Y-FN	WAWP
R-R	SYG-Y
P-LR	SYW
RL-RH-R	GGYDGW
N-N-N	Y-EF
A-GN-I-D-G-G-T-DG-N-N	W-NRGGQVNYSRQ
K-K-N-A	RDP-K-W
A-E	H-N-Y-Y
A-T-LQ	MLEH-L
LQ	Y-N
QE-T	T-SYV
P-K	SIG-S
E-N-P-K	SSSL-F
L-D-Q	VYG
G-V-K-P	WYD-DN-Y
Q-V-M-K	DLRTG
D-K	V-GY-H
S-L	AG
N-S-D	WWD-K
KK-N	IFNFY
Q-Y	NY
K-P	L-Y
Q-N-KQ	V-N-ET
P-K	YD
P-KN-E-I-L-D	ETALVVSTTY-HYD
N-N	SY
PD	R-N
L-E-N	YHSY
I-L	YA
LQ-V	S-STG-D-H
D-D-L-V	NRGW
I-T	SY
S-R	SGGN
T-L	YEGA
P-P	YY
IT	EV-GFN
T-T	SS
E-N	YY
T-P-P-Q-PG-I	Y-Y-YW-Y-SDY
SS	G-D
E-K-N	GNSNR
K-I-W-QG-P-G	SYDGGGHY-L-W
W-F	Q-YNSY-P
Q-LG	E-T-H
L-T-F	GID-N-GTN
G-W	R-YAL
Q-L	STW
FE-FP-R-A-V-R	YDSGYDYVAVAGPA
GS-T	YNSY-Y
K-N	SYW
K-N-S-E-G-L-Y	E-LEIGMTN
K-K-S	DYS
K-SKD	D-D-K-Y-N
S-E-K-E	L-K-DS
E-E	T-T
N-S-K	SYW
DK	GG-TY
R-Y	DPQDG
Q-T-L-R-Y-L	SEFEPF
VV-A	DYSY-L
A-A	R-D
V-L-R-Q	R-LYSYY
PI	Y-Y
I-P-I	YYNP-W
TI	RYG-H
I-GD-I	VMSY-T-Y
T-N	GGAAAAV
AP	SYSY-L
L-F	DYA-N
FG-L	Y-SY
F-Q	GGTGF
P-R-H	FDGA-F
G-RG	SHED-L
I-R	Y-H
R-H-R	E-Y-QAYYY
K-N-ER	FIYSS
R-K-S-R	A-TNLAD
N-L	FYG
P-E-L-N	E-DS-T
L-N	AYN
NG	NPYY
E-T-V-R-LN-Q-P	NYYDGGS-RY-Y
W-R	GNTL-F
LW	TYD
E-VS-T-W	Y-SYS-S-N
L-V-Y-E-R-W	ATA-FYDGSY
DK	H-N-K-Y
K-T	S-Y
TS	V-N-S-GTD
NK	DFYDYD
Y-H-EE	KNNIRPS
KE-QE	AL-GAT-S
K-Q-E	R-R-WD
R-D	D-D-Y-N
D-R-AE	W-GTHF-R
EF-H	SIR-R-Y
R-D	Y-GSS
S-Q-R	TYT-E
R-S	KQ
Q-F	VGDT-F
LI	SYG
L-AEI-F	TISSGGSY-Y
L-I-R	QTTMTY
H-L	Y-N-F
WSGN-N	NNVD-W
G-I-N	Y-Y-TY
W-L	I-T-Y
I-R-E-K	NSGN-K-Y
K-E-D	DYSY-Y
L-M-TN-R-N	W-Y-TGSPSY-Q
K-Y-E-D	H-YYN
K-R	ASNY
V-K	ED
V-L	Y-S-W
F-AK-L	I-Y-D-D-R
F-K-H-QK	L-YYYDS-GYY
IK	E-Y
QF-K	GDW-H
K-QF-H-A-I	E-SAG-YTD
K-GQ	ESRVSFEA
NG-I	SHN
N-I-L-D	GASTR
K-NT-N	SGSGS-D-TS
Q-I-K	SNWP
W-T-H-GD-L	VFGIFPPW
V-R-R	AGYDVH
R-N	QSY-S-S
N-GY	Y-GGS-Y
KGT-N	EGPGD
IF-D-R	SS-GSNY
SR-DE	D-KRPS
F-IF-Y-K	WDSRLG
K-E	S-T
I-K-R	DNW
R-IS-F-E	YGD-D-R
R-K-H-E-R	DWNYNPRY
QN-Y	KSV-S
TI-R-E	KREY
QE	SYW
E-N-G	N-Y-S-R-N
Q-A-T	WVY-ND
LF	GSHV
G-L	Y-H
F-G-NT-A	W-YGN-N
I-G	DKY
I-I-TY	WDSTLG
N-I	N-W
I-K-N-TY	I-YDD-D-SY
I-R-H-F	L-FEGDYSGS
GH-Y	GNN
N-T	Y-Q
Y-DN-R-S	SNSW-Y
R-L-I	SAY
R-D-W-N-S	Y-SYSGS-Y
Y-K	WA
E-E	KY
K-R-F	DYD
L-F	FANSGP
SEF	SYS-S
AK-SE-KL	VISY-NKY
GG	SASS
K-Q	SYS
K-I-K-L	Y-YYS-S
K-Q-I-F-RK-K	ESSYFYYD-E
R-T	GTHF-L
G-GT	DYS-H
T-G-L	W-E-T
GR-T	ATTATE
D-Y	Q-N-N-F
K-Q-YR	DYTY-L
Q-D	W-H
D-K-L-K-R	E-D-D-YINY-E
D-Q-K	T-LLAP
S-S	T-S
Q-T	SY
SA-R-Q-H	SSSYISY
K-D-G	NA-R
G-N-G-R-F-LT	Y-FWSAYYDAD
L-Q	L-Y
SI-E	HYG
EE	GSR
IL-L-K-EQ	RSEFYYY-TYYY-AD
S-S-V	T-D-F
N-V-E-VG	TYNH-Y
GRP	TN-Y-Y
R-R-G-N	TAAQPY
N-G-K-K	Q-IGNN
K-T	Y-Q
YR-N-S	ANSW-Y
NL-K	SDY
S-R-DG	Y-SYSGS-Y
Y-N	WD
V-R	EI
R-D	QSV-Y
R-V	Y-EF
T-D-R-G-GGS-D-G-I	W-NNSGGTNYAQ-Q
K-D-A	SDYNW
A-AR	YWNT-F
NNK	VYS
NN-VH-A-N	D-GLNYGS
G-N	DIQ
N-T-N	R-I-D
T-N-AN	QY-ET
K-G-A	P-F-H
T-G-G-I-GG-R-GG-N	W-NTNGAVNYAWY
D-Q	RR-M
KAN	R-EW
P-S-K-D	H-SGN-Y
PG	GS-I-F
H-SG	TYG-S
SQ	WINTY
H-S	RSW
Q-S	S-Y
P-Y	NRAP
R-E-R	EV-GYT-T
E-R-V	SYW
V-R	DN
G-AG-P-Y	WYYGTYY
E-T-K	EIV
T-N	Q-D
T-GK	Y-ET
K-D	RPEW
A-I-R-G-I-T-S-GG-D	W-KERGAVSYAPQ-Q
D-A-L	RLY
D-K-NN	RDSW
V-P	N-RT-Y
VY-GGV	AYIP-L
P-Q-V	DFSMH
Q-G	WVNTET
I-P-V	F-L-Q
ER	N-Y-E
R-P	F-G-V-W
K-T	DYY-H
P-K-T	W-DE-D-A
KP-A	RGGMIF
R-Y-Q	Y-N-F
R-E	R-S
SL-E-I-A	Q-GYT-T
A-D-A	NHH
R-A	Y-IY-Y
IG-R	RSS
Q-H-A	NYGA
G-R	SYY
H-E	YYS-S
R-L-VS-Y-G	S-FTVD-I-H
N-G-I	Y-EF
A-G-I-Q-I-G-R-CG-R	W-KRGGAVNYCR-Q
D-S	RY
K-V	T-Y
V-K	IRE-R
KE-G	DYY-Y
G-K-K	W-DE-E
V-KE-P	GVITM
PL	H-N-Y
PL	V-GST
G-E	NYA
L-G-E	R-RSN
E-P-E	YGNH-Y
V-P	FS
R-P	G-E
F-D-K-D	QV-GYT-T
D-D	TY
KG	DYD
I-I-T-I-FV-D-F	LQITTIIDY
E-I	YYGYY
P-K	E-K
R-A	Q-S
QR-I	GFH
YF	YY
I-I-A-S-PR	DFGEYHY-FDL
WS	RSNW-I
L-R-Q-I	V-WFD-N-Y
R-I-W	L-FI
R-P	YA-Y
S-K-H-P	YY-DY
EF-H	VHSN-Y
H-FE	GSHV-L
FR-E	H-YWD-D-R
F-H	R-II-D
A-N-D	N-GN-Y
MS-E-D	YSYPY
A-P-V	DYY
R-S-A	D-I-FY-Q
AN-D-E	SHLLRAS
KE	GTFN
R-W-A-SY-E	IGLDTPNY-Q
R-K-Y	E-E-RWRPT
L-T	NNR
A-T-L	GASW-F
V-D	D-W
L-K	I-Y-D-D-R
Y-T-K-T	GRFAH
N-N	W-ST-HI
A-K-D	HYSP-W
LNT	NYG
T-L-K-K	W-NTN-E-E
N-I-S-T-E-I	GEDNFSL
T-A-K	HYGN-F
TVG	NNED-Y
E-K	NWW
G-EK	R-VNK
Q-A-M	WFFPW
K-R-E	TASNY
E-S	DIGD
Q-F	T-S
F-Q	SYR
QM-E-K	SAGGGS-Y
Q-R	RAGW
G-F-D-N-D	YSN-Y-N
QS-D	QGTHFPY
D-EQ	YY-Y
Q-V-Y-D	Y-SN-YK-Y
TE	A-H
R-N	M-S
T-N	YD
R-Q-T-GG-K-S-T-T	DSGYSGPE-SY-HY
K-S-L-S-G-S-TQ	M-VVSAGWERAD
M-N-K	RNH
A-KQ	DDLP
Q-L	RLA
Q-K-Q	MIFDI-N
W-H-T-V-KQ	ASYSSSSPY
Q-H	GY-Y
HT	Y-S
AP-F-C	SGGYF
F-D-P	YYI-N-Y
T-P-A	RLRG-N
N-F	YGQSLS
K-T-WF	TYALS
W-L-I-F	GVILL-ITN
F-W	E-GKP-G-F
N-G	F-EF
A-N-DG-S-R-G-R-G	W-KMWGAVNYARQ
D-G	RP
E-K-N	H-DF
GD	Y-R
L-TP	GNTL-Y
K-TS	DYG
T-Q-SK-NP	IISTYSGDASY-Q
T-G	SSTWY
S-N-QL	E-D-N-Y-N
QL	S-N-E
L-N-G-W	M-TTHA-P
WH-N	S-T-GRFY
IL	M-D
K-H	D-V
H-E	L-Y
K-DE-L	Y-IRYT
KD	G-R
TEP-N-MN-N	EVQL-SGFK-K
N-Y-D	DTS-H
K-P	SN-L
Y-H-M	S-HF
W-L	Y-N-F
W-GN-S	NNVD-W
G-I-N	Y-Y-TY
W-Q	I-T-Y
I-E-D	E-RW-F
PD	V-R
P-V	SREL-W
I-S-H-S	Y-DE-Q
I-F-P	HRGN
S-D-K	RV-GY-H
N-S	GSGY-F
E-S	AG
N-K	WWD-K-H
K-N-K-N	IFNFY
Y-L	YY
E-R-K-D-E-D-A-P	RVMYYW-FSKY-Y-Y
WF	R-R
K-W	N-W
F-GN	R-T-GE-S-D
W-KI-L-W-N-F-T	KYYDFWSGYPPG-E
T-E	SKY
R-S	HD
R-G	WWD-V-R
RF	DYD
R-H	DT
R-I	SF
P-A	ST
P-R	HLGDG
NA-K-H-N-R	TYGIYDLYV
N-E-A	SM-Y
R-G	SF
R-TG	YN-D-Y
Q-T-DI	PPLFYSSWSD
F-K-K	YYGT
E-N-K-F	SNMAYS
N-Y-K-Q	FDYAG-W
P-Q-I	YNR
N-E	YW
T-FQ	ITTGYA
H-T	WDD-NW
MM	SYA
A-MM-M	WINP-N-NAK
W-HR	D-GFDL-G-Y
K-G	IR-R
K-K-V	DYY-Y
K-K	W-DPE-E
VE	GVITM
Y-E	Y-Y
E-L	K-RFS
L-R	DY
T-E	GGWHAMD
D-R	SS-Y
K-E-V	FHH-Y
KQ-V	WINTH-Q
K-D-C-E	NYYR-D
RQ	L-Y
R-KE	D-RPS
RN	VM-GG-D
G-DR-KQ-N	R-GYNDFYDGYY
E-C-C	SYN-W
R-E	N-I
F-R-E-R-E-C	VISSS-GMTR
R-R-L-C-GG	GDYVGE
S-T-E	Q-Y-S-H
H-T-T	FYIY-Y
Q-E-V-K-T-N	D-R-TTNY
QH	GSKGAM
FF-F	NSF
QP	SYW
P-E-P	E-N-TN-R-Y
P-M-F	RYGN
F-P-R-R	SS-GNNY
RD	D-K
EF	W-SS
Y-W	T-S
W-F	IF
SV-W-S-F-RG-R	SRIYDLNPSLT-Y
RK	NED
K-D	D-Y
K-EE-Y-R	E-YGV-T-Y
K-R-DQ	R-V-MY
N-G-K	Q-GNN
K-T	Y-Q
Y-GR	SNSW-Y
L-K-D	SDY
SD	Y-SYSGS-Y
EA	NKQT-L
GS-P	R-NW-W
Y-S-L	SYW
L-EK-M	YGD-D-R
PY-L-K-E	FVSLD
S-L	SYGIN
PL	YIN
PS-TH-I-L	SVYYGG-YYF
RK	FD-Y
K-D	SNE-Y
K-D-D	YT-T
L-K-P	TYY
PL	APAS-T-Y
F-H-K-Q-K	DYGFS-E
Q-K-C	SSR
Q-K-E-K	AASSL
Q-C	YH
E-T	SGSGTK
E-V-E	KRVGA-Y
RQ	L-Y
R-KE	D-PS
RN-Q	VMG-I-GGDY
V-N-A-R	AGYDVH
R-N	QSYDSSS
YG-G	Y-GGS-Y
GK-N	EGRGD
DA	T-T
D-N-K	RFW
K-A-A-V-K-D	Y-NSTGY-E
A-TK-Q	QTNY
K-V	T-Y
V-K-G	IRE-R
K-GV	DYY-Y
G-K-K	W-DE-E
EV-Y	VITM
E-N-N	DIQ
N-N	R-D
S-N-N-N	QY-ET
T-G	EW
A-D-N-G-I-D-S-GG-T	W-TNGAVNYAWY
D-Q-T	RR-M
K-D	R-EW
G-S	L-S
SG	GVPA
E-W-L-N-Q	YYDYDF-F-Y
S-E-Q-C-R	NN-GTYAY
QS	K-N
R-M-Q	Y-NFN
D-R	RY
K-S-R-R-E	DYDGDTY
R-R-L-L	DVVTGF
F-M	FNSY-I
TRM	SYD-H
M-T-R-H	AIGTA-D-Y
R-P-K-GG	E-T-DNYY-Y
SL	KY
V-L	L-IF
D-K-R	DVNR
KY	SY
R-L-HS	DD-E-WYYGMDV
Q-I	R-Y
M-QT-W	FAGSYY
WM-SL	SIGSGGGTA
M-I	E-PY
Y-D	G-NRAT
R-S-L	Q-T-R
F-Y-Q	ILF-K
I-L	KSM-R
RF-D-I-R-Y-L	LTTLTSYNWD
KR-R-I	LSNQY-Y
I-K	KD
RK	T-G
HI	ADSSGY
GR	N-Y
PG-H	Y-Y-T-V-N
H-RG-I	EWAE-D-GN
HF-D	SY-H
R-R	WRSN-Y
T-Y-E-R	DYN-D
E-R-T-N-H	N-YNN-V-G
R-Y	YYY
T-S	GSK
G-K-G-R	WDSSDY
TT-Y	SYT
Y-Y-K	GITIL-IAN
G-R-I	DTVMG
P-R	S-Y
R-PI	HYSI-L
PG-W	M-WGD-R
H-A-T-P	DYYGSG
T-K-Q-L	NIGGTF
K-K	DD-D
QN	WDMV
F-E	SY
RF-E-R-K	LGAFHWD-Q
NN-D	A-YW
IG-ID	LRYTD
E-GQ-K	Q-RNY
Q-E	A-T
Q-Q-A-K	RYNRAPY
ES-A	T-GH-D
Y-AE-K	Y-STA
K-E-Y-R	ESD-Y
R-K-R	ATHF
E-D-Y-K-R	SRSGSYSYFPD-Q
Q-R	YDD
D-GE-S	Y-SSY
Q-T-E-Y	YYRM
VA-D-N	S-ISN
T-V-S	YNNW-L
K-S	D-H
D-K-L	WN-Y
LS-K-N-D-K-N	D-YVSG-D-Y-Y
L-RF-F	TYGH-F
I-E-R	L-SN
E-D-Q	GRGS
SGT-F	NNED-W
SDG-W	WAGGT-NY
F-P	RNA
PI-K	D-ST
L-C	L-Y
C-Q	F-YS
G-E	FY
K-N-D	SYW
G-K-D	R-NPN-S
L-G-S-Y	SGFRV
A-V	H-N-Y
SA	STHF-P
Q-G-A	DYY-F
A-K-G	T-D-Y
S-Q-K	DPLEYYG
TG	SSW
RY	WYR
Y-H	FYD-F
N-N	Y-EF
A-G	EW
N-G-I-GG-GG-N-R	W-RGGGVNYGRR-Q
K-E-K-N-K-R-A-N	R-YCN-ADCFNW
LT	R-N
NNT	YNNW-W
D-I-G-G-D-G	SWGRTNYAQ
K-K-K-T-A-T	ATEGSLL
SN	YRS
R-Y	SY
G-K	NSN
R-E-K	Y-F-W
GD	DFA
DG-E	Y-SYS-N-R
VR	AGR
P-T-D	Q-S-Y
N-P-G-I	DFTL
NT-S-K-A	YGN-DTS
N-A-N	YYD
N-I	Q-N
I-NS-G	NNNWPT
V-Q-P-S-K	WSGGNTDY
K-HQ-S-S	TYYDYE
E-QE	DSIGK
R-F	NSY
YW-W	QFDP-F
L-D	S-Y
K-L-D-P	N-Y-S-STY
Y-N	ERGMH
D-R	YNR
R-T	G-E
R-D	FW
S-K	EV-IK
E-Q	DTY
E-P-A-R-T	GVF-F-DY
R-Y	ES
VE-R-K	EV-GFN-K
T-K	DTY
R-I-E	SDY-DS
Q-GR	FWS
KG	GYG
DT	WGD
N-YS-G	RDFR
E-V-D	VHSN-N-Y
A-R	STHV
K-I	WWD-D-Y
E-I-D-A	RGYY
AP-T	YSY
T-A-N	HYGSPW
PF	NYL
F-FV-QN	VINRS-DTN
PG-P-F	GT-YF
Y-E-E	SST-Y
KE-G-T	SWEI
S-V	SYY
G-V-S-CP	E-NSNGD-N
SS-H-K	DGRN
NK	S-Y
K-N	GSTF-W
N-KN	R-DAN-N-K
E-K-KE-N	YDGYFLY
W-H	N-YSY
QE	N-KT-E
E-E	E-T
K-E	SY
S-G-S	EYY
R-K	D-W
RY-L	AKAF-P
E-N	T-S
E-K-S-G	SYSMN
GS-DI	SISSSSSY-Y
L-TK	VTD
P-E-F-L	DIGSK-Y
E-K	R-Y
L-R-P-PG	L-YASS-Y
D-H-G	DYF-Y
H-R-D-K-G	D-DPYN-DTS
EL-D	GL-RF
E-K-Y-R-D-E-P-P	RVMYYW-SKY-Y-Y
E-RV	RND
V-H	A-S
V-R-R	HN-Y
P-S-G	Y-E-STN
E-V-H	ERLG
MW	WDS-W
W-R-M	WYD-SN-F
T-F-M-M-W-Y	VRSFYYS
R-R	YE-L-W
R-RQ	M-WGD-STD
K-L-K-RN	DYGNY-Y
TKS	TNY
L-K	I-T
T-E	YS
I-SL-G-H-KS-L	VQYSGS-LGAY
G-L-R-QV	LYGF-F
GR	H-D
S-S	SYW
N-R-H-K	Y-NST-Y-E
Q-S-V-E	SGRL-D
A-P	WNY-F
E-TA	SYT
AT-E-P	Y-NPSS-Y-N
E-T-I-L-T	P-VRLGY
SN-DW	Y-N-K-YLN
W-NN	VQGTHFPQ
PD	W-N
D-F	EYD
E-L	DQAH
L-E	GIGTSGN-W
G-L	GLYN-YT
E-Q	S-Y
Y-Q	SVMI
E-D	TFS
I-D-T-E-L	Y-SRTSKT-Y
D-T	GRF
S-D	L-H
T-VD-S	Y-TLHP
DS	YDNL-R
E-R	DTY
D-R-E	R-DL
NQ	GGDP
V-K-L-K-R	IIGSKL-H
KK	DD-D
K-TQ	NSG
FRE	WARWF
N-I	Y-SY-L
PT	YYTY-L
VE	VIG-N-NTN
R-W-P	R-RDDV
Q-I	SR-GY
W-T-M	F-GSYY
W-L	V-STA
MW	E-PY
G-K	GNN
Y-N	Y-Q
R-NY	SNSW-Y
R-L	S-R
W-L-S	SDY
S-G-I-N-D	Y-SYSGS-Y
KK	WD
CT	ISSA
F-I-SI	S-YRYT
C-R	RY-R
R-R	SYY
R-D-F-S	ERPLY
L-H	DI
S-L	Q-Y
R-N-N	GNTLS
K-N-N-N-A	D-D-Y-NYAP-Q
N-K-E-R-K	YQGYMD
KF-H	VHSN-Y
H-KA-F	GSHV-L
FR	H-WWD-D-S
HD-R	R-HT-D
E-R-LD-D-E-R-E-P	VMYYW-SKY-Y-Y
LE-L	SYST-F
WK	SEW
L-WK-E	I-Y-D-D-K
WASL-L-D	H-SYFYRTAY-Y
D-D-KQK-S-V	W-DDVKYDFNDG-Y
N-F	YGQSLS
T-W-WF	TYALS
W-T-L	GVILL-ITN
F-W-N	E-GKP-G-F
TA	VSGA
A-S-N-R	HYAI-L
CG	GY
A-W-R	M-WGD-RTE
H-A-F-A	DSMDPG
V-Q-A	Y-SN-K-Y
V-K	W-TRES
QN-D	NYR
DQ	SSSSSY
P-N-GD-IV	PRATGYSM
KM	D-YLI
MK	WQGT-H
PK-M	DYY
HM-K-A	WIDE-NSE
KTN	DLH
V-K	WSSH
K-E-PC	DYY-Y
P-E-K	T-DGN-Y-Y
P-RE-E-C	D-T-SGYG
G-W	N-N
WN-Q	L-HD-F-L
K-KN-Q	DSY-H
Q-K-K	R-DE
WNK	GAYYI-D
R-P	FS
G-R	SY
T-T-KK-R	IF-SPN
L-T-N-G	EWGSGRY
F-NW	YGSS-S
T-WF	SYAIS
W-A-R-I-DS	GIIIFGTAN
F-W-NT	E-GKP-G-F
EN-K	N-HNY
K-E	FWS-W
KE	DTY
T-K-G	DYG
P-P	SY-F
V-D-A	Y-GST-F
A-V-S-Q-C-V	NNS-RN-F
H-A-T-P	DLRLG
G-GA-LA	FWST-R
TI	YT
A-IT-D-Q-A-L	IISSGGSYTY
AR-P	DEGNGNYVE
R-D	EI
D-GG	Y-EF
A-E-I-GD-G-GG-T	W-NSGGTNYAQK
K-K-D	RDYYNW
G-I	T-T
E-L-N	SYW
P-N-I-P	M-HHS-STN
E-V	GWD
G-K-Y	SNN
K-T	Y-Q
Y-D-R	SNSW-Y
R-L-I	SDY
R-G-I-N-D	Y-SYSGS-Y
S-K	WE
T-L-G	HNY
L-R	N-K
NR	FW-T-F
Q-R-E	TYW
PS-E-D-S	E-NNN-R-N
P-A-N	VMIT
LL	DI
L-FH	Q-HST
L-HAD	HGTHVPY
H-A-E-K-L-GV-L	W-WPGP-I-Y-P
F-H	VL
K-Y-F-K	ISSSY
Y-V	G-SS
KN	QY
E-N	S-T
QE	SYW
L-S-D-KP	V-YGDSY-R
N-Q-F	MPNW
W-DL	W-SNHW
IP-IP	R-GGTAY-K
N-HQL	E-TYVS
LQ	G-N
FA-T	TYSY-P
F-D-A	Y-R-T
F-Q	GGTGF
T-G-N	Y-EF
T-G-DG-G-R-E-G-S	W-NNSGGTNYAQK-Q
K-N-A	YYNW
M-E-F	SS-GYIY
S-T	D-R
F-E-H-F	YTTLSW
H-VF	SYW
P-H-S	KP-E-Y
FV-D-SS-E	VSRGG-S
E-H	IHSN-Y
F-H-A	GSHV-L
FR	H-YWD-D-R
F-H	R-IT-D
V-L	DYSY-L
A-R	R-DAN
L-R-D-Q	R-VYSYY
W-L	NY-I-F
W-GS-N	SKEA-Y
T-G	Y-D-F-N
W-I	SIYYY
L-W	YY-K-F
RG	SKEV-W
GP	Y-T-Y
G-W-KP-R	S-RYDGTYY
K-Y	I-E
DR-KK-N-K	QGIFYKGSG
A-T	WPP
M-I-K-V-T	IIL-V-H
R-I-KQ-P-M	EA-EGEYDN
K-M-T-A	ED-S-Y
K-K-E-L-SV	YGTYAG-F
A-K	N-YL
P-D-G	VSSA
E-V	N-S
L-K	YY
I-F-KF-N-V	RGQASW-Y-W
R-PE	TS-Y-Y
K-A	L-Y
LA-K	L-Y-E
SR	SRDL-L
K-P	Y-Y
P-D-G-R	GINSN-GTN
Q-T-A-E-S-K	R-YRFDMD
QP-D-Q	QSVSSY
Q-FT-Q	QRSNWPGY
R	T-S
D-F	S-A
FD-T	A-SGSGGS-Y
G-F-Y-W-G-D	AARRFV
K-M	YY
E-R-E-R-GP	RVMYYW-SKY-Y-Y
T-H-P	RDNIGN
P-R	SGG
T-E-R-M-R-C-Q-L-V	Y-YYSGSTYY-K
E-P-G	CSSTSC
C-QR	YGN-F
Q-L	SY
Q-P-K	YGD
Q-R	FDYG
D-IN	HWNY-L
N-F-K	R-DPAN
R-R-Y	SKY-D
N-KR-K	Q-GNN
N-R	Y-SQ
R-D	SNSW-Y
N-N-I	SDY
S-L-D	Y-SYSGS-Y
S-K	WD
NG-D	YST
N-AG	Y-EF
A-Q-G-S-DG-A	W-KRYGAVSYARQ-Q
D-G	RY
K-R-K-K-N-AN	ARDYYNW
K-H-K-E-E	HSNGN-Y-Y
E-I	R-SN
SH	S-W
W-K-D	Y-D-D-K
GG	YS
Q-P	YL
PH	V-DTN
W-Q-PH-G	SGA-APTYYAMD
G-G-P	V-SY-Y
F-DK-S	YNSH
P-T-M	R-R-SN
P-P-Y-E	E-YYYG
D-G-AC-S-C	QFLSSF
S-Y	SG
I-A	GLLS-L
M-F-C	FFLY
K-G-TN	H-YAP
NG-K	TRWT
R-Q	FE-K
S-A-G-I-N-G-N	FHKNGAVDFFS
P-K	GRYP
H-PK	W-D-EW
L-QFC	NSYY
H-F-V-L-N	SIAYRGNS-SGSTY
F-Q-R-C	RQL-D-TGYQWA
T-GG	Y-EF
N-G-G-I-GS-GG-T-D	W-KRGGAVNYAR-Q
D-T	RVY
K-K-N-K-N-AN	Y-ARDYYNW
SP-A	HISR-R
AD	F-RK-E
TSS	EGHTAAP
KE-V-D	SY-N-F-H
T-R-K	R-NLES
D-K	SNE
T-K-G	EYI
P-TR-EK-V	W-YES-IIK
KH-LK	HDGTN-D
EW	F-T
E-D	R-RLMI
W-L	Y-F
L-A-A-L	DYEIH
LR	GIH-S-GTA
W-D	K-DY
N-SKS	S-GSNT
SS-N	TSG-S
P-G-E-W	D-DD-T-Y
N-S-N-Y-K-S-P	T-RVSGDYV
DIF-T-K-K-E	Y-NSSDY-K
D-F-K-K-E	K-DVGY
D-GG	Y-EF
N-T-R-GG-I-S-GG-D-D	W-KRGGAVNYARP-Q
D-V-R	RVY
K-KA-D	DYNW
P-P	H-N-Y
WP	STHV-P
M-E-W	N-Y-STY
K-N-D	IGSYY
K-K	ED
D-NK-T	YDD-F
T-SE	Q-RS-Y
T-VK-N	YPFY
WF	R-R
K-F	N-W
F-G	R-T-GE-S-D
W-T-I-V-K-W-F	KYYFWSGYPPGE
N-G-K	Q-GNN
R-DN-S	SNSW-Y
R-K-S	SDY
R-D-L-G	Y-SYS-S-A
S-K-N	WD-D
L-T-W	TYALS
W-L	GVILL-ITN
T-W	E-LGKP
V-P	R-AM
P-E-V	GISSGGSY-F
P-V-K-H	Y-SDPF
PY-T-D	QD-SNY
NP-A	DFTL
NTDW-S-K	YGNGDTS
N-SI-N	SYRYD
M-Q	SSW
Q-K-D	YNIY-Y
E-Q	V-GYS-T
L-S-F	TYW
F-K-E	D-D-R
E-D-L-IQ-E	RRPGQ-DF
N-G-K	Q-GNN
K-N	F-Q
R-NY	SNSW-Y
N-L	SDY
DG-R	Y-SYSGS-Y
K-N	WD
K-F	SY-F
VP-R-G	SNL-S
G-I-R	GVPA
KP	NN-W
K-K	E-IK
K-G	DTY
P-K	R-DPA
G-R-K-F-V-Y-L-P-T	RQL-LRGYYY-M
N-GH-Y	Q-GNN
N-T	Y-Q
Y-G-R	SNAW-Y
N-L-K	SDY
S-G-W-N-D	Y-SYSGS-Y
S-L	WD
E-V-D-L	SSS-H
V-CH	W-LSV-F
L-V-C-C-L-FD	R-CYNR-GVCA
Q-N	R-L
L-T-N-T-G	WSG-S-D
T-Y-D-Q-R-G	ELYGY-YL
N-G-R	S-GNN
N-T	Y-Q
YR-S	SN-Y
N-L-I	SDY
S-R-DG-V	F-SYSGS-Y
S-K-N	WD-Y
K-L	YY
E-R-D-D-E-GP-F	VMYYW-FSKY-Y-Y
K-Q	QSLSSY
K-D	S-R
Q-V	Y-V
D-GQ	R-Y-RS-Y
I-V-V-WGD	VFGVN-D
D-P	NY-Y
R-T	WGR-P
S-T-R	D-W-E
R-L-QAT	E-L-SGSTN
RG	GNYD
D-R	Y-Y
R-Q	R-NR
R-R	YS
D-R-R-Y-T-E	VYRYPER
T-H	R-Y
G-T-K	YDN
R-P	AIFGT
S-T-T-H-G	ISGSGW
QS-A-A	IGRN
T-S	SG
G-V-L	YV-F-Y
TD-SL	SGYY-N
LS	Y-Y
L-L-G-D	ASDSDGF
GH	GNN
Y-N	Y-Q
YN-R-S	SDSW-Y
N-L-K	SDY
DGN-R	Y-SYSGS-Y
S-K	WD
H-W	EY
W-D-M-KQ	W-SMTV
Q-L-L-K-Q-I-R	S-ILFGFVVY-Q
Q-HQ-H-W	YFDTYN-Y
G-K-P-Y	QD-N-Y
S-Q	Y-R-S
S-W	ANTL
Y-R-W	SYA
W-D-E-KL	T-SSGGTY-Y
W-I-K	DGNS-D
P-K-Q-L-V-L	YSSNQK-Y
PT-D	YYTY-Y
Q-D	SSW-H
D-D	M-S
QT-E	YYYDY
D-DLA	LHFY-H
DK	Y-D-D
D-WD	RRGP-R-VN
E-K	GYS
K-SG	SGYS
AS-Q-R	GSHYFW
K-Q-W	DNF
WF	A-T
W-PLV	LNSY
D-T-ST-L-W	GMTMVR-V
HR-SF	YTSRF
E-H	S-GS
VW	GYD
W-Y	WGD
F-S-T	YWYA
F-NW-K	Q-YGQSLS
S-W-WF	TYALS
W-S-L-N-I-K	GVILL-ITNY-P
F-W-Q	E-LGKP-G-F
E-QV	SS-S-Y
ED-T-SQ	YSYWR
PF-E-V-E	TSGY-Y
L-S-P	L-YL-S
SR	SRDL-L
S-P	YMY
P-D-G	GINSN-GTN
Q-K-D-L-S	R-YRFDM
ER	S-H
P-E-N-DR	SNVW-F
L-Q	T-S
Q-M-R	EFTMH
M-QC-G-T-Q	GINTIN-GSS-K
DR-E	KGF-AY
T-R	FDGD
P-AD-R	LGIANYAQ
C-A-QS-F-T	I-RY-MNVYYLMY
N-E	TS-Y
A-D	W-N
V-L-YK-N	Y-Y-STY
E-AP-P	FGSY
PP	SNY
PP-Y-W	WYSN-W
D-K	S-T
K-Q-H	GHW
D-D-A-H	HSD-E
K-P-L-K	YFYGT-Y
P-ET	H-Y-E
LT	Y-L-Y
S-T-L	F-G-F-Y
V-L	TYA-S
L-EV-T	S-SSGGS-Y
ETL	GGYGT-S
K-E	D-D-K-Y
LE	R-Y
KW	GTHF-W
L-A-D	GNYL-AY
S-D	SSY
ED	Y-S-W
N-D-T	SYW
E-N-E-GV	I-YPGDSS-R
G-E-T-D	RRNW-N
Y-KGN	SFNVPL
VT-H-V	ISTPR-T-Y
VT-Y	G-SSTSYA
Q-R	K-TLES
R-E	GV
S-Y-G-Y-G-A-K	IGVPRRDE
QA-A	QD-W
P-C-V	ANSF
D-R	DFY
I-R-R-P-V	L-DED-DTM-E-R
R-P	E-N
L-M-G	D-D-K-Y-N
FG-G	WQGS-Y
E-F	TNA-N
GL-E-E	R-RS-IN
L-W	NTW
WN-DF	R-RD-I
W-TI-L-IR-W-F	DEGAPIL-FFEWGYY-Y
G-L-D	NVGSA
IA-L	YSSY
ETK-YD-E	YGD-DTRF-Q-K
I-E-Q-SF-H	R-VYYGSN-Y
KG	GYG
GTD	WGD
G-Y-V-G	RDYR
P-AK	GRYP
F-P-K	W-D-KW
FC	NSYY
H-V-F-N	SIAYRG-S-SGSTY
F-QG-R-HA	RQL-TGYQWA
N-I-V-T	GPFR
I-G	PIF
Q-D	GYQ
G-M	YSFT
A-T	SY
A-M-Q	YGN
D-M-Q-A	DGYY
S-T-N-R-H	ES-DSYGHSF
H-NSI-T	GNEV-F
LN-T	Y-Y-Y
ES-K-R	SDGGSYTY
H-L	Y-YD
E-Q-T	H-VF-L
A-D-S	H-N-N-Y-E
S-GG	F-GS-V-P
R-S-G	SDYA-N
G-Q-Q-A	S-SY-ITGY
S-S-D	MGYD
HW	W-DV
G-W	SYA-S
WSG	AISGS-Y
WH	A-V-K-F
N-K-Y	YYY-D-K
R-R	YE-L-W
R-RQ	M-WGDGSTD
R-K-L-V-N-S	D-DYG-Y-Y
G-T-R	SGSW-R
D-T-R	TYW-E
R-Y-L-Q	E-L-SDSTY
DGR	GDG
D-K	TN
K-D	S-Y
KK-E	FN-Y
H-E	D-Y
H-R-H-T-Y	RNKGN-T
R-D-S-K	YGTN
F-I	Y-Y
T-S	IIED-W
IK-S	YWD-D-R
K-R-T	YGFTY
R-E	DVST
ST	Y-Y
W-W-H-V-E	HVNAVKN
E-Q	RN
RS	L-Y
W-SR	S-Y-NT
V-G	Y-Y
EF	S-L
E-G	SY
G-Q-YG	WTG-T
G-R	YYYG-D
T-K	R-Y
GK	YD
T-D	T-I
R-G-P-GT	AIFGT-N
K-S-T-G	ISGSGW
L-I	T-Y
R-I	GKT
AQ	GYG
Q-Q-Q	M-WGD-R-D
Q-F-Q-S-Q-R	QRYDYY
R-F-T	STW
TV-I-R	AASTL
RG-F	VPS-FSGSGS-F
R-K	Y-Y
R-I-K-M-T	D-DADTM-R
K-G	D-ELN
L-Y-L	Q-VHSN-Y
TY-LQ-M	STHV-W
GV	S-F
MW	TIN-KTY
M-GV	R-S-AL
N-G	S-SNN
N-T	Y-Q
R-G-NY	SNSW-Y
L-D	SDL
R-G-K-D	Y-SYS-S-Y
K-N	W-D
W-L	Y-Y-F
T-IN-N	Y-Y-S-Y-R
W-QL	I-T-Y
P-H-M-H	K-N-FS
Y-E-Q-S	V-SGFGFT
L-Y	IY
SY	SGR
IY-K-Q-Y	NAKN-R
M-Y-S-H	GA-YYY-Y
N-I	Q-Y
II-E-R	FDHL-L
Q-Q-V	GD-Y
R-V-P-Q-L-K-G	H-YYS-NTN
R-I-I	DRVTGA
R-G-EV	LRSYYA
R-R-Q	SSSG-TA
R-V	S-G
E-GE	NW-GS
S-M-T-E-G-C	IL-AGRGWY
H-S-M	GNNA
E-MT-P	YDNL
DA	SY
EP	SGSGGS
AT-V-S-S-F-E	RVAVKGSYY
N-L	QAVS-A
FSL	SYST-W
Q-T-G	SYV
GQT-S-Q-L-N	Y-NYNAGTN-E
Q-P-G-S-D	PTMLPW
R-D-K	FNSY
E-K	D-Y
K-V-T-E-G-P	Y-H-RVS-Y
K-E-E-K-G	QGTGTT-ED
E-K-Y	SVSSA
P-K	SSYI
I-F	S-Y-H
D-I-R	Y-SYS-Y
F-E-E-A	TPWWYWS
HL	Y-N
HS-PS-L-I	SVYYGYY
P-R	YD-Y
PG-G-R	SNE-F
K-R-Q	TYPIE
R-Q-I-R	NFHYS-DTN
R-FAR	HY-SAY-M
I-S-Q	TF-Y
VS	L-N
R-G	I-W
R-E-A	YS-Y
FQ	YG
L-W	Q-S
DL-L	LHFYPH
K-E	Y-D-D-R
KW-LW	RRGP-RG-VN
D-GT	WGD
N-Y-Q-N	RDYR
WN	NSW
FD-K-N	RRLKD
W-L-R-N-W-T	DEGTPVT-FLEWGYF-Y
D-G	SY
GS-S	WSSN
R-E	R-T
R-E-GG-S	Y-NSR-Y-N
GR	Y-D-Y
A-T	EI
T-N	Q-L-Q
T-G	L-EF
N-GN-GD-G-T-D-G-N-G	W-NRGGGVNYSRS-Q
D-T-G	R-NF
A-N	EW
R-I-P-K	NNY-Y
I-R-F-I	W-D-GGP
KK-S	DYW
I-K-Y	I-Y-D-DSR
I-K-K-S	L-D-EDSGAD
E-Q-E	V-FA-N
M-L	YY
Q-E	K-R
TL	LY
H-L	Y-N-F
N-GN-W	NNVD-W
N-IN	Y-Y-STY
W-L	I-T-Y
L-E	H-GN-Y
KT	ES
K-E-S-T-V	V-SGYTFI
E-T-T-A-M-E-K	YYGSYYDY
D-R-K	K-TLES
R-V-G-S	EV-GFTFS
E-S-Y-G-CK-K	RIGVPRRDED
N-T	L-I
N-T	SN
S-S-G	WAGGN-N
I-S-T-A-L-K	YDYD-F-Y
E-I-R-Q-Q	RSISGY
M-I	W-Y
Q-K	HYTT
Q-I-Q-P	W-DGFYA
E-T-N	S-GKF
E-E	SE
D-K	YT-N
Q-DI-N-LN	KQGEVVLP-R
T-I-K-T	SGFTL
T-H	YF
D-TN	Q-R-Y
KATK	HGESPY
K-T	DYY
T-Q-D-Y-KK-G	L-DEN-NTI-Q
K-P-D	DNSY
N-D-T-H	S-RND
D-IT	F-SN
H-E	GYT
N-K	R-W
D-D	S-K
K-ND	YGSYVY
GE	N-K
P-Q-LR	TGL-H
RL-E-T	Y-SYY
R-DQ-GG	EYY-YT
D-Q	SSW
Q-L-D	YNSY
V-Y	SYY
D-T-GYA	R-Y-SGS
V-W-I-D	E-HITF-GV
AN-S	H-N-Y-Y
SP	NLEL-Y
S-NK	R-F-D-D-D
E-S-S	NVFDGYW
N-I-T	GPFR
I-V-T	PIF
Q-D-K	GYQ
D-S	N-R-Y
D-L-K	F-I-E
W-N	I-T
WL-N	DYS
L-W	GW-L
N-G-R-Y	QS-GNN
K-N	Y-Q
R-N-S	SNSW-Y
L-K	SD
DS-L-W	Y-SAS-S-Y
K-N	WD
V-L	G-NRAP
LH	W-D-I
L-V-R	GL-DY
V-K-H-P-N	R-NREF
E-R	GYT-T
Y-E-N	EYT
K-Q-Q	S-NQR
K-T	SY
K-D	YD
TD-P-DQ-V-LS	LLMDYYDHI
R-G	SNN
N-T	Y-Q
YR	SNSW-Y
L-S	SDY
R-D-L-S	Y-SYSGS-Y
K-N	WG-D
G-W	SYA-S
W-GS	AISG-Y
RP-L-E	WWWWP
E-E	GFS-W
SLP	WSW
W-S-T-E	SSSGW-S
LS-H	WWSS
K-M	YY
E-R-D-ME-E	VMYYW-SKY-Y-Y
Q-I	SD-Y
R-S-R-I	YIQL
VI	IIF
K-V-S-R-R	DGIYE
SV-WR	A-SNLAS
R-A-N	GVPF-S
K-A-P-F	STSSF-Y
N-D-K	WEI-Y
A-G-Y-E-D	Y-TYS-T-S
K-L-N	Q-K-F
KA-K	HGESPY
NRK	DYY
K-Q-D-K	DPAN-HSMY
K-V-I-N	DSGY
MF	YAG
AN	QS
TNN-AG-N	DSDGSIRL
K-A	K-I
N-G-E-G-T-D-G-S-R	M-YRGRPWSAHK-Q
SG-D-G-G	LSL-RTSM
K-E-K-N	AASH-R-I
K-Y	SND
S-S-GH	Y-NRYT
YK-K	DYG
K-R	DE
R-D	RY
R-K-T-H-AK	DWERGD
SL	SSSSLI
L-D	YSS-H
L-L-L-L-N	S-YYY-Y-Y
D-L-R-S	GYYGA
I-I	K-F
R-I	TT-Y
R-P	S-YWN
I-P	DDF
RP-G	HNSN-L
R-R	V-W-SN
R-K-L-Q-R-Q	E-YILTGYN-Y
K-I-Q	SY-P
QG	SSS
G-K-R-I	Y-Y-Y-Y
Q-HP	YYGTG
P-Q-D-LY	NSRT-K-Y
S-AFP	SYNL-Y
M-Y	YRSY
VQ-S	IS-Y
N-V-PK	YASY-Y
F-K	S-W-E
P-VK-V	E-LPGSGS-N
K-T-W	TSYYFG
T-VD-G	LSTKW-Y
V-K	E-K
V-R-G	ST-GQW
S-V-G	WY-IH
N-T-GG	GGKYDY
Y-GN	SFNVPL
TV	KFGM
VT-VY	IATG-T-Y
VT-Y	G-SSTSYA
WN-D	NYY
DFWN	H-IYG-TTK
W-IT	IGVY-Y
WF	R-R
K-F	N-W
F-G	R-T-GE-S-D
W-K-I-A-W	KYYDFWSGYPPGE
G-GS	YDDA
GS	Y-I-DLA
G-G	SMDG
F-NP	YGQSLS
LW-WF	TYALS
W-L	GVIL-ITN
F-W	E-LGKP-G-F
E-A-P-P	D-NTA
P-K-P	HYTT
P-EP-D	R-Y-YTR
F-P-K-D	W-GFY
N-DH	HSN-N-Y
H-P	YG
P-H-Y-D	WWNDNKY
TP	DDH
Y-H	SNY
R-G	G-K
F-Q	IIF
F-PE	YS-F-W
G-R-W	TSG
E-QK	WWD-R
E-M-F-R	ITSVTDS
SR-W-P	K-YSY
S-E	YGT
K-QL-L-V	N-YYGGIS-Q
W-K	TD-Y
D-F	Q-N-K
D-F	QS
L-V	L-I
K-D-F	QSV
D-DA	SSSN
D-N-G-G-F	D-SLSV-V
D-N	N-K
NWF	YGQSLS
T-WF	TYALS
W-L-I-F	GVILL-ITN
F-W-T	E-GGKP-G-F
N-G-R-K	S-SNN
N-T	Y-Q
YN-R-S	SNSW-Y
R-L-S	RDY
R-G-W-DS	Y-SFS-N-F
S-C	WD
N-KR-Y	S-SNN
RY	SNSW-Y
L-K	SDA
SD-L-G-R	Y-SYS-S-Y
EL-N-S	GYT-Y-KG
N-N-Y-V	N-GDKY
V-R-N	DDID
E-Y-F-R	Y-FFLG
E-P-E-P	ST-GF-Y
R-D	QLT
D-G	RKF
HGAE	HNDY-L
E-H-A	AARA
RA-Q-PG	SQDIS-Y
GP-PR	GNTL-W
R-KF-G	SPYYYGNW
R-I-P-H	S-NNY-Y
H-R-F-I	W-D-GGP
R-I	DHW
I-K-Y	M-Y-D-D-R
I-R-R-H	L-Y-ND
I-R-I-I	QD-H-Y
I-R-K-N	YDEF
EK-V	DYN
V-NY	IIDKY-TIN
K-E-S-T	DYYGSSY
H-E-Q	HWTY-Y
E-Q	W-N
Q-A-K-L-N-P	N-TVNY-D-K
QHG	GGS-AM
LW	SYNL-Y
W-T-C-A-C	R-R-GFN-A-Y
ST	DG
NA-W-E-GG-RD-G-N-N	W-KRHGAVSYARQ-Q
K-N-K-AK	ARDYYNW
E-E-I	Y-YY
F-Y	YY
Y-Q	YS
I-EL	WYRR
N-F	YGSS-S
T-W-WF	SYAIS
W-T-L-H-F-S	GIIIFGTAN
T-W-F	E-GKP-G-F
KY-G-C	LGSKY
K-H	DSNR
D-K	F-M-NGT
QD-L	QV-GFT-S
L-D-PK	NYT-N
KP	Y-SS-L
Q-D-S-I-M-Q-E	ERWHVR-Y
D-S-R	QD-S-Y
R-S-N-K	GKML
P-Q	SG
Q-K-MK	WWD-DES
Q-V-R	YDP
G-T-R-R	SNSW-R
ND-R	TYW-E
R-L-Q-R	E-L-SGSTY
DG	GDG
KQ-K-K	LPKNY-Y
K-K	ED
V-Q-LF	YSTDSSGR
YF	DGA-H
FL	GIS-IIA
Y-KVH	DSPRGPL
L-Q	H-Y
DN	Y-T
D-G	WGD
N-N-V-G	RDYR
T-G-A	Y-EF
A-G-W-GG-D-S-GG-R	W-KRGGAVSYARQ-Q
K-E-K-A-N	ARDYYNW
L-K	G-T
FL-W	VLF-T
Y-G-F-N-L-W	SVTPRYCGGG-C
TN-G-N	DSDGSI-L
K-N	K-I
NAK-I-I-PS-G-N-T	M-DYRGRPWSAH-Q
GG-G	L-RT
K-N-K-E	AASH-R-I
K-I	DLG
L-K-Y-M-D-G	S-HF-TYF
R-D	V-R
GGD-N-KA-N-G-S	ERGRHF-P-NRDNLE-K
NE-L	FTFS
L-W	NTW
N-L-D	R-KD
W-TI-L-RI-W	DLGEPVV-FFEWGSY-Y
GR-I	SYW
GA-I-G	NSD-Y-E
D-N	WSNH
S-E	D-N
I-E-RQL-K-T	V-IKYGTTN-Q-Q
E-N	F-D
K-SS	TFS
S-Y	SY
K-R	TR-S
H-RR	HYGY
G-S	Y-W
KT	GQ-Y
YM	T-T
Y-R	S-Y
M-Y	YGN
E-E-Y	HYGLDW
P-ER-LQ	NSRT-K-Y
PS-T	SYNL-Y
P-V-S	Y-TYY-K
QE-RS	Q-LSSGN-Y
N-M-Q-E-R	HYISP
R-R-K-V	W-DPED-E-R
RYNE	STYIY
YAS	DYSH-L
D-DVP	T-SNGGGY-Y
AY-V	RER-EKG
A-S-T	T-SY
S-S-K	WSSY
GQ	DYS
QLH-E	WINTET-D
K-R-K	EDD
Y-LR-T	T-SNY
R-Y-P-ET	WYSNHW
P-I-R	Y-NL-D
V-SG	YAQL-Y
H-N	DTY
N-E	Y-K
H-S-R-I-G	PLYDYY
S-F	SYTTPP
D-D-S	FT-T
W-SNF	GSA-H
V-S-W-H	I-NNG-Y
D-N-D	TSN-R
F-DA-N	SARF
A-P-T	H-Y-H
L-A-T	S-V-L
V-N	TG
V-LL	YN-N
LL-V	AID-GTS
N-T-P	GM-E
N-K-H-Y	S-SNN
K-N	Y-Q
Y-D-R	SNSW-Y
R-K	SDI
R-G-W-D	Y-SYS-S-Y
S-N	W-D
YAS	DYSN-L
D-VD-P	T-SNGGGY-Y
DY-V	RER-ENG
D-R	Y-Y
A-D-Q-P-R	L-SNLES
P-A-R	QV-T
FD-R	SYW
R-K	DSD-E
F-D-R-PA	YVY-DY
D-N	N-K
NWF	YGQSLS
T-W	TYALS
W-T-L	GVILL-ITN
T-W-N-F	E-LGKP-G-F
L-V	L-Y
V-D-EL	R-RRPS
E-N	YS-S
I-Q	SF
Q-L-N-K-L-EC-L	PAAWLQQSLAWD
GC-R	RYNW
K-T-T-N	TE-DSA-K
G-K-T	NFYYY
E-KN-NR-E	YDDQLPS
I-K	D-D
F-I-R	SYW
R-H-S-R	DTD-YTN
K-E-F-K-E-Y	EPGYS-W
LP-K	NYD
YP	DGNY
Q-K	DD
Y-A	WDSS
FL-A	GFI-F-TAM
LFY	LSRG-Y
RQ	R-S
KN	SNL
QR-M	SNTS-L
FM	W-H
MF	A-Y-Y-N
Y-Y-E-Q-M	W-HSTSPW
E-E	KNY
Q-E-R-D-L-EV-E	AK-SNSGLSLLYY
P-K-T	S-F-YS
S-LR	NTY
P-Q-L-I-K	TPSSGQ
L-Q-G	TWLLR
E-R	D-Y
RR	YDT
SD-W-L-S	WAD-S-E
D-KS	NRESY
F-N	Q-YGQSLS
L-T-W	TYALS
W-I-L-I-F	GVILL-ITN
T-W-F	E-LGKP-G-F
A-A-K	RYW
K-D-A-K-K	Y-NSTGYTE
TK	VDGY
K-VG	SSN
A-G-R-F	WSHY
A-F-M-K	D-YGS-STT
T-D-D-G	LRGYYD
Y-T-Q	DIGSS
R-RS	YATS-Y
R-R-S-K-Q-E	DFSGDRSN-YF
Y-H-E	Q-NH
H-Q-E-R	WSGNPW
Y-S	R-T
N-Y-Q-G-R	V-SGG-H-YY
L-H-SN	FGDG
V-QE	QHTYT
Q-HR	VGDT-F
TR-D	Y-SRGGGY-Y
R-T-HHQ	HIYY-SHYY
C-FY-Y-R	HSNGN-Y-E
R-H	F-GSHV-L
PGR	GYY-Y
H-P-R-N	S-D-F-Y
G-PY-K-R	P-YSYDGF
H-T-S	D-D-P
QG-RS	EV-G-T-D
Y-N-M-H-Q-G	RSYVV-A-Y-Y
GR	R-KD
R-C-I-IH	D-SEDYYYY
D-H-Q	V-GFS-T
HH-Q	SSS
NQ	YYN-F
HF-L-I-QD-R-D	NALYGSGGY-ADY
P-E	Y-D-K-Y
EPWK	W-GTHF-R
W-H-SG	S-SSG-Y-Y
K-PK	DYDYG
N-T	QY
T-G-A	Y-EF
T-A-N-D-I-G-S-G-D-R	W-KRGGAVNYPQ-Q
D-T	RM
K-K-R-W-KAN	Y-ASDYYNW
R-D-L	SN-A
LL	Y-IF
Y-S-R-L	S-SL-F
L-H	Q-Y-Y-L
L-A	LYY-AM
E-M	VSSRY
GS-A	V-GGS-S
D-R	YYS
AN-G	TA-R
D-E-W	PAVFYGD-R
GD	NYA
D-N	KY-RN
GG-V-R-K-P	IGL-YDIL-Y
YN	SFNV-L
TV	KFG
VT-A-V	IVTG-RK-Y
VT-Y	SSTSYA
N-F	YGSS-S
T-W-W	SYAIS
W-T-L-H-F-D	GIIIFGTAN
T-W-N-F	E-GKP-G-F
Y-N-E	SVSSA
Y-G-D	HGPFYW
HLAE	SY-S-Y
E-W-E	R-KPYF-W
R-Q-E-K	S-SFLYS
ESV-P-A-R	E-Q-ASGFT-T
L-N	ST
Y-EV	TSKN
NA-T-L-R-Y-R-K-R	TYGIYDLYVDY
N-W	YGQSLS
L-T-WW	TYA-S
W-L-I	GVILL-ITN
T-W-W	E-LGKP-G-F
GA-A-K	NIGTKV
K-K	DD-D
K-A	N-N
A-D-K	ISTD
A-S-V-L-W-Q-D	RSGYPDT
ME	L-Y
LE-S-E	QV-GYT-T
PE	SY
KS	DSD
D-E	K-R
L-E-KF-M-E	PHYYGT-YPMDY
AT	S-S-T-T
R-Y-T-D	PSGYVSLY-Y
R-D	D-TSR
I-H-Q	DY-D
NW	NTW
WF-N	R-RD-I
W-TI-IR-LW-F	DEGAPIL-FFEWGYY-Y
EE	S-S
E-T	N-Y
F-G-R-A-D	SYYGY
P-H-N	R-FW
R-Q-V	FWDT-W
G-LH	H-LWN-G-F
R-H-K	TTTTSG
AN	STA
T-AT-T	HYTT
Q-S	DYW
S-Y-D	L-R-R
KAF-TG	SASYGD
Y-W-H	CGSY
N-G-GS	N-Y-S-DSN
T-Y	LAFY
D-R	KY
R-S-S	YDNL
D-K	T-S
D-E	SY
H-EK-D-H-S	Y-SNGGSG-Y
E-V-S-V	RGGSSYW
L-T	W-M-L
CS	EYY
G-CI-W-S-L	ADGLTY-LLQYID
AR-Y-I-F	YDNLG
I-I	AISS-TTY
P-R	D-Y-GSN
Q-K	YSY
Y-E-L	N-KT
A-A	HYGT
AA	W-H
A-N	M-K
T-P	E-Y
YK	STA
P-K	S-Y
N-K-G	R-DPA-R
P-H-M-N	SS-GAY-Y
S-D	E-R
H-S-E	YAGSN-F
E-N	YW
H-P	P-E-Y
FSS	VSRGG
E-Y-N	YSRL
Y-N-K-K	GATS-E
N-V	YW
K-DD-S-L	RDYYG
L-N-Y	SYTTPP
S-F-L	NS-H
Y-FN	FWWR
KS-S	YDE-Y
D-D	FT-S
D-D-P	SFA
P-S-Q	INSN-AS
SL-IA-I	PAGRAW
D-K	S-SY
L-N-H	WTSY
L-K	YSFN
K-H	FYW
HN-KL-S-D	M-DSE-ESR
N-L	RS
R-K-N-N-Y	NYRYD
Q-S-M-E	HGN-N-Y
M-Q	GS-V-Y
Q-F	TYA
F-Q-HE-Q	LISTYS-Y
E-G-M	VMGEQY
N-I-G-A	Q-Y-SS-Y
LN-S-R	YYAY-W
G-R-R-YK	M-DSN-D-R
R-Q	Y-SYVTP
A-E-LT	HRN-Y-H
AL	S-V-L
CN-L	GYN-N
LL-V	AIDYY-GTS
LP	GM-E
N-K-H-K	S-SNN
N-T	Y-Q
YR	SNSW-Y
L-D	SDF
DS-R-G	Y-SYSGS-Y
N-L	R-WP
Y-L	SSD-TD-R
YI-T-Y-N-T	GKCGGGRCYSGLD
L-K	S-Y
K-R-NI	YWSE
R-R-N-Y	DWYGGD
R-R	PDY
WF	R-R
F-NW	R-T-GE-S-D
W-W-IR-NT-F	KYYFWSGYPPGEE
R-H	Y-K
A-Q-E	YKQF-L
Q-D	T-S
NR-I	NYY
ED-D-GN	T-TTS-SR-Y
AI-I-F-R	RGYGGYSED
GK	YADS
WKW	SNV
Y-W-L-I	IIV-I-N
K-IY	LGLVL
QQ-TS-TN-T	QS-YSSN-K-Y
TF	YLSS
K-Y-Y-W-Q-N	M-WGGGN-DY
E-P-VN	K-F-GYD
K-R-L-D	S-SFLYS
FDD	YYTT
EM-D	NY-H
Y-P-AC-Y-R	W-TDG-YTD
ME-L-H-D	AGTLF
SK	TN
D-RA	S-SY
K-E	FN-Y
H-D	D-Y
E-HD-H-R	L-RNKGN-T-E
SA-D-S	DYGTN
N-I-V-T	GPFR
I-T-T	PIF
QT-D	GYQ
E-HD	VHSN-N-Y
F-A	GSHV-L
FR	H-WWD-D-N
HR-D	RAHN-D
ND-KG	TSRY-Y
K-E-N-I	WEI-Y
QN	DYSM
S-QN	RINTET-E-K
IQ-GPS	YDGYSWD
S-F	Y-S
S-V	R-D
SK	YDE-Y
H-Q	DYY
R-L-K	E-Y-S-N
L-V	S-R
RF	GF-G
TA	KLA
LQ-A	F-R-Y
TL	S-D
LQP	L-Y-V
Q-A-P	SNA-N
DV	Y-AVS-N-Y
AL	S-N
S-G-R-Q-T-W	SSSISSNY
V-ND	RTSK
Q-R-D	SGSG
GY	DIV
R-D	Q-Y
D-D-Y	Y-YS
G-D-D-G-QGG-R	W-NNSGGTNYAQ-Q
E-Y-E	W-VH
N-E-F-M	GFN-S
F-M	SY
I-PF-E	YYS-Y-Y
E-VD-E	YVYH-DY
GH-Y	GNN
K-N	Y-Q
RY	SNSW-Y
N-K-D	SDY
R-G-W-D	Y-SFSGS-Y
Y-L	WD
D-ER-S-T	QS-ASY
P-D-E-V	AYKT-Y
N-V	T-A-H
V-G	G-V-H-ITD
R-T	DDYSTY
A-V	T-T
I-R	GL
I-RI	F-EENE
T-V-R	YYNLWT
T-Q-Y-P	QI-Y-Y
L-S-RS	YDNLPY
L-R	W-D
TL	R-SY
D-K	S-Y
NT-N	HNSY-R
K-D-P	E-N-S-Y-N
N-SL-K-N-K	IVMVFTD-RG
HW	W-DV
G-W	TYA-T
W-GN-S	ASSS-D-Y
W-NT-N	AVVFTD-A-Y-K-F
G-N-Q-I	E-D-N-Y-N
LQ	L-Y
W-G	TTHA-P
H-T-V	S-T-GRFY
YL-QF	YINYPL
Y-D-D-Q-K-K	Y-NY-YTN-P-K
K-F-F	E-R-Y
QD-H	GYNY
A-F	SGA
V-D-P	HYS-N-Y
H-T	RLRT-RN
Y-G-N-R-S	SNSW-Y
N-L	D-T
L-I	SDY
SD-L-G-R	Y-SYSGS-Y
K-C	WD
Y-M	YY
E-R-K-D-D-E-R-F	RVMYYW-SKY-Y-Y
FH	Y-N
SV	L-Y
S-V	Y-T
HS-F	QQGGAL-F
SV-H	SPS-D
I-N-RS-Q	HGNGY-Y
K-Q	YS-S
Y-Q-K-N-S	SCSARSCY-GP
K-L-M	SY-N
LL	A-S
M-P	SY
A-H	R-V
H-E	WPS
L-S-A-M	YDFWS-A
E-N	GSTY
G-K	YT-I
D-Q-I-N	KVQGRVEVG
D-EL	LHFY-H
DK-E	Y-D-D-R
D-W	RRGP-VN
D-E-E	K-DKY
R-I	S-Y
I-N-E	YSGGT-Y
R-E-W-NI	SRASGM
K-Q-D-G	S-ASSY
D-L-A-R	YDGS-Y
I-GE-R	R-Y-RS-Y
I-I-N-DI	IFGIVI
A-D	PP
T-E-K-DT	SGSINY-E-K
P-K-A-L-Y-LT	YSNNEK-Y
PT-V-T	YYSY-Y
Y-Q-VD	NYW-H
V-Y-D	M-H-N-K
TQ	LGN-M-D
E-M	SY-H
E-G-L	RSTY-L
R-D	SYR-H
H-D-I-LS	Y-N-Y-EY-Q-K
D-K-M	GGGV-Y
I-P-L	A-SAR-T
D-A	S-S-T
Y-D-I	PSGYVSLY-Y
LD-N-M	HSIRSRR
I-L	ASS
K-E-K	W-NKE
GH-K	GNN
N-R-T	Y-SQ
Y-G-R	SNSW-Y
L-N-D	SDY
R-S-L-DG	Y-SYSGS-Y
Y-K	WD
D-D-Y	SYMY
Y-S-D-KR-R-NL-I	WYQ-K-GSS-RLLIY
YI-I-Y-I	D-NLAS
I-N-N-E-F-P-Q	GVPVR-E-ED
E-RS-K	WSTYPL
ET-A	TVTGYS-T
T-T-P-A-S-T-E-E-WT	TYSGTTDYN-S-KS
R-R-V-P	ISI-RTS
K-N-SK-R-R	YYGYWYDV
RK	WGQ
S-AF-G	SNED-F
VQ-S	HYG-N
F-Q	WINTH-I
D-R	KY
R-S-PS	YDNL
D-K	T-SS
H-DD-H-S	Y-SNGGSG-Y
V-E-F-R-S	RGGSSYW
Y-W-L	YTTT
Y-D-N	GSGSG
D-NL	H-N-Y
N-N	STHV-R
K-N-D-N	SYW-H
K-T	Y-R
NNN	IYFD
TFT	GTA
KE	L-Y
F-TI-E	S-SN-YT
Q-N	FS-Y-Y
T-T	SY
A-G-E	YRS-N-Y
A-K-F	ENYGS-V
N-T-Q	FLYS
D-T-V-C	V-GFT-L
C-D	GY
K-P-Q	W-SAG-D
C-F-T-W-K-Q	PFSPWD
HW	W-NV
GN-W	NFA-S
WH-N-S	AISSSD-Y
W-N-L-T-I-Q-IH	AVVSSDI-Y-YWSK-F
Q-K-R	SNY-Y
RD	DDYTLD
R-S-N	YHW
W-K-D	YSNY
Q-L-L-T-Q-I-RA	GIIIFGTAN
W-H-E-H	DNPT-L
AA-C	H-N-Y-N
EN	R-Y
AA-E	W-GT-F-I
N-E	DDY-H
A-K	R-DPA
E-A-N	GGL-L
NG	TYVF
N-PG	SYSY-Y
E-E-I	SYW
I-R-K-D	FSD-Y-N
G-IE-G	GARDTW
K-K-S	HSN-N-Y
R-N-R	R-SNLAS
K-AT	HLEY-F
S-D	T-T
I-R-T	SYW-E
A-RSK	E-L-Y-H
T-E-E-S-R	ALALY
C-G-R	SSN
EDG	Y-SYS-N-R
G-R-E	AGR
N-D	KL
K-NY-Q-D	Q-GYT-S
Q-S-M	SFW
D-GD	NRS
Q-E-K	FLGR-DY
HHH	H-N-Y-E
HHH	F-GSHV-F
H-H	Y-N
Y-T	Y-Q
RY	SNSW-Y
L-N-I	SDY
SD-NG	Y-SYSGS-Y
S-K	WD
K-E-EP	LPKNF-Y
P-K-E	MD-K
E-P	R-N
GS-R-E	AGRFDHF
M-T	WPP
M-I-L-V-T	IIL-V-H
R-IQ-P	EA-EGEYRN
D-S	W-H-F
K-TS	SHW-H
T-F-K-E-G	E-NSN-R-N
S-K-I-K	RDYDYG-Y
H-F	QG-Y
T-A	IGL-R
P-S-K-D-YA	E-K-GSPNYHPSLKS
T-A-V	R-NWPL
A-T	T-Y-H
TN	L-Y
I-A	I-L-R
GL-G	DYV
G-G-K	E-YGT-STY
I-N	AF-D
S-Q-S	N-KT-Y
S-PT	SYNL-R
T-IQ	F-RN-VN-E
IQ-S	GS-Y-W
R-E-P	SY-N-F
S-N	F-S
S-SG	AYS
S-GC	WGD-K
SV-E	DGYYPY
PK	LSS-Y
TQ-LT	WINTYT
QQ-F-T	G-YYYG-F
N-G-R-K	Q-GNN
K-T	Y-Q
R-NY	SNSW-Y
N-L	SDY
SD	Y-SASGS-Y
L-Q-QQ-V	TSIY-Y
A-LT	SREF-F
T-K-II	R-Y-D-DAI
N-S-V	KTGDL
R-D	TN
A-GG-D	ENYK
N-DN	SKSG
D-E-G	Y-F-T-E-N
D-S-I-D-N	RGQLVN
F-SD-D-S	HTN-N-Y
Q-S-M-D	ST-IPW
R-Q	Y-Y
M-V-Y	Y-S-N-Y
E-D-Q	Q-GGA
L-QN	WNY-F
N-T-N	W-F-DNTE
R-ED-D-H	E-SSGGRY-Y
R-F-H-G	GEVRQ
R-R	S-Y
Q-NS	SGF
EA	Y-TYS-T
E-A-T-D-N	RGFL-VNYY
N-D	FN-Y
Q-L	YR
NV-T-I-V-QT	LRSL-YF-WLS
P-Y	TS-Y
YP	W-N-W
Q-Y	TAGMQ
GQ	WINTR
G-V-Y	EGPG
E-NR	HSN-N-Y-E
W-R	GS-Y
V-W	NYA-S
WP-T-A-D	TISGG-NIY
R-E-W	ENYGSSF
R-A-M	SYYSSPF
R-E-Q	YSYSGY-Y
GTP	WYY-GE
G-P	H-N-Y
PL-K	R-AN-E-Y
TN	S-Y
ND-K	HNSY-R
ND-P	E-N-S-Y-N
N-L-L-N	IVMVFTDMRG
R-S-E	HNN-N-Y
R-SH	GS-V-F
S-K-L-H	M-DSD-E-H
R-R-E	R-YYGI
T-R-N-A	QI-Y-Y
L-S	YDNLPY
L-P	W-R
T-S-L	R-SY
F-A	L-Y
VP-F	Y-R-H
TK	DY
HYR-V-PF	SNYVYPD
KAT	HGES-W
R-T-T	EYY
Y-Q-K-D-S-KG	L-DPEQ-NTIY-Q
K-P	DTAA
VS	Y-N
S-V	L-Y
VV	Y-T
HS-FN	QQGGAL-F
DN	N-W-H
D-S	SPS-D
WN	NSW
FD-N	RR-KD
WF-T-L-IR-W	DEGTPVT-FLEWGYF-Y
D-K-E	TLGDKY
K-S	N-G
GK	S-W
KGQ	E-Y-N-N
R-S	H-Y
DN	Y-T
Q-R	FFS
G-D	WGD
YS-D-N	RDYR
D-R	YNS
R-Q	DYG
QQ-A	WINTSN
R-D-I-G	WYNR
Q-L	SNGG-Y
I-N-N-L-W-L-Q-G	IYNLM-YYSTY
Y-N	VSTA
Y-I-EQ	HYSTPW
E-K-I	SYA
I-F-D-E	TISSGGSYTSY-K
L-A	QDY
PQ	GHSF-F
T-S-E	SNV-H
S-G-H-D-P	Y-NYN-TK
T-E-S	NWDV
S-Y-T-H	YGD-F
H-Y-K	NNED-W
E-M	DYY-K
RMK	N-N-GTL
E-R	GDGIHGG
G-N-H	NSGN-Y
N-R	H-Y
Q-Q	T-S
Q-SH	SFW
R-E-Q-Y	E-L-R-R-N
S-D-K-H	GNTMVN
P-P	TS-Y
Y-PS	W-S-W
I-LH	RID-S-GTA
SY-PD	Y-Y-GG
D-KP-K	QSIGSS
EKN-P	SSSL-F
L-EQ	VYG
S-L-K-GP	WYD-DN-Y
Q-K	DLRTG
VM-R-L	SS-S-Y
L-K	FHR
RK	Y-S
K-GR-LH	SGYS-H
LE-G	Y-HY
H-D-R-L	YRYDGW
QQ-Q	SQHSTYT
QQ-QQ-Q	VGDTIF
QQ-Q	DYY-Y
PEK	YSKF
E-W	TSG
K-W-Q	WWD-D-R
Q-M-F-G	ITSVTDS
K-E	D-D-K-Y
LE	R-Y
KW	GTHF-W
L-L-W	GNYL-AY
R-N	D-S
N-TVS-E	M-GFT-R
S-N	TYG
NS	WY
C-R-N-R-N	PQWEEDI
Q-IH	NYG
K-Q-I-K-H	WINTYT-T
Q-H-Q-R-E	YPHYYGSSHW
WF	R-R
K-W	N-W
F-G	R-T-GE-S-D
W-K-L-L-W-T-F	KYYDFWSGYPPGEE
AQT	HDSS-Y
T-Q-V-L	IIF-I-H
G-R-PP-K-C-A-QA	NDAPEEGM-W
IE	GTSP
Q-M-P-TT-A	IF-T-Y-Q-R
I-AK-Q-R-M-P	PDWE-GDSYD
Y-K-N	SFNV-L
TV	K-G
TV-D-V	STGGYN-Y
VT-K-Y	SSTSYA
N-K-P	YDGD-Y
P-K-T	SN-D-Y
T-R	L-E
R-FK-T-T	V-N-SGGTN
L-K-Q	W-GDGYYA
R-FL-E	QDVNTA
F-L	SS-Y
D-WH-E	YSGY-K
D-I-G-G-E	SYYS-Y-Y-Y
PE	STV
T-P-A-C	S-Y-YI
H-T	YS-Y
E-E-N-Q	Q-GYT-T
T-E-K	DYW
K-Q	YGD-D
T-R-V-Q-K	DYYGSN-Y
L-S-D-L-M	FKRQK-PI
G-T-DL	SYS-H
M-D	Y-S-Y-Y
D-AS-L	TWYY-F
N-AG	Y-EF
NA-G-W-D-G-GD-G-R	W-KRWGAVNYAR-Q
D-T-G	RVY
K-K-R-E-K-N-A	Y-ARDYYNW
D-D	S-NN
D-NY	WSNH
S-E	DYN-N
I-E-RQL-K-T	V-IKYGTTN-Q-Q
G-N	F-D
Q-R	FVS
GT	WGD
N-N-V-G	RDYR
K-R-L-F-T-E	ES-SNYGI-F
Y-E-T	KEVPY
I-S-P-ST	S-R-YY-D-K
K-E-E	YTL
K-G-L-G	HRN-N-Y
R-L	L-Y
L-R	L-E
K-G	GTHA
E-YF	AV-GVTF
QGK	NVA
DK-LY	EV-TD
S-E-K	S-SY-H
Y-K-SE-F	WSKHPL
E-T-F	GYT-N
P-Y-V-IA-F-E	LITYN-ASSY
KK-F	YDGRGF
V-K	YD
VR	TR-V
K-AVV	L-SDQCGFPE-C
I-Q-I	TS-Y-Y
W-I-TN	IREL-R
W-G	RGDAW
R-D-A-S	D-ANY
G-N	TN
A-T	S-H
S-R-G	SFQT
D-G-E-QG-N	SAHGGS-Y
G-GT-S	SRDHF
A-T-K-NG-I-T-G-I-S	YHEGSGYYYRAG
R-T	ISSW
I-L-T-D	Y-AASYR
LF-L-K-D	YGS-SEW-K
Q-L-I	TDN
D-K	R-Y
K-G	GNTL-W
R-G-E	L-NYK-V-T
R-W-S-Y-L-K	GYYGD-DW
Q-V	Y-N
S-T-R-A-D	FWGN-W
AA	SG
D-A-K-T-E-P	WWD-VKR-P
G-A-H-S-D	SVITTG-Y
GL-K	GNN
K-N	Y-Q
YR	SNSW-Y
K-L-W	SDY
R-G-WW	Y-SSF-S-F
K-N	WD
N-S	P-EY
W-D-W-Q	W-SMV
Q-G-L-Q-L-R	SIIIFGTTNY
W-HQ-Q-H	YFDTYN-Y
QT-GW	HSN-N-Y
M-DK	S-G-H
D-E-D-R-E	H-SSGSRT
D-RR	DVNT
RE	Y-Y
RPC-K	QGISNW
L-F-R-E-G	Q-YSSF-T
P-TL	SYA-S
LT-EP-Q-D	AINSQ-S-Y
K-P-K-L	W-DE-F
V-NR	AGYDVH
R-N	QSYDS-RG
N-GR-G	Y-GGS-Y
K-T-R	EGPGD
TD-K	NEY-W
D-N	SYW
K-N-K	N-Y-D-Y
K-Y	D-NYG
L-I	H-Y
Q-I	FWS
KG	GYG
G-D	WGD
G-V-A-N	RDYR
W-KS-Y	ED-Y-R
N-K-E	YWST-W
D-V	YG
N-VK-E	WWD-D-YY-P
V-Y	R-YGNH
K-Y-G	D-DGK-Y-N
GE	R-Y
G-D-N	L-R-DS
KT	GSH-Q
VT-TT	NYGMN
T-Q-V-L	W-NTFT
T-E	GT-D
Y-N-TE-P	YSSN-K-F
T-D	P-T
TP	AY
P-D-N-Y	WGD-N
R-VC	DPYGS
NWF	YGSSPS
LW-W	SYAIS
W-L-L-F	GIIIFGT-N
F-W-T	E-LGKP-G-F
D-Q	SSW
Q-L	YN-Y
D-M-Y	R-Y-SGS
VD-I-W	EEHITF-G
C-T	WP
M-K-K-T	IILDV-H
R-I-K-P-Q-M	GEEGEYDN
L-L	FKRQK-PI
TA-L	SYS-H
M-D-S	Y-S-Y-Y
A-L-L	TWYY-F
E-GK-NK-Q	SWNGPL
N-EE-F	Y-NNS-YTN
NQ-QE	VPGNNW
L-HV	F-GSS
RN	SHSW-F
EG	FI
GE-Q	NHW
Y-Q-GE	RS-SI-H-K
P-Y-P-E	YYGS-D
QK	Y-Y
R-E	VT
E-T-L-S-A	W-NYTGEPT
S-L	LET
K-E-T-F-E	E-NLWGNY-NW
IR	AIDEY
P-Y	YVGSS
G-M	F-Y
A-GK-Y	V-DIT-E-Y
A-YM-A	TYGY
Y-D	D-H
DR-R	DAN
Y-G-G-M-D-D	KVIYYQGR
Q-W	F-A
W-Q	Q-FWG-F
PD	IYA
PD	R-RS-SN
P-TW	QMG-D
K-D	DI
R-G-D	Y-EF
N-V-D-GS-D-G-T	W-NSGGTNYAQ-Q
D-K-N	E-D-W
PD-N-I	RNNQRPS
L-P-H	G-D-K
I-E	G-N-S
E-L-S	GYY
F-R-H	TYY
S-R	GSS-T
N-R-T	L-QF
A-T-D-I-GS-G-R-K	W-KQYGAVNFGGG-RD
R-G-G	RVY
D-K-A-N-K	GDSSW
E-N	T-T
K-E-D	YDTY-W
K-T	S-T
T-E-D	SFW-H
D-GT-KG-E	M-DPSE-K-R
D-F-T-E	VRR-Y
VQ	SSSY
N-H	TR-T
N-FM	YGTSAI
LL-R	QV-GY-T
R-L-FM	ELP-H
MF-R	SFDPE-ESI
LL-R-N	PDPDA-I
I-G	Y-L-Y
I-I	Q-S-D-L
I-KR	H-FWD-D-R
IH-P	EGY-I
E-T	V-YS-T
A-E	GH
A-Y	HH
Y-A-I	DFRY
H-LR	Q-S-Y
FL-D-D	RSNW-L
ED-R	W-STG-Q
E-L-LR	SGYRD
KT	STF
K-Q-T	D-STR
Q-K	G-R
S-P	W-S-W
R-P-P	NYW
P-RT	VGQ-Y
N-G-K	Q-GNN
K-N	Y-Q
Y-G-R-S	SNSW-Y
N-K	SDF
R-G-W-D-N	Y-SYSGS-Y
KK	WD
W-Y	Q-H
YGS-K-L	QQTDSWPT
Y-R-Q	R-E-N
Q-T-I-Y	RYDPYYAM
NN	EIV
N-N	L-EF
KA	EL-H
N-T-G-GG-D-S-A-GG	W-K-VTGAVNFGSP-R
G-G-G	RRD
K-K-N-A	YTGG-GW
D-G	R-SY
GT	D-K
Y-SG	RSS-Y
H-L-M-L	RYW-H
L-I-E-R-SK	A-Y-N-DTSY-Q-E
Y-L-E	DYGY
I-D	MY
I-Q-G-K	LGGYF-R
G-F	DYY
L-K-P	F-AN
TM-G-L	VYGNYP
E-R	KY
R-K	WWD-V-R
RF	DYD
PG	H-N-Y-Y
R-G-G	SGYY
P-R	YD
L-S-L	FKR-PI
T-L	SYS-H
LD-M	Y-S-Y-Y
D-AT-L-L	TWYY-F
QS	SNS
HP	NNT
Y-T	L-Y
N-T	D-T
Y-TL	RG-WP
Y-L	SY-H-H
YI-NT-Y-LT	GLSRDNSGFTGLD
N-T-T-V	GLVYIDG
T-D-Q	THW
D-A	YN-N
V-L-W	HIL
A-D-I	Y-T-P
R-M	YD-L-R
P-T	NY
HM-P-V	W-NNT
H-T-G	DNPYY
H-I-Q	SY-S
QH	AA
HI-Q-M	Y-A-YGY
R-QH	YSY
D-D	D-D-R
GVP	SGS-DFI
VF	SNRW-F
R-D-F	N-W-Q
F-R-D-RM	A-YRD-D-K
F-Y-P-D	A-LYY
I-CI-W-T	TSGY-Y
TN	IREL-R
GN	M-R
W-N	RGDAW
R-V-F	HTDGT-Y
R-GG	NIQL-W
V-T	SYG
G-S-V-S-R	W-SYS-N
T-QH-F-R	EGSSSSGDYYY
EV	S-Y
VEQ	GSSIPF
DY	WGGGT-Y
K-Y	ASYN
S-V-D	YNR
V-E-S-L-D	AGIRW-W
AV-I	MSSY-L
FV-I	GNA
V-I-VF	WINHS-DTT
IG-A	Y-NEA
DN-WE	SNTW-Y
H-R-F	DSD-Y
M-H-D-D	YGYY
G-KY	T-YK
Y-L-K	FFG
N-S-W-S	SHYCLDC
S-D	SFW
SL-W-E-K	FQPSFTLTSY
L-K	S-N
K-A-H-R-G	SN-WPR
R-N	SYG-H
H-Y	W-D
NV-G	EPPY
PQ	S-Y
Q-F	GN-Y
R	FTFS
D-F	S-A
FD-FN	AISGSGGS-Y
D-Y-H-V-I-F-DFT-Q	TYPQRRGPQNV
K-R-S-ST	ES-SNYGI-F
R-E-R-T	KEVPY
I-SS-I-T	S-RSYY-K
K-A-R	GYT
T-R	I-E
T-A-WM-G-G-S-G-D	W-KKFGAVNYAH-Q
D-QG	RIY
D-K-NN	DGS-W
N-GA	Y-EF
N-T-N-I-D-GS-D-AG	W-KRFGAVSYARQ-Q
D-G	RY
K-E-KA-N	ARDYYNW
V-R-E-Q-E	DIGNY
E-K-T	GSRSG
T-Y-K-F-E	FYYSR-R
P-Q	G-SYV
QP-PF	TWGAGIL
Q-F	AMS
FP	GISG-S-Y
QQ	FSGKD
ND-TI	HNSY-R
DM	E-N-S-Y-N
N-S-S-N-K	IVMVFTD-RG
D-R	YSISDI
EI	N-Y
E-I-Q	Y-GGR-I-F
I-I-I-D	F-AV-V-GTYST-Y
P-R	SN
R-PN-F	W-DSN
Y-P	NI
P-R-F	Q-Y-N-Y
RT-Y	YLSSY
E-E-S	SSGGNY-Y
V-E-G-T-F	AYSGSS
N-N-G	Y-EF
L-DG-S-R-GGD-R	W-NSGGTNYAQK-Q
DN	E-D-W
Q-N	TN
W-P	W-Y
A-N-L-Q	YN-Y-L
RT-Q	DYA-S
QR-A-E	Y-TY-N-I-K
RQ	GV-D
ATQK	W-DSIN
A-K	YY-D
D-D-N-E-E	NYGI-F
RD	SKEV-L
E-R	W-H
RL	E-N
E-E-T-E	W-GSPY
K-K-K	DDD
K-E	S-NL
G-K	GYY
K-GT	E-NPRT
E-E	RINWA
R-V-S	QG-R-D
S-M-R-D	HNSY-R
G-K	S-W
D-Q-G-KD	E-YHS-STN-K
K-S	D-DDL
K-R	DI
D-GG	Y-EF
A-R-G-D-I-G-N-DG-R	W-LTSQPSYPS-Q
D-N-T	RTF
A-K	R-D
N-G-K	S-SNN
K-N	Y-Q
N-K	SDV
R-D-L-S	Y-SYS-S-Y
PA	WDSV
Q-R	T-T
D-R-P	D-NY-N
D-P	DRGYY
P-LH	DKY
I-L-FY	WDA-GT-L
KR-Y	DSW
I-K-Y	I-Y-D-D-H
I-R-P-H-S	L-L-QSSN
EE-P	Y-N-K-Y
LPK	GT-F
L-L	DYA-N
K-V-N	Y-TY
L-L	YDDY
D-R-D-F	YSY-T
F-DW	HYG-R
H-W	GM
FP	Y-GSV-D
K-Q	Y-P
KE	YDN-W
K-K-K	QV-G-NIK
K-E	DTY
K-T-KN	R-DPAN
K-Y-F-N-Q-F-K-K	E-YYGNYGVY-Y