DY	R-L
Y-Q-S	R-N
GH-F-Y	NKG
T-S	PK
AY	P-K
S-GGS-Y	G-T-K-D
D-YGDYVGR	Y-K-Y-L-F-KG
SDY	K-T
GHGF-R	T-E-T-E
GYG	N-E-L
TITSGGTY-Y	TL-QN-E-M-E
SLAGN	L-T-Y-E-T
SGY-Y	G-M-K-A
L-N-ES	F-R
GYS-T	L-G-F
GY	R-L
DYYDST-Y	S-R-G-W-F
H-D-Y-N	R-MSI
L-Y	A-S
A-N-E	M-A
Q-TNED-Y	SIR
DDF-H	Y-R-I
YGV-A	NA-S
HSN-Y	R-E-HD
GSRVPL	H-F-AE-D
H-YWD-D-R-P	F-D-R-D
R-R-YE-N	H-G-DS
W-N-P	N-E-A
N-H	S-A
AIY-N-DTS	PS-NK-E
S-Y-W	N-S-S
FWS	Q-R
GY	GK
WGD	D-G
RDYR	Y-T-N
SV-SY-Y	SV-I
YHSY	I-K-P-E
SYY	H-F
W-Y-S-NTE	T-AG-NV
SED	H-A
Y-D-Y-H	V-A-F
F-L-Y	F-L
S-ST-V-W	F-AE
RYSMS	D-L-F
Q-NS-S	F-ED
AS	FF
G-DY	F-LK
W-D-F	KL
T-A-H	QV-L
IISY-KKY	F-L
SIAAAR	VQ-R-L
W-D-W	R-K
FT-S	E-R
SYSMN	H-E-R
SISSSSSY-Y	R-D-E-LV
Q-GA-W	R-F-Q
QSNRA-A	L-N-W
GTY-H	S-P-T
YPAGGATYY-K	SR-Y-R-W-R
WWAWP	L-VF-S
W-ST-I	N-G-D
HYSP-W	K-I-D
NYG	L-I-T
W-NTN-E	T-K
EDNFSL	I-NT-W-K-I
S-SH	Y-T-S
I-Y	SR
WSTF	K-S-KK
Y-YIN	D-KK
YDGS	SRS-K
GQSF	A-N-K
T-T	G-N
SSW	S-D
E-HN-H	T-D-S
YG-Y	DS-T
V-NH	Y-H-E
WSGNPW	H-QR
R-T	Y-S
T-SGG-H-YY	N-Y-Q-R
GDG	S-SN
RSNW	A-E-H
TY	AG
IIF-K-H	S-R-Y-E-Q
SGSPF	D-AA-S-H
GTWL	E-Q-D
A-TSLAD	QK-N
F-L	L-W
PKGYFPYDY	Q-I-H-VD-T
S-FLYS	HT-Y-L
EV-FS-G	R-F-E
KS	E-F
RLALVR-W-Y	E-LD-R
SR	DS
SD-ST	R-AS
R-YYDST-YYPDS	R-WG-G-KA-D-R-Y
GYNY	QD-H
Y-DIH	TH
S-A-Y	A-V
HYS-N-Y	V-D-P
RLRT-RN	H-LF-T-C
HYSTPW	YIIQ
SYA	K-I
TISSGGSYTSY-K	I-F-WD-E
QDY	I-Y
Y-EF	N-T-A
W-KRWGAVSYARQ-Q	NA-G-I-G-D-G-E
ARDYYNW	K-K-K-N-A
QVISNY	HH-PL
YENL	Q-IH-Q
S-Y	H-N
Y-S-GAS	PS-Q
GTFYYYF	N-A-I-P-K-Q
Y-Y	E-H
DIQ	A-T-N
F-EE	T-G-A
W-NRHGAVNYPRR-Q	N-G-D-I-GS-DG-N-R
DDW	KA-N
Q-GDN	N-GH
Y-Q	Y-N
SNSW-Y	YN-R-S
SDY	N-L-K
Y-SYSGS-Y	DGN-R
WD	S-K
SNRWPF	T-AG-I
S-W-H	Y-Y-R
E-ISY-R-N-E	G-Y-R-P
ERGDG	R-YP-T
TGL-H	Q-LR
Y-TYY	RL-T-T
EYY-YT	RL-G
RLHA	Q-P-Q
EV-GYS	SV-T-D
SGY	M-T-N
EYYSVTDY	N-A-KD-S
EI	DE
Q-Y	E-E
SLSASY	WED-R
SGGYY	F-KM-V
Y-Y-S-N-Y	R-V-D-N
LDGYT	V-R-NK
YNNW-W	N-TN
Y-ANGRPDYAG-R	A-DG-I-G-AG-S
RK	D-T
GTAGSLL	K-N-T-A-T
H-Y	R-Q
Y-T	AN
RDYR	N-V-A-G
YDCN-CH	EL-P-L
PMN	GL
GIG-S-N-W	L-E
GLYN-YT	GLL
R-SQ	E-H
GTD	Q-E-K
SN-D-Y	R-T
SYW	A-P-R
M-H-E-R	T-A-L-G
L-PGGT	R-P-G
Y-EF	N-GG
W-KRGGAVNYARP-Q	NA-G-I-D-G-G-S-T-D
RVY	D-V-T
DYNW	K-KAN
N-F	VI
YDKL-P	P-W
Y-S-YTN	E-L
FW-G	Y-W
NY-F	G-SP
SKEV-L	W-S
T-SSGG-N-Y	W-SGG-P
L-Y-Y	P-D
S-Y-Y	SK-H
T-T	T-S
DYT	S-P-V
NPNSG-SIY-Q	V-H-T-F-T
VRSK-R	H-G-K-Q-L
LGPSYD	HN-K-L
GNN	G-K
Y-Q	K-N
SNSW-Y	Y-G-R-S
SAY	W-L-K
Y-SYSGS-Y	R-G-W-D
WD	KK
EKY-Y	I-Q-R
T-GGTFF	FY
SYW	RK
F-Y-D-D-R	F-RK
L-ANRGGG	IR
Y-N-K-Y	V-A
W-S	N-K
SSS-SY	DQ
PRAT-YS	D-K-G-I
Q-Y	D-T
FSKL-Y	P-PG
A-S	L-K
RYD	K-L-G
SG-Y	K-P
GLLYY	A-L-L
SLYA	R-V-F
YINY	G-Y-A
TRDTSK-F	Y-L-L-Y
GVDYF	F-GL
DY	I-Q
FVFFLPY	Q-H-K
TYR	S-I-Q
YPGN-DTT	S-TF-N-NR
EGIPQL	I-GD
H-D-Y-E	WG
F-GS-V-P	W-L
T-A	LN
TISSGGSYTY	F-EN-L
HPPTVGDAM	W-NL-L
D-K	T-P
EV-GS-R	HA-T
RNY	D-F
YS-GS	T-A
TVWYYTS-T-YDH	VP-Q-NP-H
AGYDVH	V-NR
QSYDRSSG	R-N-N
Y-GGS-Y	N-GY-N
EGRGD	K-R-G
Q-Y	N-I
YGST-L	I-NS
GD-Y	Q-H-V
Y-YYS-STD	SV-L-Q-E-K
IFGVG	S-L-K-I
Y-L-R	IGS
Y-IS	I-Y
YW-N	H-PI
M-E	I-K
HF-DY	I-I-S-A
Y-Y-N	V-V
LQGTHYPV	G-V-G
AYY	I-V
LYSL	G-V-V-I
SVSSTY	P-M-T-EH-V
GASSR-T	E-R-Q-N-S
GSG	R-E
YGSS-R	E-VI
SYS	T-N
DPIAA-Y	E-L-Q-Y
S-YYSG-KNL	L-E-S-H-E-R
GI-Y	E-R
Y-YNS-GTD	E-E-S-R
RDYGTY	E-K-V
H-IGL-R	H-A-T
GHY	PD
E-K-SPNYHP-K	P-P-D-KA-YA
NWPYL	P-P-F-P
D-Q	K-E
R-D	K-N
QY-ET	T-N-E
W-NTNGAVNYAWY	N-N-G-G-I-S-D-G-N-G
RRS	G-G
RSEW	K-D
SIE-W	MR
H-AGYS	M-L-G-P-A
Y-D	CA
DN	T-S
NNYA	R-V-F
Y-NY	A-F-E
GYDYF	F-GL-A
DIGNY	RP-V
Y-R	Q-W
GGTN-W	VPE
T-G	S-H
WGD-N	E-S-D-A
NYYG	H-VV
D-D-Y-N	R-D
WQGTHF-R	DA-R
GMS	FE
SIR-Y	EF
Y-GSS	FR-D
S-S	DD
SYS	R-E
Y-YTSY-K	H-D-R
YWRW	D-D-E
Y-Y	M-P
YTSSS	P-P
SYW	A-E
W-SYN-N	P-R-S-H
EGDG	P-CH
S-SH	Y-T-S
I-Y	SR
SG	RW
WSTF	K-KK
YDW	R-D
Y-YIN	K-H-K
YDGS	G-S-S
Y-H	FI
F-L-Y	IF
NYA-N	T-Y-M
EG-D	F-M
L-Y	I-S
TLHS	S-ID
T-T	P-E
GFW	P-T
GN	L-C
KS-R	R-Q-T
YSN-VD	C-W-D-I
YSTNQ-Y	P-K-SD-N-G
YYSY-R	GP-S-S
SYV-H	QN-S
Y-NYN-GTD-K	S-N-L-SP-G-T
E-NYAT-A	S-NQ-Q-G
T-TI-F	N-L-E
W-S	T-P
L-N-NGGTS	I-V-NT
RYGR	Y-V-T-E
NG-Y	I-I
Y-PYV	A-G-G
W-S	R-P
N-Y	R-P
E-YD-LEYYYDYY-M	P-RK-IHI
N-GSYY	K-KD-A
ED	K-K
YDD-F	T-KN
Q-RSK-Y	T-S-D
YPFY	T-K-D-N
GY-Y	Q-HA
Y-IH	T-A
GA-Y	A-F-V
H-S-N-Y	PT
RLRT-RN	FL-E-T-D-H
GT-W-W	H-F
DYDMS	R-F
GILGG-ER-Y	F-D-R-T
H-SPGYT	S-G-P
TSSY-Y	M-A-R-SL
Y-SN	R-F
SWGI-R	R-S-Q-D
NDY-ITN-K	DH-R-E-F
WISDF-D	DH-R-R
D-GIS	N-L-WL
HNSA-Y	N-L-QA
RN-NYQ-Y	A-Q-NR-T
ESYYG	NQW
NFP	V-S
SD-GGN-Y	E-D-S
DSY-F	I-G
NNED-P	G-R
R-CYE-S	R-F
E-HMYT	R-G-F-P
QV-GYS-S	F-D-S-P
TY	P-I
L-S-N	P-K
N-R	K-I
T-R-WF-Y	I-P-F
ASDY	KD-K
ED	KK
Y-S-W	V-LF
S-W	D-Y
I-YGD-D-K	F-D-K-L
L-YYHDSSGYY	FY-H-K-V
QS-LYKS-K-Y	Q-PT-V-N-I-H
YYSI-R	H-T-S
ADDYD	GS-SP
SGN-H-Y	S-G-N
FWS	NN
K-S	G-Y
S-W	Y-N
E-F-S-N-N	NQS
R-FYSYG-YY	E-Y-I-V-S-N-N
L-Y	H-T
Y-IRYT	DE-M
EVQL-SGFK-K	F-M-P-N-I-K-N
DTS-H	YF-D
SSN-L	K-I-F
S-HF	YF-L
LGS	IGD
SRSG	D-A
YGM-F-E	IR-H
Y-EF	N-AG
W-KRLGAVSYARQ-Q	N-T-W-N-D-I-G-R-GG-S
ARDYYNW	K-N-K-K-N-A
TS-Y-F	TI-C-C
SREL-W	I-GP-V
Y-N-Y	I-S-H
HRGN	H-Q-P-P
TSS-Y	R-E
SWEIP	RN-R
WWSASKYY-K	N-W-L-P-E-G-G
Y-GGY	S-ET
VHSN-Y	E-SD
GSHV-L	H-EA-F
H-WWD-D-S	FR
R-HT-D	HD
NY	VG
HSYSSG-I	M-V-P
NYG	VD
SISAG-DK-Y	G-D
TSRVYF	A-V-D-AM
DSIGK	E-LQ
LGSYF	K-FK
DD	R-K
FTHNS-V	F-PK
Y-L-YY-D-K	F-I-K
WYGG	F-R
W-S	SY
WN-GS	PT-H
N-D	N-K
YDEF-L	E-DK
T-T	K-F
D-N-H	K-E
Y-YYN-G	M-W-Y-L
R-YRYD-F	E-A-W-H-E
YGV-SF-E	IR-I
SVSSY	RY-H
RSNW-Y	H-N-G
GPS-F	YD
E-NDA	H-E-H-R
YANY-W	N-E-F
W-NTHSGV	F-E-N-Y-L-D
LTS	LG-R
I-YGNN-V	F-N-L
N-RT-Y-T	DPN-R
Y-L-Y	RT
Q-NYNY-L	RL-L-T
D-Y-H	V-Q-E
R-DP-N-YTK	E-T-V-E
Y-SY-DD	R-AK
R-R	WF
N-W	K-W
R-T-GE-S-D	F-G-W
KYYDFWSGYPPG-E	W-W-KI-T-F
VHSN-Y	E-H
ASLV-L	F-A
H-YWD-D-R	F-D-R-E
R-R-YE-N	H-S
L-N	SL
HWNY-L	IP
DD	R-F
WGGGS-Y	I-ES
DGHET	SS-Y-H
ES-DSYGHSF	S-T-N-H-D-R-D
GNEV-F	TH-N-I
D-Y-Y	S-L-T
SDGGSYTY	E-KL-R-T
Y-YD	TH
DTD-Y-N	K-D
RGHFYGSG-W	IK-S-I-N-I-I-N
N-K	V-T
L-I	LI
W-M-V	I-T-L
DYY	C-GS
DDGYYDR-YY-VD	S-I-G-IW-L
SGN-K-Y	E-S-DR
DYTY-L	KD
TYW	Y-D-S
LPGS-S	S-L-TR
SGYYGN	K-K-VF
H-N-K-Y-E	AP-D-R
Y-Y	R-D
F-GS-V-W	RP-P
Y-N-N-Y	AP
QYYGF	A-RT
LLIY	KA
NRAT	KP-L
IT-S	ES-D
NSG	DP
IWY	P-P
ND-DY	PD-K-L
T-T	Q-A
NYG-N	A-G-R
EGG-N	R-D-N
YRYS-R	L-Y-F-C
NYA-H	D-S-L-E
GISRS-GDID	L-E-K-ER-K
GGFGS	E-C
GNTLPR	H-PA-A
Y-Y-K-K	APY
GSY	HW
LGDKY	K-Q
QD	Q-K
W-N	F-A
GFI-F-TAM	F-L
PLSRG-Y	L-QYF
YGNF	LK-FE
VHSN-Y	E-R-DH
SSHV-L	FE
H-WWD-D-Y	FR
R-T-D	HD-R
D-S-Y	K-N
L-Y	K-I
Y-RLHS	S-E-QK
GNTL-R	S-W
SYT	Y-R-W
T-SSGGSY-Y	WE-L
DGND-D	W-Y-V-K
S-Y	E-Q
SVMI-M	Y-Q-I
TFS	Q-E-D
Y-SRTSKT-Y	I-D-S-S
GRF-D	D-Q-P-E
NSY	WE-D
SYA	D-Y
IIF-T-S	DY-S-GD
VG-C-TSCNR	R-W-DG-E
SNT-H	QY-E
L-Y	M-R
W-D	A-Q
T-S	H-W
ITF-N	P-P-A
E-Q	E-Y
GPIVGAPDY	YM-Y-A-Y-R
H-N-Y	K-V
HLEY-Y	KG
SYW	VD-D
R-DT-I-Y	S-SEH
YLKYDGSTYR	K-I-G-LT-Q-V
T-Y	Y-P
YY-SRP	R-LV
YRQ-Y	G-I-D-V
YNYDD	G-R-V-D
PLQS-Y	RGP-F
V-Y-D-S-F	P-H-Y
DYGSD	RG-Y
SYGYTY	Y-H-G-P-N
MVYPH	L-LH-Y
SYSS-L	F-PA
DYA-N	L-F
Y-Y	G-L
GGTGF	LD-F
H-D-N-Y	M-H-N
TTHV-P	NW
NYW-E	M-A-W
E-RL-H	W-M
GGAVGA	MH-N
VHNN-Y	Q-R
F-SDLAYT-Y	Q-DP-R-Q
YIG	E-T-T
Q-ITRH	T-N
L-E	T-N
W-RGGGVNYARQ-Q	T-W-D-I-G-N-R-G-D
RVY	G-V-G
RRHCN-ADCFNW	R-E-H-A-N
NKQT-L	EE
R-G	EA
R-R	WF
N-W	S-W
R-T-PGE-S-D	F-S-N
KYYFWSGYPPGEE	S-W-RI-W-F-T
AGYS	E-K-FE
KS	EQ
Y-S-S	PE
SGS-Y	R-I-K-N
HGS-H	YQ-D
LLTTV	Y-I-IKE
H-N-N-Y	F-HD
GSHV-L	H-F
H-WWD-D-S	FR
R-HT-D	HD-R
HYG	QH
WINTYT-T	Q-Q-I-H
YPYYYGTSHW	HIGE-E-Y-Q
IYNMPI	RH-Y-F
SYAMS	AD-F
AINA-RTYYAD-K	F-A-GYE
GKGYVF	D-RF
SY-Y	E-Q-T
S-N	Q-Q
R-Y-R	L-G
DAW	Q-G
E-RS-VN	G-SQ-G
WS-L	Q-T-P
SDY	E-T
GNGNYDL-Y	S-CD-N-H-V
N-Y	A-T
L-H	A-S
Y-TLQP	L-DS
YD-L-R	T-K-T-S
DYS	S-K-N
WINTE	T-N
N-RN-K-Y	Y-R-S
SY	P-T
WSGGN	S-I-R-Q
VGIYYEGA	T-VA
YNNW-W	NNT-G
SGGRTDYAG	D-I-G-G-S-D-AG
RK	G-G
GTAGSLL	K-L-N-E-T-N
F-EF	T-G-A
W-NQWGQVNYART-Q	N-GN-G-I-S-DG-E-A-R
RVY	D-T
D-EW	K-N
D-N-Y	N-S-P
SFSY-P	R-G
D-S	K-R
V-W-D-TN-Q-QG	R-KP-E-G-V-P-S
E-RS	DR
D-RL-F	RL-P
LGS	GD
SRRPT	N-V
YGV-AFKE	IR-H-T-I
NNY	Q-R-S
DASK	R-L
YLQY	D-P-C-P
SYT	PE
W-KRW-AAH	CH-G-C-P-S
GSFW	DN
NYGMN	V-NK
WINTY	KNN
D-YGSTYP-Y	K-V
YNSY-Y	SG-Y
SYW	N-K-L
E-LEIGMTN	K-L-L-S-GS-Y-T
DYS	NT-G
Q-GNN	N-G-R-K
A-Q	N-T
SNSW-Y	R-G-S
SDY	K-L
Y-SYSGS-Y	DG-W-N
Y-N-K-Y	L-F-P
YYRTP	Q-L-PE
VNHITI	P-QE
T-N	T-I
IF	V-I
NYYY	K-D
T-Y-Y	Q-N-N
SWEI-Y	N-F
D-Y-Y	K-N-Y
T-DG-SY-Y	Y-S-N-N
D-NGKDGGD	Y-K-CS-K-N
L-SN	V-K-F
S-N	F-E
Q-T	D-Q
SYN	R-Q-P
Y-N	R-G
E-LGALR	P-E-V-W-F
Y-EF	N-GA
W-KRWGAVNYARQ-Q	NA-W-I-D-GS-D-G-E
ARDYYNW	K-E-KA
H-Y	L-Q
FWS	Q-R
GY	GK
WGD	TG
RDYR	G-VQ-N
R-Y	Y-Y
YRYS-R	AF-L
NYA-H	D-C-L
GISRS-GDID	LC-D-E-Y-N-K
GGVGS	E-A
SDVY	KG
E-RRPS	Y-R
W-W	GS
QV-VSGIS	TR-E-H
I-GH-GTD	R-N
KS-R	E-K
HFYTY-DV	N-I-K-K-S-K
ES-DSY-N-F	R-YT
SNED-L	GD
T-S	H-D
T-SS-Y-Y	H-L
RAFDSD	L-V-TT
YGN	K-NL
L-Y	KF
R-SLES	V-K-K-K
GF-K	D-K
DTY	S-V-E
DAN	KE
DYEG-AY	K-E-V-Q
TYTID	V-G-RP
VGDT-QFY	RRP
SYG-H	E-P
WSG	R-E
YYRY	PYE
DSD-Y-N	RH-D
WQGTHFPR	DA-RH-E
Y-H-GSS	A-FR-D
TVSFHY-H	VT-N-L-L
L-Y	Y-Q
A-SNLAS	Q-F-Y
YS	D-V
RYA	TS
E-TY-D	S-W-LY
H-D-Y-Y	E-IW
NVEL-R	W-LY
NYW	Y-D
E-RL	Y-Y
PM-D	W-K
RN	K-E
LYS	R-N
W-V	E-Y
V-GFN-S	N-F-M
VY	D-N
YYS-Y-Y	I-P-E-K
YVYH-Y	E-D-H-E
DSS	K-Q
A-SS	Q-A
W-SIG	I-NK-K
SYGGGN-Y-K	Q-K-Q-N
RDCLLCAD	Y-K-YQ-Q-I
W-N-P	N-PA
AIY-DTSY	PS-K-E
V-Y-W	N-E
SRF-S	GEF-R
GYD	Y-W
WGDG	W-K
YYYG	F-S-C
FWS	Q-GR
GAG	KG
WGD	TG
RDYR	N-N-Q-G
NYG	FL
W-NTY-T	F-Y-F
Y-Y	R-L
NNVD-W	WSG
Y-Y-TY-R	N-I
I-T-Y	W-L
Q-SNY	P-D-T-N
DFTL	N-GN-A
YGN-DTS	TN-S-K-A
YYD	I-N
W-Y	P-S
Y-S-YTD	HP-R
E-F-NR-WY	HP-K-E-P
ASYY	KC-R
ED	R-K
R-Y-RSK-F-D	M-C-P
VF-Y	MG
LGDKYV	K-Q
WDSSA	Y-H
VI	LF
GFI-F-TAM	F-L-L-A
LSRG-Y	LG-F-Q
GYTL	R-GS-L
SYW	S-Y-K
E-DSD-Y-NY	K-Y-HR-IN
Y-YGTSY	R-D-L-R
Y-Y	L-E
YN	R-K
SNS	D-F
WGD-D	F-MD
LIGSWY	FI-E
DI	A-T
Q-S	T-N
F-QW	N-G
L-KVFGAVNYARQ-Q	N-T-G-W-I-G-S-D-G-G-T-G
RIY	D-G
DDLKW	K-N
YADY-W	NW-K-N-V
TA-D-Y-K	W-R-N-T
Y-PTGHY	P-P-D-W-D
Q-S-Y	P-T-D
DFTL	N-NG
YGN-DTS	NT-S-K-S
YYD	I-A-N
HNY	W-T-R
N-D	S-E
FWST-R	K-N-G-L-D
V-GYT-T	H-Q
SYW-H	RH-T-L
D-N-S	S-N-L
DDGYR-Y	K-R-R-S-H
D-R	K-D
W-SSSD	R-P-IG
DYH	N-H
W-HNS-D-N	A-LG-H-R
RSVDYYYY	V-S-S-Y-D-T-A
N-R-Y	D-L-S
F-I-E	S-L-K
I-T	W-N
DYSV	WN
GW-L	L-KW
S-SSA	D-V-L
SASS	A-QE-G
YF	D-L
SWSYA	EG-GD
QSNRAPA	L-N-Y
GTY-H	S-V-T
YPAGGATY-K	SR-YK-I-RD
WAWP	Y-FN
SYG-Y	R-R
SYW	P-LR
GGYDGW	RL-RH-R
Y-EF	N-N-N
W-NRGGQVNYSRQ	A-GN-I-D-G-G-T-DG-N-N
RDP-K-W	K-K-N-A
H-N-Y-Y	A-E
MLEH-L	A-T-LQ
Y-N	LQ
T-SYV	QE-T
SIG-S	P-K
SSSL-F	E-N-P-K
VYG	L-D-Q
WYD-DN-Y	G-V-K-P
DLRTG	Q-V-M-K
V-GY-H	D-K
AG	S-L
WWD-K	N-S-D
IFNFY	KK-N
NY	Q-Y
L-Y	K-P
V-N-ET	Q-N-KQ
YD	P-K
ETALVVSTTY-HYD	P-KN-E-I-L-D
SY	N-N
R-N	PD
YHSY	L-E-N
YA	I-L
S-STG-D-H	LQ-V
NRGW	D-D-L-V
SY	I-T
SGGN	S-R
YEGA	T-L
YY	P-P
EV-GFN	IT
SS	T-T
YY	E-N
Y-Y-YW-Y-SDY	T-P-P-Q-PG-I
G-D	SS
GNSNR	E-K-N
SYDGGGHY-L-W	K-I-W-QG-P-G
Q-YNSY-P	W-F
E-T-H	Q-LG
GID-N-GTN	L-T-F
R-YAL	G-W
STW	Q-L
YDSGYDYVAVAGPA	FE-FP-R-A-V-R
YNSY-Y	GS-T
SYW	K-N
E-LEIGMTN	K-N-S-E-G-L-Y
DYS	K-K-S
D-D-K-Y-N	K-SKD
L-K-DS	S-E-K-E
T-T	E-E
SYW	N-S-K
GG-TY	DK
DPQDG	R-Y
SEFEPF	Q-T-L-R-Y-L
DYSY-L	VV-A
R-D	A-A
R-LYSYY	V-L-R-Q
Y-Y	PI
YYNP-W	I-P-I
RYG-H	TI
VMSY-T-Y	I-GD-I
GGAAAAV	T-N
SYSY-L	AP
DYA-N	L-F
Y-SY	FG-L
GGTGF	F-Q
FDGA-F	P-R-H
SHED-L	G-RG
Y-H	I-R
E-Y-QAYYY	R-H-R
FIYSS	K-N-ER
A-TNLAD	R-K-S-R
FYG	N-L
E-DS-T	P-E-L-N
AYN	L-N
NPYY	NG
NYYDGGS-RY-Y	E-T-V-R-LN-Q-P
GNTL-F	W-R
TYD	LW
Y-SYS-S-N	E-VS-T-W
ATA-FYDGSY	L-V-Y-E-R-W
H-N-K-Y	DK
S-Y	K-T
V-N-S-GTD	TS
DFYDYD	NK
KNNIRPS	Y-H-EE
AL-GAT-S	KE-QE
R-R-WD	K-Q-E
D-D-Y-N	R-D
W-GTHF-R	D-R-AE
SIR-R-Y	EF-H
Y-GSS	R-D
TYT-E	S-Q-R
KQ	R-S
VGDT-F	Q-F
SYG	LI
TISSGGSY-Y	L-AEI-F
QTTMTY	L-I-R
Y-N-F	H-L
NNVD-W	WSGN-N
Y-Y-TY	G-I-N
I-T-Y	W-L
NSGN-K-Y	I-R-E-K
DYSY-Y	K-E-D
W-Y-TGSPSY-Q	L-M-TN-R-N
H-YYN	K-Y-E-D
ASNY	K-R
ED	V-K
Y-S-W	V-L
I-Y-D-D-R	F-AK-L
L-YYYDS-GYY	F-K-H-QK
E-Y	IK
GDW-H	QF-K
E-SAG-YTD	K-QF-H-A-I
ESRVSFEA	K-GQ
SHN	NG-I
GASTR	N-I-L-D
SGSGS-D-TS	K-NT-N
SNWP	Q-I-K
VFGIFPPW	W-T-H-GD-L
AGYDVH	V-R-R
QSY-S-S	R-N
Y-GGS-Y	N-GY
EGPGD	KGT-N
SS-GSNY	IF-D-R
D-KRPS	SR-DE
WDSRLG	F-IF-Y-K
S-T	K-E
DNW	I-K-R
YGD-D-R	R-IS-F-E
DWNYNPRY	R-K-H-E-R
KSV-S	QN-Y
KREY	TI-R-E
SYW	QE
N-Y-S-R-N	E-N-G
WVY-ND	Q-A-T
GSHV	LF
Y-H	G-L
W-YGN-N	F-G-NT-A
DKY	I-G
WDSTLG	I-I-TY
N-W	N-I
I-YDD-D-SY	I-K-N-TY
L-FEGDYSGS	I-R-H-F
GNN	GH-Y
Y-Q	N-T
SNSW-Y	Y-DN-R-S
SAY	R-L-I
Y-SYSGS-Y	R-D-W-N-S
WA	Y-K
KY	E-E
DYD	K-R-F
FANSGP	L-F
SYS-S	SEF
VISY-NKY	AK-SE-KL
SASS	GG
SYS	K-Q
Y-YYS-S	K-I-K-L
ESSYFYYD-E	K-Q-I-F-RK-K
GTHF-L	R-T
DYS-H	G-GT
W-E-T	T-G-L
ATTATE	GR-T
Q-N-N-F	D-Y
DYTY-L	K-Q-YR
W-H	Q-D
E-D-D-YINY-E	D-K-L-K-R
T-LLAP	D-Q-K
T-S	S-S
SY	Q-T
SSSYISY	SA-R-Q-H
NA-R	K-D-G
Y-FWSAYYDAD	G-N-G-R-F-LT
L-Y	L-Q
HYG	SI-E
GSR	EE
RSEFYYY-TYYY-AD	IL-L-K-EQ
T-D-F	S-S-V
TYNH-Y	N-V-E-VG
TN-Y-Y	GRP
TAAQPY	R-R-G-N
Q-IGNN	N-G-K-K
Y-Q	K-T
ANSW-Y	YR-N-S
SDY	NL-K
Y-SYSGS-Y	S-R-DG
WD	Y-N
EI	V-R
QSV-Y	R-D
Y-EF	R-V
W-NNSGGTNYAQ-Q	T-D-R-G-GGS-D-G-I
SDYNW	K-D-A
YWNT-F	A-AR
VYS	NNK
D-GLNYGS	NN-VH-A-N
DIQ	G-N
R-I-D	N-T-N
QY-ET	T-N-AN
P-F-H	K-G-A
W-NTNGAVNYAWY	T-G-G-I-GG-R-GG-N
RR-M	D-Q
R-EW	KAN
H-SGN-Y	P-S-K-D
GS-I-F	PG
TYG-S	H-SG
WINTY	SQ
RSW	H-S
S-Y	Q-S
NRAP	P-Y
EV-GYT-T	R-E-R
SYW	E-R-V
DN	V-R
WYYGTYY	G-AG-P-Y
EIV	E-T-K
Q-D	T-N
Y-ET	T-GK
RPEW	K-D
W-KERGAVSYAPQ-Q	A-I-R-G-I-T-S-GG-D
RLY	D-A-L
RDSW	D-K-NN
N-RT-Y	V-P
AYIP-L	VY-GGV
DFSMH	P-Q-V
WVNTET	Q-G
F-L-Q	I-P-V
N-Y-E	ER
F-G-V-W	R-P
DYY-H	K-T
W-DE-D-A	P-K-T
RGGMIF	KP-A
Y-N-F	R-Y-Q
R-S	R-E
Q-GYT-T	SL-E-I-A
NHH	A-D-A
Y-IY-Y	R-A
RSS	IG-R
NYGA	Q-H-A
SYY	G-R
YYS-S	H-E
S-FTVD-I-H	R-L-VS-Y-G
Y-EF	N-G-I
W-KRGGAVNYCR-Q	A-G-I-Q-I-G-R-CG-R
RY	D-S
T-Y	K-V
IRE-R	V-K
DYY-Y	KE-G
W-DE-E	G-K-K
GVITM	V-KE-P
H-N-Y	PL
V-GST	PL
NYA	G-E
R-RSN	L-G-E
YGNH-Y	E-P-E
FS	V-P
G-E	R-P
QV-GYT-T	F-D-K-D
TY	D-D
DYD	KG
LQITTIIDY	I-I-T-I-FV-D-F
YYGYY	E-I
E-K	P-K
Q-S	R-A
GFH	QR-I
YY	YF
DFGEYHY-FDL	I-I-A-S-PR
RSNW-I	WS
V-WFD-N-Y	L-R-Q-I
L-FI	R-I-W
YA-Y	R-P
YY-DY	S-K-H-P
VHSN-Y	EF-H
GSHV-L	H-FE
H-YWD-D-R	FR-E
R-II-D	F-H
N-GN-Y	A-N-D
YSYPY	MS-E-D
DYY	A-P-V
D-I-FY-Q	R-S-A
SHLLRAS	AN-D-E
GTFN	KE
IGLDTPNY-Q	R-W-A-SY-E
E-E-RWRPT	R-K-Y
NNR	L-T
GASW-F	A-T-L
D-W	V-D
I-Y-D-D-R	L-K
GRFAH	Y-T-K-T
W-ST-HI	N-N
HYSP-W	A-K-D
NYG	LNT
W-NTN-E-E	T-L-K-K
GEDNFSL	N-I-S-T-E-I
HYGN-F	T-A-K
NNED-Y	TVG
NWW	E-K
R-VNK	G-EK
WFFPW	Q-A-M
TASNY	K-R-E
DIGD	E-S
T-S	Q-F
SYR	F-Q
SAGGGS-Y	QM-E-K
RAGW	Q-R
YSN-Y-N	G-F-D-N-D
QGTHFPY	QS-D
YY-Y	D-EQ
Y-SN-YK-Y	Q-V-Y-D
A-H	TE
M-S	R-N
YD	T-N
DSGYSGPE-SY-HY	R-Q-T-GG-K-S-T-T
M-VVSAGWERAD	K-S-L-S-G-S-TQ
RNH	M-N-K
DDLP	A-KQ
RLA	Q-L
MIFDI-N	Q-K-Q
ASYSSSSPY	W-H-T-V-KQ
GY-Y	Q-H
Y-S	HT
SGGYF	AP-F-C
YYI-N-Y	F-D-P
RLRG-N	T-P-A
YGQSLS	N-F
TYALS	K-T-WF
GVILL-ITN	W-L-I-F
E-GKP-G-F	F-W
F-EF	N-G
W-KMWGAVNYARQ	A-N-DG-S-R-G-R-G
RP	D-G
H-DF	E-K-N
Y-R	GD
GNTL-Y	L-TP
DYG	K-TS
IISTYSGDASY-Q	T-Q-SK-NP
SSTWY	T-G
E-D-N-Y-N	S-N-QL
S-N-E	QL
M-TTHA-P	L-N-G-W
S-T-GRFY	WH-N
M-D	IL
D-V	K-H
L-Y	H-E
Y-IRYT	K-DE-L
G-R	KD
EVQL-SGFK-K	TEP-N-MN-N
DTS-H	N-Y-D
SN-L	K-P
S-HF	Y-H-M
Y-N-F	W-L
NNVD-W	W-GN-S
Y-Y-TY	G-I-N
I-T-Y	W-Q
E-RW-F	I-E-D
V-R	PD
SREL-W	P-V
Y-DE-Q	I-S-H-S
HRGN	I-F-P
RV-GY-H	S-D-K
GSGY-F	N-S
AG	E-S
WWD-K-H	N-K
IFNFY	K-N-K-N
YY	Y-L
RVMYYW-FSKY-Y-Y	E-R-K-D-E-D-A-P
R-R	WF
N-W	K-W
R-T-GE-S-D	F-GN
KYYDFWSGYPPG-E	W-KI-L-W-N-F-T
SKY	T-E
HD	R-S
WWD-V-R	R-G
DYD	RF
DT	R-H
SF	R-I
ST	P-A
HLGDG	P-R
TYGIYDLYV	NA-K-H-N-R
SM-Y	N-E-A
SF	R-G
YN-D-Y	R-TG
PPLFYSSWSD	Q-T-DI
YYGT	F-K-K
SNMAYS	E-N-K-F
FDYAG-W	N-Y-K-Q
YNR	P-Q-I
YW	N-E
ITTGYA	T-FQ
WDD-NW	H-T
SYA	MM
WINP-N-NAK	A-MM-M
D-GFDL-G-Y	W-HR
IR-R	K-G
DYY-Y	K-K-V
W-DPE-E	K-K
GVITM	VE
Y-Y	Y-E
K-RFS	E-L
DY	L-R
GGWHAMD	T-E
SS-Y	D-R
FHH-Y	K-E-V
WINTH-Q	KQ-V
NYYR-D	K-D-C-E
L-Y	RQ
D-RPS	R-KE
VM-GG-D	RN
R-GYNDFYDGYY	G-DR-KQ-N
SYN-W	E-C-C
N-I	R-E
VISSS-GMTR	F-R-E-R-E-C
GDYVGE	R-R-L-C-GG
Q-Y-S-H	S-T-E
FYIY-Y	H-T-T
D-R-TTNY	Q-E-V-K-T-N
GSKGAM	QH
NSF	FF-F
SYW	QP
E-N-TN-R-Y	P-E-P
RYGN	P-M-F
SS-GNNY	F-P-R-R
D-K	RD
W-SS	EF
T-S	Y-W
IF	W-F
SRIYDLNPSLT-Y	SV-W-S-F-RG-R
NED	RK
D-Y	K-D
E-YGV-T-Y	K-EE-Y-R
R-V-MY	K-R-DQ
Q-GNN	N-G-K
Y-Q	K-T
SNSW-Y	Y-GR
SDY	L-K-D
Y-SYSGS-Y	SD
NKQT-L	EA
R-NW-W	GS-P
SYW	Y-S-L
YGD-D-R	L-EK-M
FVSLD	PY-L-K-E
SYGIN	S-L
YIN	PL
SVYYGG-YYF	PS-TH-I-L
FD-Y	RK
SNE-Y	K-D
YT-T	K-D-D
TYY	L-K-P
APAS-T-Y	PL
DYGFS-E	F-H-K-Q-K
SSR	Q-K-C
AASSL	Q-K-E-K
YH	Q-C
SGSGTK	E-T
KRVGA-Y	E-V-E
L-Y	RQ
D-PS	R-KE
VMG-I-GGDY	RN-Q
AGYDVH	V-N-A-R
QSYDSSS	R-N
Y-GGS-Y	YG-G
EGRGD	GK-N
T-T	DA
RFW	D-N-K
Y-NSTGY-E	K-A-A-V-K-D
QTNY	A-TK-Q
T-Y	K-V
IRE-R	V-K-G
DYY-Y	K-GV
W-DE-E	G-K-K
VITM	EV-Y
DIQ	E-N-N
R-D	N-N
QY-ET	S-N-N-N
EW	T-G
W-TNGAVNYAWY	A-D-N-G-I-D-S-GG-T
RR-M	D-Q-T
R-EW	K-D
L-S	G-S
GVPA	SG
YYDYDF-F-Y	E-W-L-N-Q
NN-GTYAY	S-E-Q-C-R
K-N	QS
Y-NFN	R-M-Q
RY	D-R
DYDGDTY	K-S-R-R-E
DVVTGF	R-R-L-L
FNSY-I	F-M
SYD-H	TRM
AIGTA-D-Y	M-T-R-H
E-T-DNYY-Y	R-P-K-GG
KY	SL
L-IF	V-L
DVNR	D-K-R
SY	KY
DD-E-WYYGMDV	R-L-HS
R-Y	Q-I
FAGSYY	M-QT-W
SIGSGGGTA	WM-SL
E-PY	M-I
G-NRAT	Y-D
Q-T-R	R-S-L
ILF-K	F-Y-Q
KSM-R	I-L
LTTLTSYNWD	RF-D-I-R-Y-L
LSNQY-Y	KR-R-I
KD	I-K
T-G	RK
ADSSGY	HI
N-Y	GR
Y-Y-T-V-N	PG-H
EWAE-D-GN	H-RG-I
SY-H	HF-D
WRSN-Y	R-R
DYN-D	T-Y-E-R
N-YNN-V-G	E-R-T-N-H
YYY	R-Y
GSK	T-S
WDSSDY	G-K-G-R
SYT	TT-Y
GITIL-IAN	Y-Y-K
DTVMG	G-R-I
S-Y	P-R
HYSI-L	R-PI
M-WGD-R	PG-W
DYYGSG	H-A-T-P
NIGGTF	T-K-Q-L
DD-D	K-K
WDMV	QN
SY	F-E
LGAFHWD-Q	RF-E-R-K
A-YW	NN-D
LRYTD	IG-ID
Q-RNY	E-GQ-K
A-T	Q-E
RYNRAPY	Q-Q-A-K
T-GH-D	ES-A
Y-STA	Y-AE-K
ESD-Y	K-E-Y-R
ATHF	R-K-R
SRSGSYSYFPD-Q	E-D-Y-K-R
YDD	Q-R
Y-SSY	D-GE-S
YYRM	Q-T-E-Y
S-ISN	VA-D-N
YNNW-L	T-V-S
D-H	K-S
WN-Y	D-K-L
D-YVSG-D-Y-Y	LS-K-N-D-K-N
TYGH-F	L-RF-F
L-SN	I-E-R
GRGS	E-D-Q
NNED-W	SGT-F
WAGGT-NY	SDG-W
RNA	F-P
D-ST	PI-K
L-Y	L-C
F-YS	C-Q
FY	G-E
SYW	K-N-D
R-NPN-S	G-K-D
SGFRV	L-G-S-Y
H-N-Y	A-V
STHF-P	SA
DYY-F	Q-G-A
T-D-Y	A-K-G
DPLEYYG	S-Q-K
SSW	TG
WYR	RY
FYD-F	Y-H
Y-EF	N-N
EW	A-G
W-RGGGVNYGRR-Q	N-G-I-GG-GG-N-R
R-YCN-ADCFNW	K-E-K-N-K-R-A-N
R-N	LT
YNNW-W	NNT
SWGRTNYAQ	D-I-G-G-D-G
ATEGSLL	K-K-K-T-A-T
YRS	SN
SY	R-Y
NSN	G-K
Y-F-W	R-E-K
DFA	GD
Y-SYS-N-R	DG-E
AGR	VR
Q-S-Y	P-T-D
DFTL	N-P-G-I
YGN-DTS	NT-S-K-A
YYD	N-A-N
Q-N	N-I
NNNWPT	I-NS-G
WSGGNTDY	V-Q-P-S-K
TYYDYE	K-HQ-S-S
DSIGK	E-QE
NSY	R-F
QFDP-F	YW-W
S-Y	L-D
N-Y-S-STY	K-L-D-P
ERGMH	Y-N
YNR	D-R
G-E	R-T
FW	R-D
EV-IK	S-K
DTY	E-Q
GVF-F-DY	E-P-A-R-T
ES	R-Y
EV-GFN-K	VE-R-K
DTY	T-K
SDY-DS	R-I-E
FWS	Q-GR
GYG	KG
WGD	DT
RDFR	N-YS-G
VHSN-N-Y	E-V-D
STHV	A-R
WWD-D-Y	K-I
RGYY	E-I-D-A
YSY	AP-T
HYGSPW	T-A-N
NYL	PF
VINRS-DTN	F-FV-QN
GT-YF	PG-P-F
SST-Y	Y-E-E
SWEI	KE-G-T
SYY	S-V
E-NSNGD-N	G-V-S-CP
DGRN	SS-H-K
S-Y	NK
GSTF-W	K-N
R-DAN-N-K	N-KN
YDGYFLY	E-K-KE-N
N-YSY	W-H
N-KT-E	QE
E-T	E-E
SY	K-E
EYY	S-G-S
D-W	R-K
AKAF-P	RY-L
T-S	E-N
SYSMN	E-K-S-G
SISSSSSY-Y	GS-DI
VTD	L-TK
DIGSK-Y	P-E-F-L
R-Y	E-K
L-YASS-Y	L-R-P-PG
DYF-Y	D-H-G
D-DPYN-DTS	H-R-D-K-G
GL-RF	EL-D
RVMYYW-SKY-Y-Y	E-K-Y-R-D-E-P-P
RND	E-RV
A-S	V-H
HN-Y	V-R-R
Y-E-STN	P-S-G
ERLG	E-V-H
WDS-W	MW
WYD-SN-F	W-R-M
VRSFYYS	T-F-M-M-W-Y
YE-L-W	R-R
M-WGD-STD	R-RQ
DYGNY-Y	K-L-K-RN
TNY	TKS
I-T	L-K
YS	T-E
VQYSGS-LGAY	I-SL-G-H-KS-L
LYGF-F	G-L-R-QV
H-D	GR
SYW	S-S
Y-NST-Y-E	N-R-H-K
SGRL-D	Q-S-V-E
WNY-F	A-P
SYT	E-TA
Y-NPSS-Y-N	AT-E-P
P-VRLGY	E-T-I-L-T
Y-N-K-YLN	SN-DW
VQGTHFPQ	W-NN
W-N	PD
EYD	D-F
DQAH	E-L
GIGTSGN-W	L-E
GLYN-YT	G-L
S-Y	E-Q
SVMI	Y-Q
TFS	E-D
Y-SRTSKT-Y	I-D-T-E-L
GRF	D-T
L-H	S-D
Y-TLHP	T-VD-S
YDNL-R	DS
DTY	E-R
R-DL	D-R-E
GGDP	NQ
IIGSKL-H	V-K-L-K-R
DD-D	KK
NSG	K-TQ
WARWF	FRE
Y-SY-L	N-I
YYTY-L	PT
VIG-N-NTN	VE
R-RDDV	R-W-P
SR-GY	Q-I
F-GSYY	W-T-M
V-STA	W-L
E-PY	MW
GNN	G-K
Y-Q	Y-N
SNSW-Y	R-NY
S-R	R-L
SDY	W-L-S
Y-SYSGS-Y	S-G-I-N-D
WD	KK
ISSA	CT
S-YRYT	F-I-SI
RY-R	C-R
SYY	R-R
ERPLY	R-D-F-S
DI	L-H
Q-Y	S-L
GNTLS	R-N-N
D-D-Y-NYAP-Q	K-N-N-N-A
YQGYMD	N-K-E-R-K
VHSN-Y	KF-H
GSHV-L	H-KA-F
H-WWD-D-S	FR
R-HT-D	HD-R
VMYYW-SKY-Y-Y	E-R-LD-D-E-R-E-P
SYST-F	LE-L
SEW	WK
I-Y-D-D-K	L-WK-E
H-SYFYRTAY-Y	WASL-L-D
W-DDVKYDFNDG-Y	D-D-KQK-S-V
YGQSLS	N-F
TYALS	T-W-WF
GVILL-ITN	W-T-L
E-GKP-G-F	F-W-N
VSGA	TA
HYAI-L	A-S-N-R
GY	CG
M-WGD-RTE	A-W-R
DSMDPG	H-A-F-A
Y-SN-K-Y	V-Q-A
W-TRES	V-K
NYR	QN-D
SSSSSY	DQ
PRATGYSM	P-N-GD-IV
D-YLI	KM
WQGT-H	MK
DYY	PK-M
WIDE-NSE	HM-K-A
DLH	KTN
WSSH	V-K
DYY-Y	K-E-PC
T-DGN-Y-Y	P-E-K
D-T-SGYG	P-RE-E-C
N-N	G-W
L-HD-F-L	WN-Q
DSY-H	K-KN-Q
R-DE	Q-K-K
GAYYI-D	WNK
FS	R-P
SY	G-R
IF-SPN	T-T-KK-R
EWGSGRY	L-T-N-G
YGSS-S	F-NW
SYAIS	T-WF
GIIIFGTAN	W-A-R-I-DS
E-GKP-G-F	F-W-NT
N-HNY	EN-K
FWS-W	K-E
DTY	KE
DYG	T-K-G
SY-F	P-P
Y-GST-F	V-D-A
NNS-RN-F	A-V-S-Q-C-V
DLRLG	H-A-T-P
FWST-R	G-GA-LA
YT	TI
IISSGGSYTY	A-IT-D-Q-A-L
DEGNGNYVE	AR-P
EI	R-D
Y-EF	D-GG
W-NSGGTNYAQK	A-E-I-GD-G-GG-T
RDYYNW	K-K-D
T-T	G-I
SYW	E-L-N
M-HHS-STN	P-N-I-P
GWD	E-V
SNN	G-K-Y
Y-Q	K-T
SNSW-Y	Y-D-R
SDY	R-L-I
Y-SYSGS-Y	R-G-I-N-D
WE	S-K
HNY	T-L-G
N-K	L-R
FW-T-F	NR
TYW	Q-R-E
E-NNN-R-N	PS-E-D-S
VMIT	P-A-N
DI	LL
Q-HST	L-FH
HGTHVPY	L-HAD
W-WPGP-I-Y-P	H-A-E-K-L-GV-L
VL	F-H
ISSSY	K-Y-F-K
G-SS	Y-V
QY	KN
S-T	E-N
SYW	QE
V-YGDSY-R	L-S-D-KP
MPNW	N-Q-F
W-SNHW	W-DL
R-GGTAY-K	IP-IP
E-TYVS	N-HQL
G-N	LQ
TYSY-P	FA-T
Y-R-T	F-D-A
GGTGF	F-Q
Y-EF	T-G-N
W-NNSGGTNYAQK-Q	T-G-DG-G-R-E-G-S
YYNW	K-N-A
SS-GYIY	M-E-F
D-R	S-T
YTTLSW	F-E-H-F
SYW	H-VF
KP-E-Y	P-H-S
VSRGG-S	FV-D-SS-E
IHSN-Y	E-H
GSHV-L	F-H-A
H-YWD-D-R	FR
R-IT-D	F-H
DYSY-L	V-L
R-DAN	A-R
R-VYSYY	L-R-D-Q
NY-I-F	W-L
SKEA-Y	W-GS-N
Y-D-F-N	T-G
SIYYY	W-I
YY-K-F	L-W
SKEV-W	RG
Y-T-Y	GP
S-RYDGTYY	G-W-KP-R
I-E	K-Y
QGIFYKGSG	DR-KK-N-K
WPP	A-T
IIL-V-H	M-I-K-V-T
EA-EGEYDN	R-I-KQ-P-M
ED-S-Y	K-M-T-A
YGTYAG-F	K-K-E-L-SV
N-YL	A-K
VSSA	P-D-G
N-S	E-V
YY	L-K
RGQASW-Y-W	I-F-KF-N-V
TS-Y-Y	R-PE
L-Y	K-A
L-Y-E	LA-K
SRDL-L	SR
Y-Y	K-P
GINSN-GTN	P-D-G-R
R-YRFDMD	Q-T-A-E-S-K
QSVSSY	QP-D-Q
QRSNWPGY	Q-FT-Q
T-S	R
S-A	D-F
A-SGSGGS-Y	FD-T
AARRFV	G-F-Y-W-G-D
YY	K-M
RVMYYW-SKY-Y-Y	E-R-E-R-GP
RDNIGN	T-H-P
SGG	P-R
Y-YYSGSTYY-K	T-E-R-M-R-C-Q-L-V
CSSTSC	E-P-G
YGN-F	C-QR
SY	Q-L
YGD	Q-P-K
FDYG	Q-R
HWNY-L	D-IN
R-DPAN	N-F-K
SKY-D	R-R-Y
Q-GNN	N-KR-K
Y-SQ	N-R
SNSW-Y	R-D
SDY	N-N-I
Y-SYSGS-Y	S-L-D
WD	S-K
YST	NG-D
Y-EF	N-AG
W-KRYGAVSYARQ-Q	A-Q-G-S-DG-A
RY	D-G
ARDYYNW	K-R-K-K-N-AN
HSNGN-Y-Y	K-H-K-E-E
R-SN	E-I
S-W	SH
Y-D-D-K	W-K-D
YS	GG
YL	Q-P
V-DTN	PH
SGA-APTYYAMD	W-Q-PH-G
V-SY-Y	G-G-P
YNSH	F-DK-S
R-R-SN	P-T-M
E-YYYG	P-P-Y-E
QFLSSF	D-G-AC-S-C
SG	S-Y
GLLS-L	I-A
FFLY	M-F-C
H-YAP	K-G-TN
TRWT	NG-K
FE-K	R-Q
FHKNGAVDFFS	S-A-G-I-N-G-N
GRYP	P-K
W-D-EW	H-PK
NSYY	L-QFC
SIAYRGNS-SGSTY	H-F-V-L-N
RQL-D-TGYQWA	F-Q-R-C
Y-EF	T-GG
W-KRGGAVNYAR-Q	N-G-G-I-GS-GG-T-D
RVY	D-T
Y-ARDYYNW	K-K-N-K-N-AN
HISR-R	SP-A
F-RK-E	AD
EGHTAAP	TSS
SY-N-F-H	KE-V-D
R-NLES	T-R-K
SNE	D-K
EYI	T-K-G
W-YES-IIK	P-TR-EK-V
HDGTN-D	KH-LK
F-T	EW
R-RLMI	E-D
Y-F	W-L
DYEIH	L-A-A-L
GIH-S-GTA	LR
K-DY	W-D
S-GSNT	N-SKS
TSG-S	SS-N
D-DD-T-Y	P-G-E-W
T-RVSGDYV	N-S-N-Y-K-S-P
Y-NSSDY-K	DIF-T-K-K-E
K-DVGY	D-F-K-K-E
Y-EF	D-GG
W-KRGGAVNYARP-Q	N-T-R-GG-I-S-GG-D-D
RVY	D-V-R
DYNW	K-KA-D
H-N-Y	P-P
STHV-P	WP
N-Y-STY	M-E-W
IGSYY	K-N-D
ED	K-K
YDD-F	D-NK-T
Q-RS-Y	T-SE
YPFY	T-VK-N
R-R	WF
N-W	K-F
R-T-GE-S-D	F-G
KYYFWSGYPPGE	W-T-I-V-K-W-F
Q-GNN	N-G-K
SNSW-Y	R-DN-S
SDY	R-K-S
Y-SYS-S-A	R-D-L-G
WD-D	S-K-N
TYALS	L-T-W
GVILL-ITN	W-L
E-LGKP	T-W
R-AM	V-P
GISSGGSY-F	P-E-V
Y-SDPF	P-V-K-H
QD-SNY	PY-T-D
DFTL	NP-A
YGNGDTS	NTDW-S-K
SYRYD	N-SI-N
SSW	M-Q
YNIY-Y	Q-K-D
V-GYS-T	E-Q
TYW	L-S-F
D-D-R	F-K-E
RRPGQ-DF	E-D-L-IQ-E
Q-GNN	N-G-K
F-Q	K-N
SNSW-Y	R-NY
SDY	N-L
Y-SYSGS-Y	DG-R
WD	K-N
SY-F	K-F
SNL-S	VP-R-G
GVPA	G-I-R
NN-W	KP
E-IK	K-K
DTY	K-G
R-DPA	P-K
RQL-LRGYYY-M	G-R-K-F-V-Y-L-P-T
Q-GNN	N-GH-Y
Y-Q	N-T
SNAW-Y	Y-G-R
SDY	N-L-K
Y-SYSGS-Y	S-G-W-N-D
WD	S-L
SSS-H	E-V-D-L
W-LSV-F	V-CH
R-CYNR-GVCA	L-V-C-C-L-FD
R-L	Q-N
WSG-S-D	L-T-N-T-G
ELYGY-YL	T-Y-D-Q-R-G
S-GNN	N-G-R
Y-Q	N-T
SN-Y	YR-S
SDY	N-L-I
F-SYSGS-Y	S-R-DG-V
WD-Y	S-K-N
YY	K-L
VMYYW-FSKY-Y-Y	E-R-D-D-E-GP-F
QSLSSY	K-Q
S-R	K-D
Y-V	Q-V
R-Y-RS-Y	D-GQ
VFGVN-D	I-V-V-WGD
NY-Y	D-P
WGR-P	R-T
D-W-E	S-T-R
E-L-SGSTN	R-L-QAT
GNYD	RG
Y-Y	D-R
R-NR	R-Q
YS	R-R
VYRYPER	D-R-R-Y-T-E
R-Y	T-H
YDN	G-T-K
AIFGT	R-P
ISGSGW	S-T-T-H-G
IGRN	QS-A-A
SG	T-S
YV-F-Y	G-V-L
SGYY-N	TD-SL
Y-Y	LS
ASDSDGF	L-L-G-D
GNN	GH
Y-Q	Y-N
SDSW-Y	YN-R-S
SDY	N-L-K
Y-SYSGS-Y	DGN-R
WD	S-K
EY	H-W
W-SMTV	W-D-M-KQ
S-ILFGFVVY-Q	Q-L-L-K-Q-I-R
YFDTYN-Y	Q-HQ-H-W
QD-N-Y	G-K-P-Y
Y-R-S	S-Q
ANTL	S-W
SYA	Y-R-W
T-SSGGTY-Y	W-D-E-KL
DGNS-D	W-I-K
YSSNQK-Y	P-K-Q-L-V-L
YYTY-Y	PT-D
SSW-H	Q-D
M-S	D-D
YYYDY	QT-E
LHFY-H	D-DLA
Y-D-D	DK
RRGP-R-VN	D-WD
GYS	E-K
SGYS	K-SG
GSHYFW	AS-Q-R
DNF	K-Q-W
A-T	WF
LNSY	W-PLV
GMTMVR-V	D-T-ST-L-W
YTSRF	HR-SF
S-GS	E-H
GYD	VW
WGD	W-Y
YWYA	F-S-T
Q-YGQSLS	F-NW-K
TYALS	S-W-WF
GVILL-ITNY-P	W-S-L-N-I-K
E-LGKP-G-F	F-W-Q
SS-S-Y	E-QV
YSYWR	ED-T-SQ
TSGY-Y	PF-E-V-E
L-YL-S	L-S-P
SRDL-L	SR
YMY	S-P
GINSN-GTN	P-D-G
R-YRFDM	Q-K-D-L-S
S-H	ER
SNVW-F	P-E-N-DR
T-S	L-Q
EFTMH	Q-M-R
GINTIN-GSS-K	M-QC-G-T-Q
KGF-AY	DR-E
FDGD	T-R
LGIANYAQ	P-AD-R
I-RY-MNVYYLMY	C-A-QS-F-T
TS-Y	N-E
W-N	A-D
Y-Y-STY	V-L-YK-N
FGSY	E-AP-P
SNY	PP
WYSN-W	PP-Y-W
S-T	D-K
GHW	K-Q-H
HSD-E	D-D-A-H
YFYGT-Y	K-P-L-K
H-Y-E	P-ET
Y-L-Y	LT
F-G-F-Y	S-T-L
TYA-S	V-L
S-SSGGS-Y	L-EV-T
GGYGT-S	ETL
D-D-K-Y	K-E
R-Y	LE
GTHF-W	KW
GNYL-AY	L-A-D
SSY	S-D
Y-S-W	ED
SYW	N-D-T
I-YPGDSS-R	E-N-E-GV
RRNW-N	G-E-T-D
SFNVPL	Y-KGN
ISTPR-T-Y	VT-H-V
G-SSTSYA	VT-Y
K-TLES	Q-R
GV	R-E
IGVPRRDE	S-Y-G-Y-G-A-K
QD-W	QA-A
ANSF	P-C-V
DFY	D-R
L-DED-DTM-E-R	I-R-R-P-V
E-N	R-P
D-D-K-Y-N	L-M-G
WQGS-Y	FG-G
TNA-N	E-F
R-RS-IN	GL-E-E
NTW	L-W
R-RD-I	WN-DF
DEGAPIL-FFEWGYY-Y	W-TI-L-IR-W-F
NVGSA	G-L-D
YSSY	IA-L
YGD-DTRF-Q-K	ETK-YD-E
R-VYYGSN-Y	I-E-Q-SF-H
GYG	KG
WGD	GTD
RDYR	G-Y-V-G
GRYP	P-AK
W-D-KW	F-P-K
NSYY	FC
SIAYRG-S-SGSTY	H-V-F-N
RQL-TGYQWA	F-QG-R-HA
GPFR	N-I-V-T
PIF	I-G
GYQ	Q-D
YSFT	G-M
SY	A-T
YGN	A-M-Q
DGYY	D-M-Q-A
ES-DSYGHSF	S-T-N-R-H
GNEV-F	H-NSI-T
Y-Y-Y	LN-T
SDGGSYTY	ES-K-R
Y-YD	H-L
H-VF-L	E-Q-T
H-N-N-Y-E	A-D-S
F-GS-V-P	S-GG
SDYA-N	R-S-G
S-SY-ITGY	G-Q-Q-A
MGYD	S-S-D
W-DV	HW
SYA-S	G-W
AISGS-Y	WSG
A-V-K-F	WH
YYY-D-K	N-K-Y
YE-L-W	R-R
M-WGDGSTD	R-RQ
D-DYG-Y-Y	R-K-L-V-N-S
SGSW-R	G-T-R
TYW-E	D-T-R
E-L-SDSTY	R-Y-L-Q
GDG	DGR
TN	D-K
S-Y	K-D
FN-Y	KK-E
D-Y	H-E
RNKGN-T	H-R-H-T-Y
YGTN	R-D-S-K
Y-Y	F-I
IIED-W	T-S
YWD-D-R	IK-S
YGFTY	K-R-T
DVST	R-E
Y-Y	ST
HVNAVKN	W-W-H-V-E
RN	E-Q
L-Y	RS
S-Y-NT	W-SR
Y-Y	V-G
S-L	EF
SY	E-G
WTG-T	G-Q-YG
YYYG-D	G-R
R-Y	T-K
YD	GK
T-I	T-D
AIFGT-N	R-G-P-GT
ISGSGW	K-S-T-G
T-Y	L-I
GKT	R-I
GYG	AQ
M-WGD-R-D	Q-Q-Q
QRYDYY	Q-F-Q-S-Q-R
STW	R-F-T
AASTL	TV-I-R
VPS-FSGSGS-F	RG-F
Y-Y	R-K
D-DADTM-R	R-I-K-M-T
D-ELN	K-G
Q-VHSN-Y	L-Y-L
STHV-W	TY-LQ-M
S-F	GV
TIN-KTY	MW
R-S-AL	M-GV
S-SNN	N-G
Y-Q	N-T
SNSW-Y	R-G-NY
SDL	L-D
Y-SYS-S-Y	R-G-K-D
W-D	K-N
Y-Y-F	W-L
Y-Y-S-Y-R	T-IN-N
I-T-Y	W-QL
K-N-FS	P-H-M-H
V-SGFGFT	Y-E-Q-S
IY	L-Y
SGR	SY
NAKN-R	IY-K-Q-Y
GA-YYY-Y	M-Y-S-H
Q-Y	N-I
FDHL-L	II-E-R
GD-Y	Q-Q-V
H-YYS-NTN	R-V-P-Q-L-K-G
DRVTGA	R-I-I
LRSYYA	R-G-EV
SSSG-TA	R-R-Q
S-G	R-V
NW-GS	E-GE
IL-AGRGWY	S-M-T-E-G-C
GNNA	H-S-M
YDNL	E-MT-P
SY	DA
SGSGGS	EP
RVAVKGSYY	AT-V-S-S-F-E
QAVS-A	N-L
SYST-W	FSL
SYV	Q-T-G
Y-NYNAGTN-E	GQT-S-Q-L-N
PTMLPW	Q-P-G-S-D
FNSY	R-D-K
D-Y	E-K
Y-H-RVS-Y	K-V-T-E-G-P
QGTGTT-ED	K-E-E-K-G
SVSSA	E-K-Y
SSYI	P-K
S-Y-H	I-F
Y-SYS-Y	D-I-R
TPWWYWS	F-E-E-A
Y-N	HL
SVYYGYY	HS-PS-L-I
YD-Y	P-R
SNE-F	PG-G-R
TYPIE	K-R-Q
NFHYS-DTN	R-Q-I-R
HY-SAY-M	R-FAR
TF-Y	I-S-Q
L-N	VS
I-W	R-G
YS-Y	R-E-A
YG	FQ
Q-S	L-W
LHFYPH	DL-L
Y-D-D-R	K-E
RRGP-RG-VN	KW-LW
WGD	D-GT
RDYR	N-Y-Q-N
NSW	WN
RRLKD	FD-K-N
DEGTPVT-FLEWGYF-Y	W-L-R-N-W-T
SY	D-G
WSSN	GS-S
R-T	R-E
Y-NSR-Y-N	R-E-GG-S
Y-D-Y	GR
EI	A-T
Q-L-Q	T-N
L-EF	T-G
W-NRGGGVNYSRS-Q	N-GN-GD-G-T-D-G-N-G
R-NF	D-T-G
EW	A-N
NNY-Y	R-I-P-K
W-D-GGP	I-R-F-I
DYW	KK-S
I-Y-D-DSR	I-K-Y
L-D-EDSGAD	I-K-K-S
V-FA-N	E-Q-E
YY	M-L
K-R	Q-E
LY	TL
Y-N-F	H-L
NNVD-W	N-GN-W
Y-Y-STY	N-IN
I-T-Y	W-L
H-GN-Y	L-E
ES	KT
V-SGYTFI	K-E-S-T-V
YYGSYYDY	E-T-T-A-M-E-K
K-TLES	D-R-K
EV-GFTFS	R-V-G-S
RIGVPRRDED	E-S-Y-G-CK-K
L-I	N-T
SN	N-T
WAGGN-N	S-S-G
YDYD-F-Y	I-S-T-A-L-K
RSISGY	E-I-R-Q-Q
W-Y	M-I
HYTT	Q-K
W-DGFYA	Q-I-Q-P
S-GKF	E-T-N
SE	E-E
YT-N	D-K
KQGEVVLP-R	Q-DI-N-LN
SGFTL	T-I-K-T
YF	T-H
Q-R-Y	D-TN
HGESPY	KATK
DYY	K-T
L-DEN-NTI-Q	T-Q-D-Y-KK-G
DNSY	K-P-D
S-RND	N-D-T-H
F-SN	D-IT
GYT	H-E
R-W	N-K
S-K	D-D
YGSYVY	K-ND
N-K	GE
TGL-H	P-Q-LR
Y-SYY	RL-E-T
EYY-YT	R-DQ-GG
SSW	D-Q
YNSY	Q-L-D
SYY	V-Y
R-Y-SGS	D-T-GYA
E-HITF-GV	V-W-I-D
H-N-Y-Y	AN-S
NLEL-Y	SP
R-F-D-D-D	S-NK
NVFDGYW	E-S-S
GPFR	N-I-T
PIF	I-V-T
GYQ	Q-D-K
N-R-Y	D-S
F-I-E	D-L-K
I-T	W-N
DYS	WL-N
GW-L	L-W
QS-GNN	N-G-R-Y
Y-Q	K-N
SNSW-Y	R-N-S
SD	L-K
Y-SAS-S-Y	DS-L-W
WD	K-N
G-NRAP	V-L
W-D-I	LH
GL-DY	L-V-R
R-NREF	V-K-H-P-N
GYT-T	E-R
EYT	Y-E-N
S-NQR	K-Q-Q
SY	K-T
YD	K-D
LLMDYYDHI	TD-P-DQ-V-LS
SNN	R-G
Y-Q	N-T
SNSW-Y	YR
SDY	L-S
Y-SYSGS-Y	R-D-L-S
WG-D	K-N
SYA-S	G-W
AISG-Y	W-GS
WWWWP	RP-L-E
GFS-W	E-E
WSW	SLP
SSSGW-S	W-S-T-E
WWSS	LS-H
YY	K-M
VMYYW-SKY-Y-Y	E-R-D-ME-E
SD-Y	Q-I
YIQL	R-S-R-I
IIF	VI
DGIYE	K-V-S-R-R
A-SNLAS	SV-WR
GVPF-S	R-A-N
STSSF-Y	K-A-P-F
WEI-Y	N-D-K
Y-TYS-T-S	A-G-Y-E-D
Q-K-F	K-L-N
HGESPY	KA-K
DYY	NRK
DPAN-HSMY	K-Q-D-K
DSGY	K-V-I-N
YAG	MF
QS	AN
DSDGSIRL	TNN-AG-N
K-I	K-A
M-YRGRPWSAHK-Q	N-G-E-G-T-D-G-S-R
LSL-RTSM	SG-D-G-G
AASH-R-I	K-E-K-N
SND	K-Y
Y-NRYT	S-S-GH
DYG	YK-K
DE	K-R
RY	R-D
DWERGD	R-K-T-H-AK
SSSSLI	SL
YSS-H	L-D
S-YYY-Y-Y	L-L-L-L-N
GYYGA	D-L-R-S
K-F	I-I
TT-Y	R-I
S-YWN	R-P
DDF	I-P
HNSN-L	RP-G
V-W-SN	R-R
E-YILTGYN-Y	R-K-L-Q-R-Q
SY-P	K-I-Q
SSS	QG
Y-Y-Y-Y	G-K-R-I
YYGTG	Q-HP
NSRT-K-Y	P-Q-D-LY
SYNL-Y	S-AFP
YRSY	M-Y
IS-Y	VQ-S
YASY-Y	N-V-PK
S-W-E	F-K
E-LPGSGS-N	P-VK-V
TSYYFG	K-T-W
LSTKW-Y	T-VD-G
E-K	V-K
ST-GQW	V-R-G
WY-IH	S-V-G
GGKYDY	N-T-GG
SFNVPL	Y-GN
KFGM	TV
IATG-T-Y	VT-VY
G-SSTSYA	VT-Y
NYY	WN-D
H-IYG-TTK	DFWN
IGVY-Y	W-IT
R-R	WF
N-W	K-F
R-T-GE-S-D	F-G
KYYDFWSGYPPGE	W-K-I-A-W
YDDA	G-GS
Y-I-DLA	GS
SMDG	G-G
YGQSLS	F-NP
TYALS	LW-WF
GVIL-ITN	W-L
E-LGKP-G-F	F-W
D-NTA	E-A-P-P
HYTT	P-K-P
R-Y-YTR	P-EP-D
W-GFY	F-P-K-D
HSN-N-Y	N-DH
YG	H-P
WWNDNKY	P-H-Y-D
DDH	TP
SNY	Y-H
G-K	R-G
IIF	F-Q
YS-F-W	F-PE
TSG	G-R-W
WWD-R	E-QK
ITSVTDS	E-M-F-R
K-YSY	SR-W-P
YGT	S-E
N-YYGGIS-Q	K-QL-L-V
TD-Y	W-K
Q-N-K	D-F
QS	D-F
L-I	L-V
QSV	K-D-F
SSSN	D-DA
D-SLSV-V	D-N-G-G-F
N-K	D-N
YGQSLS	NWF
TYALS	T-WF
GVILL-ITN	W-L-I-F
E-GGKP-G-F	F-W-T
S-SNN	N-G-R-K
Y-Q	N-T
SNSW-Y	YN-R-S
RDY	R-L-S
Y-SFS-N-F	R-G-W-DS
WD	S-C
S-SNN	N-KR-Y
SNSW-Y	RY
SDA	L-K
Y-SYS-S-Y	SD-L-G-R
GYT-Y-KG	EL-N-S
N-GDKY	N-N-Y-V
DDID	V-R-N
Y-FFLG	E-Y-F-R
ST-GF-Y	E-P-E-P
QLT	R-D
RKF	D-G
HNDY-L	HGAE
AARA	E-H-A
SQDIS-Y	RA-Q-PG
GNTL-W	GP-PR
SPYYYGNW	R-KF-G
S-NNY-Y	R-I-P-H
W-D-GGP	H-R-F-I
DHW	R-I
M-Y-D-D-R	I-K-Y
L-Y-ND	I-R-R-H
QD-H-Y	I-R-I-I
YDEF	I-R-K-N
DYN	EK-V
IIDKY-TIN	V-NY
DYYGSSY	K-E-S-T
HWTY-Y	H-E-Q
W-N	E-Q
N-TVNY-D-K	Q-A-K-L-N-P
GGS-AM	QHG
SYNL-Y	LW
R-R-GFN-A-Y	W-T-C-A-C
DG	ST
W-KRHGAVSYARQ-Q	NA-W-E-GG-RD-G-N-N
ARDYYNW	K-N-K-AK
Y-YY	E-E-I
YY	F-Y
YS	Y-Q
WYRR	I-EL
YGSS-S	N-F
SYAIS	T-W-WF
GIIIFGTAN	W-T-L-H-F-S
E-GKP-G-F	T-W-F
LGSKY	KY-G-C
DSNR	K-H
F-M-NGT	D-K
QV-GFT-S	QD-L
NYT-N	L-D-PK
Y-SS-L	KP
ERWHVR-Y	Q-D-S-I-M-Q-E
QD-S-Y	D-S-R
GKML	R-S-N-K
SG	P-Q
WWD-DES	Q-K-MK
YDP	Q-V-R
SNSW-R	G-T-R-R
TYW-E	ND-R
E-L-SGSTY	R-L-Q-R
GDG	DG
LPKNY-Y	KQ-K-K
ED	K-K
YSTDSSGR	V-Q-LF
DGA-H	YF
GIS-IIA	FL
DSPRGPL	Y-KVH
H-Y	L-Q
Y-T	DN
WGD	D-G
RDYR	N-N-V-G
Y-EF	T-G-A
W-KRGGAVSYARQ-Q	A-G-W-GG-D-S-GG-R
ARDYYNW	K-E-K-A-N
G-T	L-K
VLF-T	FL-W
SVTPRYCGGG-C	Y-G-F-N-L-W
DSDGSI-L	TN-G-N
K-I	K-N
M-DYRGRPWSAH-Q	NAK-I-I-PS-G-N-T
L-RT	GG-G
AASH-R-I	K-N-K-E
DLG	K-I
S-HF-TYF	L-K-Y-M-D-G
V-R	R-D
ERGRHF-P-NRDNLE-K	GGD-N-KA-N-G-S
FTFS	NE-L
NTW	L-W
R-KD	N-L-D
DLGEPVV-FFEWGSY-Y	W-TI-L-RI-W
SYW	GR-I
NSD-Y-E	GA-I-G
WSNH	D-N
D-N	S-E
V-IKYGTTN-Q-Q	I-E-RQL-K-T
F-D	E-N
TFS	K-SS
SY	S-Y
TR-S	K-R
HYGY	H-RR
Y-W	G-S
GQ-Y	KT
T-T	YM
S-Y	Y-R
YGN	M-Y
HYGLDW	E-E-Y
NSRT-K-Y	P-ER-LQ
SYNL-Y	PS-T
Y-TYY-K	P-V-S
Q-LSSGN-Y	QE-RS
HYISP	N-M-Q-E-R
W-DPED-E-R	R-R-K-V
STYIY	RYNE
DYSH-L	YAS
T-SNGGGY-Y	D-DVP
RER-EKG	AY-V
T-SY	A-S-T
WSSY	S-S-K
DYS	GQ
WINTET-D	QLH-E
EDD	K-R-K
T-SNY	Y-LR-T
WYSNHW	R-Y-P-ET
Y-NL-D	P-I-R
YAQL-Y	V-SG
DTY	H-N
Y-K	N-E
PLYDYY	H-S-R-I-G
SYTTPP	S-F
FT-T	D-D-S
GSA-H	W-SNF
I-NNG-Y	V-S-W-H
TSN-R	D-N-D
SARF	F-DA-N
H-Y-H	A-P-T
S-V-L	L-A-T
TG	V-N
YN-N	V-LL
AID-GTS	LL-V
GM-E	N-T-P
S-SNN	N-K-H-Y
Y-Q	K-N
SNSW-Y	Y-D-R
SDI	R-K
Y-SYS-S-Y	R-G-W-D
W-D	S-N
DYSN-L	YAS
T-SNGGGY-Y	D-VD-P
RER-ENG	DY-V
Y-Y	D-R
L-SNLES	A-D-Q-P-R
QV-T	P-A-R
SYW	FD-R
DSD-E	R-K
YVY-DY	F-D-R-PA
N-K	D-N
YGQSLS	NWF
TYALS	T-W
GVILL-ITN	W-T-L
E-LGKP-G-F	T-W-N-F
L-Y	L-V
R-RRPS	V-D-EL
YS-S	E-N
SF	I-Q
PAAWLQQSLAWD	Q-L-N-K-L-EC-L
RYNW	GC-R
TE-DSA-K	K-T-T-N
NFYYY	G-K-T
YDDQLPS	E-KN-NR-E
D-D	I-K
SYW	F-I-R
DTD-YTN	R-H-S-R
EPGYS-W	K-E-F-K-E-Y
NYD	LP-K
DGNY	YP
DD	Q-K
WDSS	Y-A
GFI-F-TAM	FL-A
LSRG-Y	LFY
R-S	RQ
SNL	KN
SNTS-L	QR-M
W-H	FM
A-Y-Y-N	MF
W-HSTSPW	Y-Y-E-Q-M
KNY	E-E
AK-SNSGLSLLYY	Q-E-R-D-L-EV-E
S-F-YS	P-K-T
NTY	S-LR
TPSSGQ	P-Q-L-I-K
TWLLR	L-Q-G
D-Y	E-R
YDT	RR
WAD-S-E	SD-W-L-S
NRESY	D-KS
Q-YGQSLS	F-N
TYALS	L-T-W
GVILL-ITN	W-I-L-I-F
E-LGKP-G-F	T-W-F
RYW	A-A-K
Y-NSTGYTE	K-D-A-K-K
VDGY	TK
SSN	K-VG
WSHY	A-G-R-F
D-YGS-STT	A-F-M-K
LRGYYD	T-D-D-G
DIGSS	Y-T-Q
YATS-Y	R-RS
DFSGDRSN-YF	R-R-S-K-Q-E
Q-NH	Y-H-E
WSGNPW	H-Q-E-R
R-T	Y-S
V-SGG-H-YY	N-Y-Q-G-R
FGDG	L-H-SN
QHTYT	V-QE
VGDT-F	Q-HR
Y-SRGGGY-Y	TR-D
HIYY-SHYY	R-T-HHQ
HSNGN-Y-E	C-FY-Y-R
F-GSHV-L	R-H
GYY-Y	PGR
S-D-F-Y	H-P-R-N
P-YSYDGF	G-PY-K-R
D-D-P	H-T-S
EV-G-T-D	QG-RS
RSYVV-A-Y-Y	Y-N-M-H-Q-G
R-KD	GR
D-SEDYYYY	R-C-I-IH
V-GFS-T	D-H-Q
SSS	HH-Q
YYN-F	NQ
NALYGSGGY-ADY	HF-L-I-QD-R-D
Y-D-K-Y	P-E
W-GTHF-R	EPWK
S-SSG-Y-Y	W-H-SG
DYDYG	K-PK
QY	N-T
Y-EF	T-G-A
W-KRGGAVNYPQ-Q	T-A-N-D-I-G-S-G-D-R
RM	D-T
Y-ASDYYNW	K-K-R-W-KAN
SN-A	R-D-L
Y-IF	LL
S-SL-F	Y-S-R-L
Q-Y-Y-L	L-H
LYY-AM	L-A
VSSRY	E-M
V-GGS-S	GS-A
YYS	D-R
TA-R	AN-G
PAVFYGD-R	D-E-W
NYA	GD
KY-RN	D-N
IGL-YDIL-Y	GG-V-R-K-P
SFNV-L	YN
KFG	TV
IVTG-RK-Y	VT-A-V
SSTSYA	VT-Y
YGSS-S	N-F
SYAIS	T-W-W
GIIIFGTAN	W-T-L-H-F-D
E-GKP-G-F	T-W-N-F
SVSSA	Y-N-E
HGPFYW	Y-G-D
SY-S-Y	HLAE
R-KPYF-W	E-W-E
S-SFLYS	R-Q-E-K
E-Q-ASGFT-T	ESV-P-A-R
ST	L-N
TSKN	Y-EV
TYGIYDLYVDY	NA-T-L-R-Y-R-K-R
YGQSLS	N-W
TYA-S	L-T-WW
GVILL-ITN	W-L-I
E-LGKP-G-F	T-W-W
NIGTKV	GA-A-K
DD-D	K-K
N-N	K-A
ISTD	A-D-K
RSGYPDT	A-S-V-L-W-Q-D
L-Y	ME
QV-GYT-T	LE-S-E
SY	PE
DSD	KS
K-R	D-E
PHYYGT-YPMDY	L-E-KF-M-E
S-S-T-T	AT
PSGYVSLY-Y	R-Y-T-D
D-TSR	R-D
DY-D	I-H-Q
NTW	NW
R-RD-I	WF-N
DEGAPIL-FFEWGYY-Y	W-TI-IR-LW-F
S-S	EE
N-Y	E-T
SYYGY	F-G-R-A-D
R-FW	P-H-N
FWDT-W	R-Q-V
H-LWN-G-F	G-LH
TTTTSG	R-H-K
STA	AN
HYTT	T-AT-T
DYW	Q-S
L-R-R	S-Y-D
SASYGD	KAF-TG
CGSY	Y-W-H
N-Y-S-DSN	N-G-GS
LAFY	T-Y
KY	D-R
YDNL	R-S-S
T-S	D-K
SY	D-E
Y-SNGGSG-Y	H-EK-D-H-S
RGGSSYW	E-V-S-V
W-M-L	L-T
EYY	CS
ADGLTY-LLQYID	G-CI-W-S-L
YDNLG	AR-Y-I-F
AISS-TTY	I-I
D-Y-GSN	P-R
YSY	Q-K
N-KT	Y-E-L
HYGT	A-A
W-H	AA
M-K	A-N
E-Y	T-P
STA	YK
S-Y	P-K
R-DPA-R	N-K-G
SS-GAY-Y	P-H-M-N
E-R	S-D
YAGSN-F	H-S-E
YW	E-N
P-E-Y	H-P
VSRGG	FSS
YSRL	E-Y-N
GATS-E	Y-N-K-K
YW	N-V
RDYYG	K-DD-S-L
SYTTPP	L-N-Y
NS-H	S-F-L
FWWR	Y-FN
YDE-Y	KS-S
FT-S	D-D
SFA	D-D-P
INSN-AS	P-S-Q
PAGRAW	SL-IA-I
S-SY	D-K
WTSY	L-N-H
YSFN	L-K
FYW	K-H
M-DSE-ESR	HN-KL-S-D
RS	N-L
NYRYD	R-K-N-N-Y
HGN-N-Y	Q-S-M-E
GS-V-Y	M-Q
TYA	Q-F
LISTYS-Y	F-Q-HE-Q
VMGEQY	E-G-M
Q-Y-SS-Y	N-I-G-A
YYAY-W	LN-S-R
M-DSN-D-R	G-R-R-YK
Y-SYVTP	R-Q
HRN-Y-H	A-E-LT
S-V-L	AL
GYN-N	CN-L
AIDYY-GTS	LL-V
GM-E	LP
S-SNN	N-K-H-K
Y-Q	N-T
SNSW-Y	YR
SDF	L-D
Y-SYSGS-Y	DS-R-G
R-WP	N-L
SSD-TD-R	Y-L
GKCGGGRCYSGLD	YI-T-Y-N-T
S-Y	L-K
YWSE	K-R-NI
DWYGGD	R-R-N-Y
PDY	R-R
R-R	WF
R-T-GE-S-D	F-NW
KYYFWSGYPPGEE	W-W-IR-NT-F
Y-K	R-H
YKQF-L	A-Q-E
T-S	Q-D
NYY	NR-I
T-TTS-SR-Y	ED-D-GN
RGYGGYSED	AI-I-F-R
YADS	GK
SNV	WKW
IIV-I-N	Y-W-L-I
LGLVL	K-IY
QS-YSSN-K-Y	QQ-TS-TN-T
YLSS	TF
M-WGGGN-DY	K-Y-Y-W-Q-N
K-F-GYD	E-P-VN
S-SFLYS	K-R-L-D
YYTT	FDD
NY-H	EM-D
W-TDG-YTD	Y-P-AC-Y-R
AGTLF	ME-L-H-D
TN	SK
S-SY	D-RA
FN-Y	K-E
D-Y	H-D
L-RNKGN-T-E	E-HD-H-R
DYGTN	SA-D-S
GPFR	N-I-V-T
PIF	I-T-T
GYQ	QT-D
VHSN-N-Y	E-HD
GSHV-L	F-A
H-WWD-D-N	FR
RAHN-D	HR-D
TSRY-Y	ND-KG
WEI-Y	K-E-N-I
DYSM	QN
RINTET-E-K	S-QN
YDGYSWD	IQ-GPS
Y-S	S-F
R-D	S-V
YDE-Y	SK
DYY	H-Q
E-Y-S-N	R-L-K
S-R	L-V
GF-G	RF
KLA	TA
F-R-Y	LQ-A
S-D	TL
L-Y-V	LQP
SNA-N	Q-A-P
Y-AVS-N-Y	DV
S-N	AL
SSSISSNY	S-G-R-Q-T-W
RTSK	V-ND
SGSG	Q-R-D
DIV	GY
Q-Y	R-D
Y-YS	D-D-Y
W-NNSGGTNYAQ-Q	G-D-D-G-QGG-R
W-VH	E-Y-E
GFN-S	N-E-F-M
SY	F-M
YYS-Y-Y	I-PF-E
YVYH-DY	E-VD-E
GNN	GH-Y
Y-Q	K-N
SNSW-Y	RY
SDY	N-K-D
Y-SFSGS-Y	R-G-W-D
WD	Y-L
QS-ASY	D-ER-S-T
AYKT-Y	P-D-E-V
T-A-H	N-V
G-V-H-ITD	V-G
DDYSTY	R-T
T-T	A-V
GL	I-R
F-EENE	I-RI
YYNLWT	T-V-R
QI-Y-Y	T-Q-Y-P
YDNLPY	L-S-RS
W-D	L-R
R-SY	TL
S-Y	D-K
HNSY-R	NT-N
E-N-S-Y-N	K-D-P
IVMVFTD-RG	N-SL-K-N-K
W-DV	HW
TYA-T	G-W
ASSS-D-Y	W-GN-S
AVVFTD-A-Y-K-F	W-NT-N
E-D-N-Y-N	G-N-Q-I
L-Y	LQ
TTHA-P	W-G
S-T-GRFY	H-T-V
YINYPL	YL-QF
Y-NY-YTN-P-K	Y-D-D-Q-K-K
E-R-Y	K-F-F
GYNY	QD-H
SGA	A-F
HYS-N-Y	V-D-P
RLRT-RN	H-T
SNSW-Y	Y-G-N-R-S
D-T	N-L
SDY	L-I
Y-SYSGS-Y	SD-L-G-R
WD	K-C
YY	Y-M
RVMYYW-SKY-Y-Y	E-R-K-D-D-E-R-F
Y-N	FH
L-Y	SV
Y-T	S-V
QQGGAL-F	HS-F
SPS-D	SV-H
HGNGY-Y	I-N-RS-Q
YS-S	K-Q
SCSARSCY-GP	Y-Q-K-N-S
SY-N	K-L-M
A-S	LL
SY	M-P
R-V	A-H
WPS	H-E
YDFWS-A	L-S-A-M
GSTY	E-N
YT-I	G-K
KVQGRVEVG	D-Q-I-N
LHFY-H	D-EL
Y-D-D-R	DK-E
RRGP-VN	D-W
K-DKY	D-E-E
S-Y	R-I
YSGGT-Y	I-N-E
SRASGM	R-E-W-NI
S-ASSY	K-Q-D-G
YDGS-Y	D-L-A-R
R-Y-RS-Y	I-GE-R
IFGIVI	I-I-N-DI
PP	A-D
SGSINY-E-K	T-E-K-DT
YSNNEK-Y	P-K-A-L-Y-LT
YYSY-Y	PT-V-T
NYW-H	Y-Q-VD
M-H-N-K	V-Y-D
LGN-M-D	TQ
SY-H	E-M
RSTY-L	E-G-L
SYR-H	R-D
Y-N-Y-EY-Q-K	H-D-I-LS
GGGV-Y	D-K-M
A-SAR-T	I-P-L
S-S-T	D-A
PSGYVSLY-Y	Y-D-I
HSIRSRR	LD-N-M
ASS	I-L
W-NKE	K-E-K
GNN	GH-K
Y-SQ	N-R-T
SNSW-Y	Y-G-R
SDY	L-N-D
Y-SYSGS-Y	R-S-L-DG
WD	Y-K
SYMY	D-D-Y
WYQ-K-GSS-RLLIY	Y-S-D-KR-R-NL-I
D-NLAS	YI-I-Y-I
GVPVR-E-ED	I-N-N-E-F-P-Q
WSTYPL	E-RS-K
TVTGYS-T	ET-A
TYSGTTDYN-S-KS	T-T-P-A-S-T-E-E-WT
ISI-RTS	R-R-V-P
YYGYWYDV	K-N-SK-R-R
WGQ	RK
SNED-F	S-AF-G
HYG-N	VQ-S
WINTH-I	F-Q
KY	D-R
YDNL	R-S-PS
T-SS	D-K
Y-SNGGSG-Y	H-DD-H-S
RGGSSYW	V-E-F-R-S
YTTT	Y-W-L
GSGSG	Y-D-N
H-N-Y	D-NL
STHV-R	N-N
SYW-H	K-N-D-N
Y-R	K-T
IYFD	NNN
GTA	TFT
L-Y	KE
S-SN-YT	F-TI-E
FS-Y-Y	Q-N
SY	T-T
YRS-N-Y	A-G-E
ENYGS-V	A-K-F
FLYS	N-T-Q
V-GFT-L	D-T-V-C
GY	C-D
W-SAG-D	K-P-Q
PFSPWD	C-F-T-W-K-Q
W-NV	HW
NFA-S	GN-W
AISSSD-Y	WH-N-S
AVVSSDI-Y-YWSK-F	W-N-L-T-I-Q-IH
SNY-Y	Q-K-R
DDYTLD	RD
YHW	R-S-N
YSNY	W-K-D
GIIIFGTAN	Q-L-L-T-Q-I-RA
DNPT-L	W-H-E-H
H-N-Y-N	AA-C
R-Y	EN
W-GT-F-I	AA-E
DDY-H	N-E
R-DPA	A-K
GGL-L	E-A-N
TYVF	NG
SYSY-Y	N-PG
SYW	E-E-I
FSD-Y-N	I-R-K-D
GARDTW	G-IE-G
HSN-N-Y	K-K-S
R-SNLAS	R-N-R
HLEY-F	K-AT
T-T	S-D
SYW-E	I-R-T
E-L-Y-H	A-RSK
ALALY	T-E-E-S-R
SSN	C-G-R
Y-SYS-N-R	EDG
AGR	G-R-E
KL	N-D
Q-GYT-S	K-NY-Q-D
SFW	Q-S-M
NRS	D-GD
FLGR-DY	Q-E-K
H-N-Y-E	HHH
F-GSHV-F	HHH
Y-N	H-H
Y-Q	Y-T
SNSW-Y	RY
SDY	L-N-I
Y-SYSGS-Y	SD-NG
WD	S-K
LPKNF-Y	K-E-EP
MD-K	P-K-E
R-N	E-P
AGRFDHF	GS-R-E
WPP	M-T
IIL-V-H	M-I-L-V-T
EA-EGEYRN	R-IQ-P
W-H-F	D-S
SHW-H	K-TS
E-NSN-R-N	T-F-K-E-G
RDYDYG-Y	S-K-I-K
QG-Y	H-F
IGL-R	T-A
E-K-GSPNYHPSLKS	P-S-K-D-YA
R-NWPL	T-A-V
T-Y-H	A-T
L-Y	TN
I-L-R	I-A
DYV	GL-G
E-YGT-STY	G-G-K
AF-D	I-N
N-KT-Y	S-Q-S
SYNL-R	S-PT
F-RN-VN-E	T-IQ
GS-Y-W	IQ-S
SY-N-F	R-E-P
F-S	S-N
AYS	S-SG
WGD-K	S-GC
DGYYPY	SV-E
LSS-Y	PK
WINTYT	TQ-LT
G-YYYG-F	QQ-F-T
Q-GNN	N-G-R-K
Y-Q	K-T
SNSW-Y	R-NY
SDY	N-L
Y-SASGS-Y	SD
TSIY-Y	L-Q-QQ-V
SREF-F	A-LT
R-Y-D-DAI	T-K-II
KTGDL	N-S-V
TN	R-D
ENYK	A-GG-D
SKSG	N-DN
Y-F-T-E-N	D-E-G
RGQLVN	D-S-I-D-N
HTN-N-Y	F-SD-D-S
ST-IPW	Q-S-M-D
Y-Y	R-Q
Y-S-N-Y	M-V-Y
Q-GGA	E-D-Q
WNY-F	L-QN
W-F-DNTE	N-T-N
E-SSGGRY-Y	R-ED-D-H
GEVRQ	R-F-H-G
S-Y	R-R
SGF	Q-NS
Y-TYS-T	EA
RGFL-VNYY	E-A-T-D-N
FN-Y	N-D
YR	Q-L
LRSL-YF-WLS	NV-T-I-V-QT
TS-Y	P-Y
W-N-W	YP
TAGMQ	Q-Y
WINTR	GQ
EGPG	G-V-Y
HSN-N-Y-E	E-NR
GS-Y	W-R
NYA-S	V-W
TISGG-NIY	WP-T-A-D
ENYGSSF	R-E-W
SYYSSPF	R-A-M
YSYSGY-Y	R-E-Q
WYY-GE	GTP
H-N-Y	G-P
R-AN-E-Y	PL-K
S-Y	TN
HNSY-R	ND-K
E-N-S-Y-N	ND-P
IVMVFTDMRG	N-L-L-N
HNN-N-Y	R-S-E
GS-V-F	R-SH
M-DSD-E-H	S-K-L-H
R-YYGI	R-R-E
QI-Y-Y	T-R-N-A
YDNLPY	L-S
W-R	L-P
R-SY	T-S-L
L-Y	F-A
Y-R-H	VP-F
DY	TK
SNYVYPD	HYR-V-PF
HGES-W	KAT
EYY	R-T-T
L-DPEQ-NTIY-Q	Y-Q-K-D-S-KG
DTAA	K-P
Y-N	VS
L-Y	S-V
Y-T	VV
QQGGAL-F	HS-FN
N-W-H	DN
SPS-D	D-S
NSW	WN
RR-KD	FD-N
DEGTPVT-FLEWGYF-Y	WF-T-L-IR-W
TLGDKY	D-K-E
N-G	K-S
S-W	GK
E-Y-N-N	KGQ
H-Y	R-S
Y-T	DN
FFS	Q-R
WGD	G-D
RDYR	YS-D-N
YNS	D-R
DYG	R-Q
WINTSN	QQ-A
WYNR	R-D-I-G
SNGG-Y	Q-L
IYNLM-YYSTY	I-N-N-L-W-L-Q-G
VSTA	Y-N
HYSTPW	Y-I-EQ
SYA	E-K-I
TISSGGSYTSY-K	I-F-D-E
QDY	L-A
GHSF-F	PQ
SNV-H	T-S-E
Y-NYN-TK	S-G-H-D-P
NWDV	T-E-S
YGD-F	S-Y-T-H
NNED-W	H-Y-K
DYY-K	E-M
N-N-GTL	RMK
GDGIHGG	E-R
NSGN-Y	G-N-H
H-Y	N-R
T-S	Q-Q
SFW	Q-SH
E-L-R-R-N	R-E-Q-Y
GNTMVN	S-D-K-H
TS-Y	P-P
W-S-W	Y-PS
RID-S-GTA	I-LH
Y-Y-GG	SY-PD
QSIGSS	D-KP-K
SSSL-F	EKN-P
VYG	L-EQ
WYD-DN-Y	S-L-K-GP
DLRTG	Q-K
SS-S-Y	VM-R-L
FHR	L-K
Y-S	RK
SGYS-H	K-GR-LH
Y-HY	LE-G
YRYDGW	H-D-R-L
SQHSTYT	QQ-Q
VGDTIF	QQ-QQ-Q
DYY-Y	QQ-Q
YSKF	PEK
TSG	E-W
WWD-D-R	K-W-Q
ITSVTDS	Q-M-F-G
D-D-K-Y	K-E
R-Y	LE
GTHF-W	KW
GNYL-AY	L-L-W
D-S	R-N
M-GFT-R	N-TVS-E
TYG	S-N
WY	NS
PQWEEDI	C-R-N-R-N
NYG	Q-IH
WINTYT-T	K-Q-I-K-H
YPHYYGSSHW	Q-H-Q-R-E
R-R	WF
N-W	K-W
R-T-GE-S-D	F-G
KYYDFWSGYPPGEE	W-K-L-L-W-T-F
HDSS-Y	AQT
IIF-I-H	T-Q-V-L
NDAPEEGM-W	G-R-PP-K-C-A-QA
GTSP	IE
IF-T-Y-Q-R	Q-M-P-TT-A
PDWE-GDSYD	I-AK-Q-R-M-P
SFNV-L	Y-K-N
K-G	TV
STGGYN-Y	TV-D-V
SSTSYA	VT-K-Y
YDGD-Y	N-K-P
SN-D-Y	P-K-T
L-E	T-R
V-N-SGGTN	R-FK-T-T
W-GDGYYA	L-K-Q
QDVNTA	R-FL-E
SS-Y	F-L
YSGY-K	D-WH-E
SYYS-Y-Y-Y	D-I-G-G-E
STV	PE
S-Y-YI	T-P-A-C
YS-Y	H-T
Q-GYT-T	E-E-N-Q
DYW	T-E-K
YGD-D	K-Q
DYYGSN-Y	T-R-V-Q-K
FKRQK-PI	L-S-D-L-M
SYS-H	G-T-DL
Y-S-Y-Y	M-D
TWYY-F	D-AS-L
Y-EF	N-AG
W-KRWGAVNYAR-Q	NA-G-W-D-G-GD-G-R
RVY	D-T-G
Y-ARDYYNW	K-K-R-E-K-N-A
S-NN	D-D
WSNH	D-NY
DYN-N	S-E
V-IKYGTTN-Q-Q	I-E-RQL-K-T
F-D	G-N
FVS	Q-R
WGD	GT
RDYR	N-N-V-G
ES-SNYGI-F	K-R-L-F-T-E
KEVPY	Y-E-T
S-R-YY-D-K	I-S-P-ST
YTL	K-E-E
HRN-N-Y	K-G-L-G
L-Y	R-L
L-E	L-R
GTHA	K-G
AV-GVTF	E-YF
NVA	QGK
EV-TD	DK-LY
S-SY-H	S-E-K
WSKHPL	Y-K-SE-F
GYT-N	E-T-F
LITYN-ASSY	P-Y-V-IA-F-E
YDGRGF	KK-F
YD	V-K
TR-V	VR
L-SDQCGFPE-C	K-AVV
TS-Y-Y	I-Q-I
IREL-R	W-I-TN
RGDAW	W-G
D-ANY	R-D-A-S
TN	G-N
S-H	A-T
SFQT	S-R-G
SAHGGS-Y	D-G-E-QG-N
SRDHF	G-GT-S
YHEGSGYYYRAG	A-T-K-NG-I-T-G-I-S
ISSW	R-T
Y-AASYR	I-L-T-D
YGS-SEW-K	LF-L-K-D
TDN	Q-L-I
R-Y	D-K
GNTL-W	K-G
L-NYK-V-T	R-G-E
GYYGD-DW	R-W-S-Y-L-K
Y-N	Q-V
FWGN-W	S-T-R-A-D
SG	AA
WWD-VKR-P	D-A-K-T-E-P
SVITTG-Y	G-A-H-S-D
GNN	GL-K
Y-Q	K-N
SNSW-Y	YR
SDY	K-L-W
Y-SSF-S-F	R-G-WW
WD	K-N
P-EY	N-S
W-SMV	W-D-W-Q
SIIIFGTTNY	Q-G-L-Q-L-R
YFDTYN-Y	W-HQ-Q-H
HSN-N-Y	QT-GW
S-G-H	M-DK
H-SSGSRT	D-E-D-R-E
DVNT	D-RR
Y-Y	RE
QGISNW	RPC-K
Q-YSSF-T	L-F-R-E-G
SYA-S	P-TL
AINSQ-S-Y	LT-EP-Q-D
W-DE-F	K-P-K-L
AGYDVH	V-NR
QSYDS-RG	R-N
Y-GGS-Y	N-GR-G
EGPGD	K-T-R
NEY-W	TD-K
SYW	D-N
N-Y-D-Y	K-N-K
D-NYG	K-Y
H-Y	L-I
FWS	Q-I
GYG	KG
WGD	G-D
RDYR	G-V-A-N
ED-Y-R	W-KS-Y
YWST-W	N-K-E
YG	D-V
WWD-D-YY-P	N-VK-E
R-YGNH	V-Y
D-DGK-Y-N	K-Y-G
R-Y	GE
L-R-DS	G-D-N
GSH-Q	KT
NYGMN	VT-TT
W-NTFT	T-Q-V-L
GT-D	T-E
YSSN-K-F	Y-N-TE-P
P-T	T-D
AY	TP
WGD-N	P-D-N-Y
DPYGS	R-VC
YGSSPS	NWF
SYAIS	LW-W
GIIIFGT-N	W-L-L-F
E-LGKP-G-F	F-W-T
SSW	D-Q
YN-Y	Q-L
R-Y-SGS	D-M-Y
EEHITF-G	VD-I-W
WP	C-T
IILDV-H	M-K-K-T
GEEGEYDN	R-I-K-P-Q-M
FKRQK-PI	L-L
SYS-H	TA-L
Y-S-Y-Y	M-D-S
TWYY-F	A-L-L
SWNGPL	E-GK-NK-Q
Y-NNS-YTN	N-EE-F
VPGNNW	NQ-QE
F-GSS	L-HV
SHSW-F	RN
FI	EG
NHW	GE-Q
RS-SI-H-K	Y-Q-GE
YYGS-D	P-Y-P-E
Y-Y	QK
VT	R-E
W-NYTGEPT	E-T-L-S-A
LET	S-L
E-NLWGNY-NW	K-E-T-F-E
AIDEY	IR
YVGSS	P-Y
F-Y	G-M
V-DIT-E-Y	A-GK-Y
TYGY	A-YM-A
D-H	Y-D
DAN	DR-R
KVIYYQGR	Y-G-G-M-D-D
F-A	Q-W
Q-FWG-F	W-Q
IYA	PD
R-RS-SN	PD
QMG-D	P-TW
DI	K-D
Y-EF	R-G-D
W-NSGGTNYAQ-Q	N-V-D-GS-D-G-T
E-D-W	D-K-N
RNNQRPS	PD-N-I
G-D-K	L-P-H
G-N-S	I-E
GYY	E-L-S
TYY	F-R-H
GSS-T	S-R
L-QF	N-R-T
W-KQYGAVNFGGG-RD	A-T-D-I-GS-G-R-K
RVY	R-G-G
GDSSW	D-K-A-N-K
T-T	E-N
YDTY-W	K-E-D
S-T	K-T
SFW-H	T-E-D
M-DPSE-K-R	D-GT-KG-E
VRR-Y	D-F-T-E
SSSY	VQ
TR-T	N-H
YGTSAI	N-FM
QV-GY-T	LL-R
ELP-H	R-L-FM
SFDPE-ESI	MF-R
PDPDA-I	LL-R-N
Y-L-Y	I-G
Q-S-D-L	I-I
H-FWD-D-R	I-KR
EGY-I	IH-P
V-YS-T	E-T
GH	A-E
HH	A-Y
DFRY	Y-A-I
Q-S-Y	H-LR
RSNW-L	FL-D-D
W-STG-Q	ED-R
SGYRD	E-L-LR
STF	KT
D-STR	K-Q-T
G-R	Q-K
W-S-W	S-P
NYW	R-P-P
VGQ-Y	P-RT
Q-GNN	N-G-K
Y-Q	K-N
SNSW-Y	Y-G-R-S
SDF	N-K
Y-SYSGS-Y	R-G-W-D-N
WD	KK
Q-H	W-Y
QQTDSWPT	YGS-K-L
R-E-N	Y-R-Q
RYDPYYAM	Q-T-I-Y
EIV	NN
L-EF	N-N
EL-H	KA
W-K-VTGAVNFGSP-R	N-T-G-GG-D-S-A-GG
RRD	G-G-G
YTGG-GW	K-K-N-A
R-SY	D-G
D-K	GT
RSS-Y	Y-SG
RYW-H	H-L-M-L
A-Y-N-DTSY-Q-E	L-I-E-R-SK
DYGY	Y-L-E
MY	I-D
LGGYF-R	I-Q-G-K
DYY	G-F
F-AN	L-K-P
VYGNYP	TM-G-L
KY	E-R
WWD-V-R	R-K
DYD	RF
H-N-Y-Y	PG
SGYY	R-G-G
YD	P-R
FKR-PI	L-S-L
SYS-H	T-L
Y-S-Y-Y	LD-M
TWYY-F	D-AT-L-L
SNS	QS
NNT	HP
L-Y	Y-T
D-T	N-T
RG-WP	Y-TL
SY-H-H	Y-L
GLSRDNSGFTGLD	YI-NT-Y-LT
GLVYIDG	N-T-T-V
THW	T-D-Q
YN-N	D-A
HIL	V-L-W
Y-T-P	A-D-I
YD-L-R	R-M
NY	P-T
W-NNT	HM-P-V
DNPYY	H-T-G
SY-S	H-I-Q
AA	QH
Y-A-YGY	HI-Q-M
YSY	R-QH
D-D-R	D-D
SGS-DFI	GVP
SNRW-F	VF
N-W-Q	R-D-F
A-YRD-D-K	F-R-D-RM
A-LYY	F-Y-P-D
TSGY-Y	I-CI-W-T
IREL-R	TN
M-R	GN
RGDAW	W-N
HTDGT-Y	R-V-F
NIQL-W	R-GG
SYG	V-T
W-SYS-N	G-S-V-S-R
EGSSSSGDYYY	T-QH-F-R
S-Y	EV
GSSIPF	VEQ
WGGGT-Y	DY
ASYN	K-Y
YNR	S-V-D
AGIRW-W	V-E-S-L-D
MSSY-L	AV-I
GNA	FV-I
WINHS-DTT	V-I-VF
Y-NEA	IG-A
SNTW-Y	DN-WE
DSD-Y	H-R-F
YGYY	M-H-D-D
T-YK	G-KY
FFG	Y-L-K
SHYCLDC	N-S-W-S
SFW	S-D
FQPSFTLTSY	SL-W-E-K
S-N	L-K
SN-WPR	K-A-H-R-G
SYG-H	R-N
W-D	H-Y
EPPY	NV-G
S-Y	PQ
GN-Y	Q-F
FTFS	R
S-A	D-F
AISGSGGS-Y	FD-FN
TYPQRRGPQNV	D-Y-H-V-I-F-DFT-Q
ES-SNYGI-F	K-R-S-ST
KEVPY	R-E-R-T
S-RSYY-K	I-SS-I-T
GYT	K-A-R
I-E	T-R
W-KKFGAVNYAH-Q	T-A-WM-G-G-S-G-D
RIY	D-QG
DGS-W	D-K-NN
Y-EF	N-GA
W-KRFGAVSYARQ-Q	N-T-N-I-D-GS-D-AG
RY	D-G
ARDYYNW	K-E-KA-N
DIGNY	V-R-E-Q-E
GSRSG	E-K-T
FYYSR-R	T-Y-K-F-E
G-SYV	P-Q
TWGAGIL	QP-PF
AMS	Q-F
GISG-S-Y	FP
FSGKD	QQ
HNSY-R	ND-TI
E-N-S-Y-N	DM
IVMVFTD-RG	N-S-S-N-K
YSISDI	D-R
N-Y	EI
Y-GGR-I-F	E-I-Q
F-AV-V-GTYST-Y	I-I-I-D
SN	P-R
W-DSN	R-PN-F
NI	Y-P
Q-Y-N-Y	P-R-F
YLSSY	RT-Y
SSGGNY-Y	E-E-S
AYSGSS	V-E-G-T-F
Y-EF	N-N-G
W-NSGGTNYAQK-Q	L-DG-S-R-GGD-R
E-D-W	DN
TN	Q-N
W-Y	W-P
YN-Y-L	A-N-L-Q
DYA-S	RT-Q
Y-TY-N-I-K	QR-A-E
GV-D	RQ
W-DSIN	ATQK
YY-D	A-K
NYGI-F	D-D-N-E-E
SKEV-L	RD
W-H	E-R
E-N	RL
W-GSPY	E-E-T-E
DDD	K-K-K
S-NL	K-E
GYY	G-K
E-NPRT	K-GT
RINWA	E-E
QG-R-D	R-V-S
HNSY-R	S-M-R-D
S-W	G-K
E-YHS-STN-K	D-Q-G-KD
D-DDL	K-S
DI	K-R
Y-EF	D-GG
W-LTSQPSYPS-Q	A-R-G-D-I-G-N-DG-R
RTF	D-N-T
R-D	A-K
S-SNN	N-G-K
Y-Q	K-N
SDV	N-K
Y-SYS-S-Y	R-D-L-S
WDSV	PA
T-T	Q-R
D-NY-N	D-R-P
DRGYY	D-P
DKY	P-LH
WDA-GT-L	I-L-FY
DSW	KR-Y
I-Y-D-D-H	I-K-Y
L-L-QSSN	I-R-P-H-S
Y-N-K-Y	EE-P
GT-F	LPK
DYA-N	L-L
Y-TY	K-V-N
YDDY	L-L
YSY-T	D-R-D-F
HYG-R	F-DW
GM	H-W
Y-GSV-D	FP
Y-P	K-Q
YDN-W	KE
QV-G-NIK	K-K-K
DTY	K-E
R-DPAN	K-T-KN
E-YYGNYGVY-Y	K-Y-F-N-Q-F-K-K